fips,year,renter_occupied,for_rent_vacant,rented_vacant,total_units
51001,2010,3649,135,7,3791
51001,2011,3558,159,15,3732
51001,2012,4216,239,11,4466
51001,2013,4373,117,32,4522
51001,2014,4236,118,25,4379
51001,2015,4042,207,18,4267
51001,2016,4214,186,12,4412
51001,2017,4062,141,36,4239
51001,2018,4308,129,24,4461
51001,2019,4461,105,25,4591
51001,2020,4780,42,32,4854
51001,2021,4689,69,27,4785
51003,2010,12949,1114,174,14237
51003,2011,12667,1402,215,14284
51003,2012,12901,1616,299,14816
51003,2013,12886,1671,214,14771
51003,2014,13402,1528,304,15234
51003,2015,13572,1523,303,15398
51003,2016,13847,1399,399,15645
51003,2017,14556,1095,372,16023
51003,2018,15221,1018,315,16554
51003,2019,15231,809,281,16321
51003,2020,14756,703,264,15723
51003,2021,14641,359,293,15293
51005,2010,1206,0,49,1255
51005,2011,1306,0,72,1378
51005,2012,1234,31,72,1337
51005,2013,1360,59,25,1444
51005,2014,1377,115,63,1555
51005,2015,1444,127,75,1646
51005,2016,1449,160,56,1665
51005,2017,1641,163,72,1876
51005,2018,1504,119,72,1695
51005,2019,1568,145,12,1725
51005,2020,1359,97,11,1467
51005,2021,1244,73,37,1354
51007,2010,821,0,0,821
51007,2011,952,0,0,952
51007,2012,910,0,0,910
51007,2013,965,0,0,965
51007,2014,875,0,0,875
51007,2015,880,0,0,880
51007,2016,695,40,0,735
51007,2017,771,40,0,811
51007,2018,753,44,0,797
51007,2019,773,39,0,812
51007,2020,850,24,0,874
51007,2021,890,0,0,890
51009,2010,3130,64,31,3225
51009,2011,3059,27,29,3115
51009,2012,3069,45,29,3143
51009,2013,3278,38,0,3316
51009,2014,3204,60,0,3264
51009,2015,2968,79,24,3071
51009,2016,2872,74,36,2982
51009,2017,2797,171,83,3051
51009,2018,2695,164,82,2941
51009,2019,2782,130,87,2999
51009,2020,2753,149,56,2958
51009,2021,3084,145,33,3262
51011,2010,1437,35,0,1472
51011,2011,1440,29,0,1469
51011,2012,1390,67,0,1457
51011,2013,1149,51,0,1200
51011,2014,1125,41,0,1166
51011,2015,1137,35,0,1172
51011,2016,1215,34,0,1249
51011,2017,1131,0,0,1131
51011,2018,1362,0,0,1362
51011,2019,1354,0,0,1354
51011,2020,1417,0,0,1417
51011,2021,1423,0,0,1423
51013,2010,48724,3278,1433,53435
51013,2011,49340,3235,2063,54638
51013,2012,50296,3259,2348,55903
51013,2013,51800,3312,2040,57152
51013,2014,53107,3268,1968,58343
51013,2015,54744,3267,1742,59753
51013,2016,56176,3229,1271,60676
51013,2017,56785,3223,977,60985
51013,2018,59212,2957,768,62937
51013,2019,61280,2638,612,64530
51013,2020,62399,2541,584,65524
51013,2021,63220,2979,770,66969
51015,2010,5226,301,134,5661
51015,2011,5207,255,84,5546
51015,2012,5292,295,44,5631
51015,2013,5337,421,75,5833
51015,2014,5311,458,84,5853
51015,2015,5809,494,113,6416
51015,2016,5824,497,166,6487
51015,2017,6016,544,155,6715
51015,2018,6187,436,96,6719
51015,2019,6109,274,91,6474
51015,2020,6227,268,43,6538
51015,2021,6420,360,0,6780
51017,2010,264,20,0,284
51017,2011,293,73,0,366
51017,2012,402,34,0,436
51017,2013,501,33,0,534
51017,2014,551,67,0,618
51017,2015,651,106,0,757
51017,2016,674,72,0,746
51017,2017,482,75,37,594
51017,2018,556,74,37,667
51017,2019,444,36,38,518
51017,2020,332,0,37,369
51017,2021,404,0,36,440
51019,2010,4217,333,103,4653
51019,2011,4275,347,147,4769
51019,2012,4118,362,116,4596
51019,2013,4076,352,84,4512
51019,2014,5494,441,52,5987
51019,2015,5741,453,103,6297
51019,2016,5765,438,113,6316
51019,2017,5760,409,184,6353
51019,2018,5734,375,175,6284
51019,2019,5605,404,173,6182
51019,2020,4976,464,117,5557
51019,2021,5220,412,84,5716
51021,2010,391,0,0,391
51021,2011,429,0,0,429
51021,2012,433,0,0,433
51021,2013,435,0,0,435
51021,2014,513,0,0,513
51021,2015,525,0,0,525
51021,2016,454,0,0,454
51021,2017,445,0,0,445
51021,2018,436,0,0,436
51021,2019,440,0,0,440
51021,2020,407,25,18,450
51021,2021,375,23,18,416
51023,2010,1654,335,71,2060
51023,2011,1559,225,100,1884
51023,2012,1605,235,90,1930
51023,2013,1529,219,89,1837
51023,2014,1501,125,97,1723
51023,2015,1599,183,41,1823
51023,2016,1863,210,42,2115
51023,2017,1964,227,24,2215
51023,2018,1808,249,24,2081
51023,2019,1817,242,63,2122
51023,2020,1880,231,29,2140
51023,2021,1849,216,27,2092
51025,2010,1823,42,0,1865
51025,2011,1812,88,0,1900
51025,2012,1772,122,41,1935
51025,2013,1619,150,39,1808
51025,2014,1530,147,39,1716
51025,2015,1597,159,34,1790
51025,2016,1757,79,50,1886
51025,2017,1576,74,14,1664
51025,2018,1712,34,14,1760
51025,2019,1769,33,15,1817
51025,2020,1593,21,14,1628
51025,2021,1437,49,0,1486
51027,2010,1869,128,19,2016
51027,2011,1943,166,33,2142
51027,2012,2045,171,24,2240
51027,2013,2027,265,23,2315
51027,2014,1830,307,19,2156
51027,2015,1993,305,39,2337
51027,2016,1961,448,19,2428
51027,2017,1906,530,20,2456
51027,2018,1946,514,39,2499
51027,2019,1944,432,51,2427
51027,2020,1668,392,57,2117
51027,2021,1369,212,53,1634
51029,2010,1227,37,0,1264
51029,2011,1524,53,0,1577
51029,2012,1427,46,0,1473
51029,2013,1397,11,22,1430
51029,2014,1371,36,20,1427
51029,2015,1256,53,24,1333
51029,2016,1338,73,26,1437
51029,2017,1407,71,25,1503
51029,2018,1442,60,0,1502
51029,2019,1445,37,0,1482
51029,2020,1557,22,0,1579
51029,2021,1484,0,0,1484
51031,2010,5348,263,29,5640
51031,2011,5288,360,28,5676
51031,2012,5077,322,0,5399
51031,2013,5229,305,43,5577
51031,2014,4967,230,47,5244
51031,2015,5219,181,57,5457
51031,2016,5397,93,56,5546
51031,2017,5661,108,62,5831
51031,2018,5686,126,0,5812
51031,2019,5829,205,79,6113
51031,2020,6241,218,45,6504
51031,2021,5998,271,42,6311
51033,2010,1753,255,16,2024
51033,2011,1812,194,7,2013
51033,2012,1819,113,0,1932
51033,2013,2127,132,0,2259
51033,2014,1991,124,21,2136
51033,2015,2115,68,25,2208
51033,2016,2442,70,29,2541
51033,2017,2147,72,30,2249
51033,2018,2043,146,28,2217
51033,2019,2277,103,36,2416
51033,2020,2155,203,58,2416
51033,2021,2033,244,62,2339
51035,2010,3048,334,171,3553
51035,2011,2819,336,106,3261
51035,2012,2750,439,79,3268
51035,2013,2683,442,78,3203
51035,2014,2662,470,28,3160
51035,2015,2633,441,35,3109
51035,2016,2793,362,30,3185
51035,2017,2757,252,27,3036
51035,2018,2849,133,57,3039
51035,2019,2683,83,79,2845
51035,2020,2515,106,79,2700
51035,2021,2693,92,60,2845
51036,2010,407,27,14,448
51036,2011,408,42,13,463
51036,2012,498,37,28,563
51036,2013,556,24,23,603
51036,2014,553,43,10,606
51036,2015,539,45,12,596
51036,2016,504,32,12,548
51036,2017,484,24,2,510
51036,2018,469,23,4,496
51036,2019,466,34,7,507
51036,2020,467,24,4,495
51036,2021,451,17,3,471
51037,2010,975,132,77,1184
51037,2011,1021,115,46,1182
51037,2012,1182,65,0,1247
51037,2013,1282,71,0,1353
51037,2014,1275,35,0,1310
51037,2015,1442,12,0,1454
51037,2016,1440,6,8,1454
51037,2017,1295,0,7,1302
51037,2018,1387,0,6,1393
51037,2019,1339,0,6,1345
51037,2020,1541,0,6,1547
51037,2021,1460,0,4,1464
51041,2010,24312,1904,621,26837
51041,2011,24754,2529,719,28002
51041,2012,25062,3052,834,28948
51041,2013,26158,3382,903,30443
51041,2014,26949,3491,750,31190
51041,2015,27646,2824,801,31271
51041,2016,29051,2346,806,32203
51041,2017,29860,1763,688,32311
51041,2018,30188,1601,611,32400
51041,2019,30273,1397,533,32203
51041,2020,29640,1477,419,31536
51041,2021,30708,1354,441,32503
51043,2010,1340,137,0,1477
51043,2011,1295,132,0,1427
51043,2012,1193,103,0,1296
51043,2013,1133,104,0,1237
51043,2014,1344,118,0,1462
51043,2015,1331,114,0,1445
51043,2016,1429,145,0,1574
51043,2017,1392,149,0,1541
51043,2018,1423,113,0,1536
51043,2019,1403,82,0,1485
51043,2020,1275,37,5,1317
51043,2021,1346,8,5,1359
51045,2010,285,7,4,296
51045,2011,220,4,9,233
51045,2012,301,8,5,314
51045,2013,331,32,4,367
51045,2014,418,32,9,459
51045,2015,420,32,8,460
51045,2016,636,31,4,671
51045,2017,610,26,4,640
51045,2018,630,9,3,642
51045,2019,541,50,0,591
51045,2020,644,48,0,692
51045,2021,432,52,0,484
51047,2010,4336,329,64,4729
51047,2011,4274,345,92,4711
51047,2012,4172,366,115,4653
51047,2013,4328,263,151,4742
51047,2014,4397,137,127,4661
51047,2015,4492,62,111,4665
51047,2016,4786,58,56,4900
51047,2017,4565,41,33,4639
51047,2018,4364,117,40,4521
51047,2019,4659,216,31,4906
51047,2020,4645,179,27,4851
51047,2021,4705,148,23,4876
51049,2010,880,0,0,880
51049,2011,953,0,0,953
51049,2012,913,0,0,913
51049,2013,915,0,0,915
51049,2014,968,0,0,968
51049,2015,1119,62,0,1181
51049,2016,1108,55,0,1163
51049,2017,1102,68,0,1170
51049,2018,1071,86,0,1157
51049,2019,1039,87,0,1126
51049,2020,984,33,0,1017
51049,2021,916,32,0,948
51051,2010,1198,74,17,1289
51051,2011,1348,85,12,1445
51051,2012,1370,88,11,1469
51051,2013,1392,123,12,1527
51051,2014,1364,136,0,1500
51051,2015,1400,155,0,1555
51051,2016,1514,191,0,1705
51051,2017,1466,178,4,1648
51051,2018,1385,158,9,1552
51051,2019,1404,152,9,1565
51051,2020,1429,146,8,1583
51051,2021,1283,103,8,1394
51053,2010,2373,442,0,2815
51053,2011,2156,638,0,2794
51053,2012,2379,508,43,2930
51053,2013,2325,467,32,2824
51053,2014,2489,435,41,2965
51053,2015,2322,441,59,2822
51053,2016,2544,277,69,2890
51053,2017,2365,293,20,2678
51053,2018,2491,305,16,2812
51053,2019,2374,231,16,2621
51053,2020,2370,276,3,2649
51053,2021,2398,126,0,2524
51057,2010,1125,41,0,1166
51057,2011,1041,83,0,1124
51057,2012,1042,95,9,1146
51057,2013,1021,100,28,1149
51057,2014,1104,104,30,1238
51057,2015,1143,95,31,1269
51057,2016,1270,101,42,1413
51057,2017,1317,114,33,1464
51057,2018,1355,145,9,1509
51057,2019,1499,151,10,1660
51057,2020,1451,140,9,1600
51057,2021,1434,88,12,1534
51059,2010,107320,6263,3122,116705
51059,2011,111787,5793,2824,120404
51059,2012,117524,4960,2093,124577
51059,2013,120741,5169,1890,127800
51059,2014,124638,4382,1664,130684
51059,2015,126662,4562,1748,132972
51059,2016,128007,4567,1721,134295
51059,2017,126673,5113,1519,133305
51059,2018,126101,5037,1678,132816
51059,2019,126973,5007,1682,133662
51059,2020,125225,5186,1645,132056
51059,2021,128596,5665,1618,135879
51061,2010,4736,974,277,5987
51061,2011,4905,713,207,5825
51061,2012,4815,417,246,5478
51061,2013,4600,362,350,5312
51061,2014,4745,348,333,5426
51061,2015,4921,238,285,5444
51061,2016,5230,184,252,5666
51061,2017,5178,179,224,5581
51061,2018,5316,173,127,5616
51061,2019,5333,71,179,5583
51061,2020,5678,57,139,5874
51061,2021,5962,92,149,6203
51063,2010,1364,188,0,1552
51063,2011,1391,223,0,1614
51063,2012,1351,216,24,1591
51063,2013,1366,209,59,1634
51063,2014,1295,139,84,1518
51063,2015,1399,91,63,1553
51063,2016,1400,119,88,1607
51063,2017,1238,87,37,1362
51063,2018,1154,131,37,1322
51063,2019,1226,109,34,1369
51063,2020,931,91,31,1053
51063,2021,961,15,0,976
51065,2010,1171,116,0,1287
51065,2011,1206,89,0,1295
51065,2012,1165,50,0,1215
51065,2013,1368,45,0,1413
51065,2014,1637,44,0,1681
51065,2015,1767,17,0,1784
51065,2016,2025,19,0,2044
51065,2017,1883,30,0,1913
51065,2018,1586,46,0,1632
51065,2019,1491,49,0,1540
51065,2020,1752,16,0,1768
51065,2021,1402,59,0,1461
51067,2010,5031,421,110,5562
51067,2011,4886,424,84,5394
51067,2012,5242,472,116,5830
51067,2013,5128,611,48,5787
51067,2014,5176,611,48,5835
51067,2015,5239,474,183,5896
51067,2016,4767,478,174,5419
51067,2017,4810,432,138,5380
51067,2018,4657,257,136,5050
51067,2019,4199,216,195,4610
51067,2020,4181,316,37,4534
51067,2021,4312,238,118,4668
51069,2010,6063,367,44,6474
51069,2011,6147,333,20,6500
51069,2012,5984,284,28,6296
51069,2013,6320,214,33,6567
51069,2014,6502,220,68,6790
51069,2015,6445,189,37,6671
51069,2016,6548,323,40,6911
51069,2017,6875,316,28,7219
51069,2018,6908,311,31,7250
51069,2019,7053,345,7,7405
51069,2020,7155,429,0,7584
51069,2021,7902,386,0,8288
51071,2010,1573,119,79,1771
51071,2011,1560,137,51,1748
51071,2012,1610,154,10,1774
51071,2013,1725,142,10,1877
51071,2014,1771,114,27,1912
51071,2015,1731,90,52,1873
51071,2016,1824,135,51,2010
51071,2017,1788,106,43,1937
51071,2018,1624,202,47,1873
51071,2019,1723,216,23,1962
51071,2020,1587,328,26,1941
51071,2021,1616,233,36,1885
51073,2010,2470,122,50,2642
51073,2011,2212,224,101,2537
51073,2012,2235,351,101,2687
51073,2013,2370,402,72,2844
51073,2014,2697,337,73,3107
51073,2015,2998,316,7,3321
51073,2016,3381,170,0,3551
51073,2017,3368,76,0,3444
51073,2018,3498,36,0,3534
51073,2019,3217,38,0,3255
51073,2020,2962,129,16,3107
51073,2021,3017,190,16,3223
51075,2010,598,0,46,644
51075,2011,565,0,46,611
51075,2012,662,8,57,727
51075,2013,787,7,61,855
51075,2014,1018,7,10,1035
51075,2015,1060,7,72,1139
51075,2016,1144,8,101,1253
51075,2017,1071,0,125,1196
51075,2018,1269,3,99,1371
51075,2019,1286,5,99,1390
51075,2020,1245,13,45,1303
51075,2021,1335,14,38,1387
51077,2010,1285,98,115,1498
51077,2011,1348,51,63,1462
51077,2012,1525,86,95,1706
51077,2013,1478,80,106,1664
51077,2014,1607,117,42,1766
51077,2015,1736,146,49,1931
51077,2016,1416,138,39,1593
51077,2017,1415,126,7,1548
51077,2018,1358,149,25,1532
51077,2019,1216,86,25,1327
51077,2020,1021,66,27,1114
51077,2021,1099,43,28,1170
51079,2010,1352,75,0,1427
51079,2011,1363,107,0,1470
51079,2012,1537,102,21,1660
51079,2013,1449,134,23,1606
51079,2014,1612,139,27,1778
51079,2015,1599,87,24,1710
51079,2016,1561,67,27,1655
51079,2017,1408,56,6,1470
51079,2018,1459,13,31,1503
51079,2019,1691,13,33,1737
51079,2020,1430,13,32,1475
51079,2021,1517,44,32,1593
51081,2010,860,92,0,952
51081,2011,904,100,0,1004
51081,2012,983,93,0,1076
51081,2013,821,73,0,894
51081,2014,915,90,6,1011
51081,2015,991,62,6,1059
51081,2016,890,4,2,896
51081,2017,895,4,5,904
51081,2018,990,2,6,998
51081,2019,974,0,0,974
51081,2020,968,0,24,992
51081,2021,844,0,23,867
51083,2010,3526,204,17,3747
51083,2011,3461,157,45,3663
51083,2012,3829,138,47,4014
51083,2013,4098,120,16,4234
51083,2014,3898,58,12,3968
51083,2015,3956,30,13,3999
51083,2016,4112,23,0,4135
51083,2017,3864,13,0,3877
51083,2018,3549,42,0,3591
51083,2019,3664,36,0,3700
51083,2020,3563,42,0,3605
51083,2021,3499,43,0,3542
51085,2010,5813,199,65,6077
51085,2011,5894,171,82,6147
51085,2012,5901,252,92,6245
51085,2013,6147,154,22,6323
51085,2014,6551,198,22,6771
51085,2015,7115,203,79,7397
51085,2016,7094,169,70,7333
51085,2017,7138,213,64,7415
51085,2018,7086,235,65,7386
51085,2019,6813,295,80,7188
51085,2020,6707,348,58,7113
51085,2021,6925,347,29,7301
51087,2010,40263,2810,1720,44793
51087,2011,41481,3017,1472,45970
51087,2012,42199,2972,1155,46326
51087,2013,42993,2792,1467,47252
51087,2014,44756,3319,1551,49626
51087,2015,46248,2893,1539,50680
51087,2016,46872,2460,1628,50960
51087,2017,46804,2625,1552,50981
51087,2018,47408,2559,1284,51251
51087,2019,47975,2418,1302,51695
51087,2020,46986,2542,1019,50547
51087,2021,47129,2480,893,50502
51089,2010,5513,871,86,6470
51089,2011,5830,926,69,6825
51089,2012,5516,853,51,6420
51089,2013,5771,787,68,6626
51089,2014,5815,617,110,6542
51089,2015,5704,637,98,6439
51089,2016,5883,448,71,6402
51089,2017,5941,565,69,6575
51089,2018,5969,808,56,6833
51089,2019,5956,845,107,6908
51089,2020,5891,667,212,6770
51089,2021,5669,630,267,6566
51091,2010,264,16,0,280
51091,2011,220,5,0,225
51091,2012,171,2,0,173
51091,2013,138,7,0,145
51091,2014,156,8,0,164
51091,2015,188,8,0,196
51091,2016,164,8,6,178
51091,2017,169,17,6,192
51091,2018,203,11,6,220
51091,2019,184,13,6,203
51091,2020,125,13,11,149
51091,2021,164,13,5,182
51093,2010,2558,80,0,2638
51093,2011,2540,44,24,2608
51093,2012,2656,59,27,2742
51093,2013,2634,133,26,2793
51093,2014,2840,242,18,3100
51093,2015,3020,220,22,3262
51093,2016,3051,244,0,3295
51093,2017,3218,255,0,3473
51093,2018,3612,180,0,3792
51093,2019,3532,73,0,3605
51093,2020,3391,43,0,3434
51093,2021,3332,141,0,3473
51095,2010,6079,676,297,7052
51095,2011,6356,608,301,7265
51095,2012,6273,641,288,7202
51095,2013,6393,786,209,7388
51095,2014,7049,998,139,8186
51095,2015,7016,1018,78,8112
51095,2016,7044,1068,51,8163
51095,2017,7293,1300,69,8662
51095,2018,7332,1261,139,8732
51095,2019,6827,1299,169,8295
51095,2020,6972,1078,268,8318
51095,2021,6814,1173,277,8264
51097,2010,552,59,0,611
51097,2011,566,60,0,626
51097,2012,663,61,0,724
51097,2013,680,44,0,724
51097,2014,711,45,0,756
51097,2015,698,0,0,698
51097,2016,593,18,0,611
51097,2017,598,16,0,614
51097,2018,464,18,0,482
51097,2019,446,18,0,464
51097,2020,434,17,0,451
51097,2021,489,0,0,489
51099,2010,1933,200,135,2268
51099,2011,2067,193,274,2534
51099,2012,2034,286,302,2622
51099,2013,2200,232,283,2715
51099,2014,2201,185,259,2645
51099,2015,2259,170,221,2650
51099,2016,2320,206,52,2578
51099,2017,2192,190,32,2414
51099,2018,2089,140,0,2229
51099,2019,1955,175,0,2130
51099,2020,2250,241,0,2491
51099,2021,2369,239,0,2608
51101,2010,860,27,0,887
51101,2011,1004,21,0,1025
51101,2012,1014,23,0,1037
51101,2013,1016,26,0,1042
51101,2014,1096,0,0,1096
51101,2015,1105,0,0,1105
51101,2016,966,0,0,966
51101,2017,846,0,0,846
51101,2018,849,0,0,849
51101,2019,768,0,0,768
51101,2020,742,0,0,742
51101,2021,869,2,0,871
51103,2010,1241,19,58,1318
51103,2011,1272,29,59,1360
51103,2012,1086,31,71,1188
51103,2013,1076,71,61,1208
51103,2014,1299,88,66,1453
51103,2015,1290,92,28,1410
51103,2016,1275,156,18,1449
51103,2017,1362,139,9,1510
51103,2018,1252,97,21,1370
51103,2019,1222,84,41,1347
51103,2020,1277,115,39,1431
51103,2021,1020,90,36,1146
51105,2010,2573,129,3,2705
51105,2011,2501,143,3,2647
51105,2012,2456,149,43,2648
51105,2013,2476,158,52,2686
51105,2014,2643,175,53,2871
51105,2015,2539,193,47,2779
51105,2016,2627,152,52,2831
51105,2017,2607,159,14,2780
51105,2018,2684,168,0,2852
51105,2019,2672,205,10,2887
51105,2020,2713,215,9,2937
51105,2021,2461,235,17,2713
51107,2010,18308,2553,1765,22626
51107,2011,20774,1889,1358,24021
51107,2012,22719,1108,701,24528
51107,2013,23897,919,774,25590
51107,2014,25385,833,714,26932
51107,2015,25971,1114,496,27581
51107,2016,26417,1237,338,27992
51107,2017,26862,1113,213,28188
51107,2018,27796,1011,233,29040
51107,2019,28237,1279,239,29755
51107,2020,29546,1126,202,30874
51107,2021,30454,1134,189,31777
51109,2010,2886,191,9,3086
51109,2011,2914,244,11,3169
51109,2012,2552,221,10,2783
51109,2013,2624,200,7,2831
51109,2014,2414,258,6,2678
51109,2015,2625,227,6,2858
51109,2016,2858,183,0,3041
51109,2017,2730,167,49,2946
51109,2018,2757,134,56,2947
51109,2019,2768,127,62,2957
51109,2020,2976,52,43,3071
51109,2021,2694,96,89,2879
51111,2010,1154,94,3,1251
51111,2011,1204,56,3,1263
51111,2012,1155,32,4,1191
51111,2013,1128,16,4,1148
51111,2014,1205,16,4,1225
51111,2015,1190,9,0,1199
51111,2016,1351,0,0,1351
51111,2017,1253,0,0,1253
51111,2018,1243,0,0,1243
51111,2019,1211,0,0,1211
51111,2020,1285,0,0,1285
51111,2021,1346,0,0,1346
51113,2010,992,62,0,1054
51113,2011,1075,30,0,1105
51113,2012,1055,9,0,1064
51113,2013,992,64,0,1056
51113,2014,1111,56,0,1167
51113,2015,1368,49,0,1417
51113,2016,1385,48,18,1451
51113,2017,1358,45,17,1420
51113,2018,1364,5,16,1385
51113,2019,1264,4,17,1285
51113,2020,1094,6,22,1122
51113,2021,913,0,0,913
51115,2010,642,15,13,670
51115,2011,642,14,12,668
51115,2012,786,15,12,813
51115,2013,778,58,0,836
51115,2014,710,85,0,795
51115,2015,654,75,0,729
51115,2016,591,104,0,695
51115,2017,518,104,0,622
51115,2018,502,52,0,554
51115,2019,589,31,0,620
51115,2020,634,42,0,676
51115,2021,564,0,0,564
51117,2010,3131,302,5,3438
51117,2011,3201,290,0,3491
51117,2012,3438,179,0,3617
51117,2013,3368,127,0,3495
51117,2014,3449,54,0,3503
51117,2015,3240,40,0,3280
51117,2016,3406,18,0,3424
51117,2017,3282,35,0,3317
51117,2018,3558,43,0,3601
51117,2019,3495,119,0,3614
51117,2020,3409,107,0,3516
51117,2021,3654,105,0,3759
51119,2010,814,83,50,947
51119,2011,800,56,54,910
51119,2012,740,39,67,846
51119,2013,794,39,68,901
51119,2014,741,46,66,853
51119,2015,729,20,39,788
51119,2016,796,19,38,853
51119,2017,863,33,0,896
51119,2018,869,35,26,930
51119,2019,982,43,38,1063
51119,2020,1018,37,38,1093
51119,2021,714,45,40,799
51121,2010,14982,473,670,16125
51121,2011,15549,462,582,16593
51121,2012,15888,451,597,16936
51121,2013,15777,601,587,16965
51121,2014,15953,628,748,17329
51121,2015,16106,587,623,17316
51121,2016,16571,620,721,17912
51121,2017,16057,849,848,17754
51121,2018,15953,847,959,17759
51121,2019,15927,867,1012,17806
51121,2020,15770,946,1192,17908
51121,2021,15883,794,1316,17993
51125,2010,1448,195,0,1643
51125,2011,1632,119,0,1751
51125,2012,1464,178,0,1642
51125,2013,1548,232,0,1780
51125,2014,1666,202,0,1868
51125,2015,1771,215,52,2038
51125,2016,1729,213,53,1995
51125,2017,1838,132,52,2022
51125,2018,1658,133,61,1852
51125,2019,1515,152,60,1727
51125,2020,1593,104,17,1714
51125,2021,1424,107,13,1544
51127,2010,648,0,34,682
51127,2011,599,0,43,642
51127,2012,700,0,37,737
51127,2013,759,0,0,759
51127,2014,853,16,0,869
51127,2015,1059,19,0,1078
51127,2016,1202,21,0,1223
51127,2017,1373,21,0,1394
51127,2018,1148,18,0,1166
51127,2019,1075,0,0,1075
51127,2020,815,54,0,869
51127,2021,838,61,0,899
51131,2010,1471,47,37,1555
51131,2011,1588,44,29,1661
51131,2012,1538,59,25,1622
51131,2013,1616,25,29,1670
51131,2014,1575,14,0,1589
51131,2015,1634,18,0,1652
51131,2016,1663,19,0,1682
51131,2017,1833,3,0,1836
51131,2018,1780,8,0,1788
51131,2019,1792,8,0,1800
51131,2020,1907,2,0,1909
51131,2021,1974,3,0,1977
51133,2010,859,79,0,938
51133,2011,943,73,0,1016
51133,2012,845,70,0,915
51133,2013,852,38,0,890
51133,2014,939,63,0,1002
51133,2015,955,105,0,1060
51133,2016,786,81,0,867
51133,2017,857,83,0,940
51133,2018,834,82,0,916
51133,2019,603,16,0,619
51133,2020,605,0,0,605
51133,2021,562,61,0,623
51135,2010,1999,42,38,2079
51135,2011,1800,63,46,1909
51135,2012,1763,69,0,1832
51135,2013,1999,58,0,2057
51135,2014,2031,106,0,2137
51135,2015,1938,132,0,2070
51135,2016,2098,131,0,2229
51135,2017,2315,96,0,2411
51135,2018,2146,99,0,2245
51135,2019,1924,48,0,1972
51135,2020,1820,0,0,1820
51135,2021,1526,10,0,1536
51137,2010,2732,227,0,2959
51137,2011,2992,360,0,3352
51137,2012,2839,388,80,3307
51137,2013,3045,341,117,3503
51137,2014,2890,323,112,3325
51137,2015,3141,255,111,3507
51137,2016,2914,120,110,3144
51137,2017,3064,37,45,3146
51137,2018,3005,91,0,3096
51137,2019,2902,33,9,2944
51137,2020,3036,28,7,3071
51137,2021,2960,30,8,2998
51139,2010,2347,74,37,2458
51139,2011,2355,116,14,2485
51139,2012,2393,170,15,2578
51139,2013,2693,201,17,2911
51139,2014,2762,274,24,3060
51139,2015,2776,249,23,3048
51139,2016,2811,235,25,3071
51139,2017,2942,154,30,3126
51139,2018,2792,139,28,2959
51139,2019,2686,101,0,2787
51139,2020,2653,109,0,2762
51139,2021,2729,110,0,2839
51141,2010,1371,340,110,1821
51141,2011,1453,340,137,1930
51141,2012,1646,357,116,2119
51141,2013,1805,357,69,2231
51141,2014,1838,311,67,2216
51141,2015,1816,260,25,2101
51141,2016,1791,273,0,2064
51141,2017,1771,228,0,1999
51141,2018,1807,158,9,1974
51141,2019,1631,106,9,1746
51141,2020,1766,102,9,1877
51141,2021,1681,101,18,1800
51143,2010,5469,368,99,5936
51143,2011,5365,413,120,5898
51143,2012,5238,411,117,5766
51143,2013,5305,317,183,5805
51143,2014,5609,294,277,6180
51143,2015,6083,196,280,6559
51143,2016,6233,239,173,6645
51143,2017,6619,275,158,7052
51143,2018,6580,281,73,6934
51143,2019,6467,278,40,6785
51143,2020,6339,421,100,6860
51143,2021,5781,350,88,6219
51145,2010,894,17,25,936
51145,2011,1062,13,26,1101
51145,2012,1049,13,3,1065
51145,2013,1078,0,3,1081
51145,2014,1165,0,3,1168
51145,2015,1231,0,3,1234
51145,2016,1129,0,0,1129
51145,2017,1020,0,0,1020
51145,2018,1059,0,0,1059
51145,2019,1012,0,0,1012
51145,2020,745,0,0,745
51145,2021,913,0,0,913
51147,2010,2676,106,0,2782
51147,2011,2517,147,0,2664
51147,2012,2248,120,0,2368
51147,2013,2597,105,0,2702
51147,2014,2583,66,0,2649
51147,2015,2608,63,0,2671
51147,2016,2583,0,0,2583
51147,2017,2559,0,0,2559
51147,2018,2379,15,0,2394
51147,2019,2560,62,0,2622
51147,2020,2723,75,0,2798
51147,2021,2727,79,0,2806
51149,2010,2581,456,0,3037
51149,2011,2584,358,0,2942
51149,2012,2753,445,0,3198
51149,2013,3045,400,3,3448
51149,2014,3223,384,8,3615
51149,2015,3267,190,8,3465
51149,2016,3524,181,18,3723
51149,2017,3588,118,24,3730
51149,2018,3767,135,16,3918
51149,2019,3733,192,13,3938
51149,2020,3698,244,13,3955
51149,2021,3697,273,7,3977
51153,2010,31507,2661,318,34486
51153,2011,32834,2414,593,35841
51153,2012,35237,2057,717,38011
51153,2013,36936,1865,824,39625
51153,2014,37980,1623,1024,40627
51153,2015,39050,1541,1226,41817
51153,2016,39810,1711,1333,42854
51153,2017,38358,2113,1328,41799
51153,2018,37662,2352,1327,41341
51153,2019,37939,2573,1088,41600
51153,2020,38827,2404,988,42219
51153,2021,39275,2529,907,42711
51155,2010,4006,284,97,4387
51155,2011,4086,278,166,4530
51155,2012,4206,160,133,4499
51155,2013,4059,133,122,4314
51155,2014,4089,163,113,4365
51155,2015,4203,310,51,4564
51155,2016,4098,297,0,4395
51155,2017,3962,310,12,4284
51155,2018,4018,372,22,4412
51155,2019,4163,314,45,4522
51155,2020,4482,282,45,4809
51155,2021,4469,273,55,4797
51157,2010,869,0,0,869
51157,2011,824,0,0,824
51157,2012,740,0,0,740
51157,2013,708,0,0,708
51157,2014,681,0,0,681
51157,2015,781,0,0,781
51157,2016,835,24,0,859
51157,2017,777,50,0,827
51157,2018,780,58,0,838
51157,2019,751,63,0,814
51157,2020,646,53,0,699
51157,2021,742,20,0,762
51159,2010,605,47,10,662
51159,2011,612,56,37,705
51159,2012,748,48,101,897
51159,2013,715,48,84,847
51159,2014,678,51,100,829
51159,2015,737,23,111,871
51159,2016,825,26,58,909
51159,2017,912,57,18,987
51159,2018,877,49,13,939
51159,2019,923,98,0,1021
51159,2020,1053,88,0,1141
51159,2021,914,104,0,1018
51161,2010,8432,469,65,8966
51161,2011,8709,373,134,9216
51161,2012,9011,578,88,9677
51161,2013,8830,596,83,9509
51161,2014,9448,525,88,10061
51161,2015,9668,607,166,10441
51161,2016,9830,567,112,10509
51161,2017,9683,506,98,10287
51161,2018,9940,568,71,10579
51161,2019,9631,532,66,10229
51161,2020,9687,604,39,10330
51161,2021,9685,511,58,10254
51163,2010,2212,121,52,2385
51163,2011,2458,240,113,2811
51163,2012,2471,277,62,2810
51163,2013,2473,181,49,2703
51163,2014,2298,152,101,2551
51163,2015,2392,162,100,2654
51163,2016,2101,112,81,2294
51163,2017,2120,141,79,2340
51163,2018,1946,209,173,2328
51163,2019,2290,180,115,2585
51163,2020,2328,160,141,2629
51163,2021,2135,176,122,2433
51165,2010,7501,304,115,7920
51165,2011,7014,343,125,7482
51165,2012,6886,402,110,7398
51165,2013,6837,398,93,7328
51165,2014,6954,503,95,7552
51165,2015,7176,539,30,7745
51165,2016,7735,525,29,8289
51165,2017,8152,490,15,8657
51165,2018,8114,407,17,8538
51165,2019,7914,263,138,8315
51165,2020,8017,244,122,8383
51165,2021,7501,196,167,7864
51167,2010,2648,111,37,2796
51167,2011,2636,159,69,2864
51167,2012,2550,256,66,2872
51167,2013,2441,281,45,2767
51167,2014,2438,280,31,2749
51167,2015,2431,350,37,2818
51167,2016,2432,360,0,2792
51167,2017,2459,299,0,2758
51167,2018,2622,323,0,2945
51167,2019,2580,274,0,2854
51167,2020,2768,259,0,3027
51167,2021,2470,186,0,2656
51169,2010,2207,245,14,2466
51169,2011,2130,122,19,2271
51169,2012,2094,173,4,2271
51169,2013,2231,161,4,2396
51169,2014,2002,253,4,2259
51169,2015,2090,210,4,2304
51169,2016,2122,238,0,2360
51169,2017,2045,288,0,2333
51169,2018,1934,297,0,2231
51169,2019,1986,209,0,2195
51169,2020,1792,235,5,2032
51169,2021,1697,200,30,1927
51171,2010,5277,373,61,5711
51171,2011,5090,446,97,5633
51171,2012,5009,337,169,5515
51171,2013,5138,264,129,5531
51171,2014,4865,328,140,5333
51171,2015,4679,308,167,5154
51171,2016,5033,276,94,5403
51171,2017,5227,293,18,5538
51171,2018,5086,216,14,5316
51171,2019,5058,185,15,5258
51171,2020,5322,214,14,5550
51171,2021,4854,238,14,5106
51173,2010,3518,399,116,4033
51173,2011,3626,460,131,4217
51173,2012,3668,496,141,4305
51173,2013,3700,458,99,4257
51173,2014,3906,349,41,4296
51173,2015,3853,350,45,4248
51173,2016,3869,224,39,4132
51173,2017,3814,210,27,4051
51173,2018,3688,219,53,3960
51173,2019,3616,178,51,3845
51173,2020,3793,170,21,3984
51173,2021,3976,201,22,4199
51175,2010,1567,147,15,1729
51175,2011,1734,108,0,1842
51175,2012,1762,163,0,1925
51175,2013,1893,115,0,2008
51175,2014,1877,151,0,2028
51175,2015,2026,111,0,2137
51175,2016,2117,142,0,2259
51175,2017,1891,114,52,2057
51175,2018,1751,128,57,1936
51175,2019,1652,86,64,1802
51175,2020,1695,70,51,1816
51175,2021,1601,73,81,1755
51177,2010,8250,536,131,8917
51177,2011,9078,558,105,9741
51177,2012,9095,692,147,9934
51177,2013,9391,638,192,10221
51177,2014,10076,553,234,10863
51177,2015,10234,623,165,11022
51177,2016,9856,798,177,10831
51177,2017,9797,905,77,10779
51177,2018,9754,950,126,10830
51177,2019,9736,978,66,10780
51177,2020,9526,919,58,10503
51177,2021,10315,850,68,11233
51179,2010,8681,705,98,9484
51179,2011,8605,814,117,9536
51179,2012,8926,879,87,9892
51179,2013,9743,673,65,10481
51179,2014,9994,664,68,10726
51179,2015,10091,654,112,10857
51179,2016,10981,585,95,11661
51179,2017,10968,490,113,11571
51179,2018,11039,471,143,11653
51179,2019,10648,506,195,11349
51179,2020,10894,502,101,11497
51179,2021,10819,652,190,11661
51181,2010,641,234,0,875
51181,2011,659,234,0,893
51181,2012,581,185,31,797
51181,2013,522,161,21,704
51181,2014,564,129,23,716
51181,2015,534,100,27,661
51181,2016,495,53,22,570
51181,2017,663,16,0,679
51181,2018,639,20,0,659
51181,2019,702,48,0,750
51181,2020,780,41,0,821
51181,2021,719,44,0,763
51183,2010,1252,347,0,1599
51183,2011,1285,428,0,1713
51183,2012,1252,405,0,1657
51183,2013,1104,334,0,1438
51183,2014,1137,256,0,1393
51183,2015,1088,135,0,1223
51183,2016,1337,82,0,1419
51183,2017,993,65,0,1058
51183,2018,1250,55,0,1305
51183,2019,1170,85,0,1255
51183,2020,1023,90,0,1113
51183,2021,1016,95,0,1111
51185,2010,4800,423,24,5247
51185,2011,4914,427,65,5406
51185,2012,5038,437,92,5567
51185,2013,4941,380,83,5404
51185,2014,4859,351,113,5323
51185,2015,4394,388,144,4926
51185,2016,4387,370,101,4858
51185,2017,4026,289,142,4457
51185,2018,4119,369,136,4624
51185,2019,4211,382,108,4701
51185,2020,4144,400,72,4616
51185,2021,4061,347,97,4505
51187,2010,3569,240,71,3880
51187,2011,3649,243,55,3947
51187,2012,4077,195,80,4352
51187,2013,3951,205,66,4222
51187,2014,3616,303,97,4016
51187,2015,3344,325,76,3745
51187,2016,3437,363,72,3872
51187,2017,3303,471,73,3847
51187,2018,3307,521,80,3908
51187,2019,3408,336,94,3838
51187,2020,3564,297,77,3938
51187,2021,3731,263,75,4069
51191,2010,5858,386,65,6309
51191,2011,5785,382,68,6235
51191,2012,5647,329,93,6069
51191,2013,5513,388,96,5997
51191,2014,5242,202,94,5538
51191,2015,5400,170,101,5671
51191,2016,5334,141,96,5571
51191,2017,5462,142,154,5758
51191,2018,5532,136,134,5802
51191,2019,5541,145,84,5770
51191,2020,5284,335,79,5698
51191,2021,5300,321,78,5699
51193,2010,1702,76,100,1878
51193,2011,1768,75,133,1976
51193,2012,1668,82,195,1945
51193,2013,1577,70,158,1805
51193,2014,1600,101,111,1812
51193,2015,1765,100,101,1966
51193,2016,1614,142,81,1837
51193,2017,1717,161,23,1901
51193,2018,1943,246,25,2214
51193,2019,2127,222,52,2401
51193,2020,2062,240,58,2360
51193,2021,1932,207,61,2200
51195,2010,4777,413,19,5209
51195,2011,4638,427,40,5105
51195,2012,4800,361,22,5183
51195,2013,4493,436,23,4952
51195,2014,4778,415,23,5216
51195,2015,4627,498,45,5170
51195,2016,4778,615,21,5414
51195,2017,4649,566,36,5251
51195,2018,5146,465,51,5662
51195,2019,4979,552,58,5589
51195,2020,4654,473,21,5148
51195,2021,4092,266,22,4380
51197,2010,2684,341,112,3137
51197,2011,3047,280,183,3510
51197,2012,3229,251,268,3748
51197,2013,3071,314,284,3669
51197,2014,3499,213,259,3971
51197,2015,3593,284,189,4066
51197,2016,3396,334,137,3867
51197,2017,2856,413,99,3368
51197,2018,2843,289,108,3240
51197,2019,2640,238,64,2942
51197,2020,2854,182,65,3101
51197,2021,2809,83,25,2917
51199,2010,5131,467,354,5952
51199,2011,5524,513,348,6385
51199,2012,5809,563,487,6859
51199,2013,6003,838,460,7301
51199,2014,6351,932,329,7612
51199,2015,6485,796,299,7580
51199,2016,6665,844,416,7925
51199,2017,6786,838,146,7770
51199,2018,6941,927,81,7949
51199,2019,7207,942,103,8252
51199,2020,7134,1004,124,8262
51199,2021,6971,903,24,7898
51510,2010,34635,1977,2149,38761
51510,2011,35349,1819,2199,39367
51510,2012,36326,1566,2162,40054
51510,2013,37032,1540,2476,41048
51510,2014,37770,1649,2537,41956
51510,2015,38469,1644,2200,42313
51510,2016,39353,1852,1649,42854
51510,2017,39087,1883,1311,42281
51510,2018,39990,1703,839,42532
51510,2019,40045,1511,675,42231
51510,2020,40358,1344,686,42388
51510,2021,42367,1799,805,44971
51515,2010,930,0,38,968
51515,2011,1041,0,0,1041
51515,2012,1070,29,0,1099
51515,2013,1156,84,0,1240
51520,2010,3039,140,41,3220
51520,2011,3104,156,0,3260
51520,2012,3211,172,48,3431
51520,2013,3179,271,42,3492
51520,2014,3472,304,39,3815
51520,2015,3461,263,41,3765
51520,2016,3248,359,39,3646
51520,2017,3046,379,0,3425
51520,2018,3040,341,0,3381
51520,2019,2905,218,0,3123
51520,2020,2882,278,23,3183
51520,2021,2752,276,66,3094
51530,2010,948,37,0,985
51530,2011,969,109,0,1078
51530,2012,913,94,0,1007
51530,2013,928,101,0,1029
51530,2014,984,120,0,1104
51530,2015,1132,143,0,1275
51530,2016,1101,130,0,1231
51530,2017,983,140,28,1151
51530,2018,845,85,40,970
51530,2019,806,63,37,906
51530,2020,970,27,48,1045
51530,2021,1167,0,65,1232
51540,2010,10147,613,167,10927
51540,2011,10208,628,138,10974
51540,2012,10258,714,259,11231
51540,2013,10372,740,308,11420
51540,2014,10275,724,319,11318
51540,2015,10017,578,435,11030
51540,2016,10401,543,506,11450
51540,2017,10292,394,431,11117
51540,2018,10568,321,320,11209
51540,2019,10640,336,255,11231
51540,2020,11264,364,150,11778
51540,2021,11333,403,142,11878
51550,2010,19790,671,311,20772
51550,2011,20238,779,305,21322
51550,2012,21505,1035,288,22828
51550,2013,21842,1323,384,23549
51550,2014,22744,1460,379,24583
51550,2015,24144,1438,390,25972
51550,2016,24722,1612,396,26730
51550,2017,24188,1879,388,26455
51550,2018,24147,1597,343,26087
51550,2019,24309,1717,333,26359
51550,2020,23934,1536,294,25764
51550,2021,24443,1313,190,25946
51570,2010,2423,459,0,2882
51570,2011,2477,422,0,2899
51570,2012,2392,435,0,2827
51570,2013,2524,389,30,2943
51570,2014,2483,316,34,2833
51570,2015,2645,128,40,2813
51570,2016,2856,37,41,2934
51570,2017,2621,36,35,2692
51570,2018,2570,85,0,2655
51570,2019,2610,125,0,2735
51570,2020,2420,83,0,2503
51570,2021,2536,78,0,2614
51580,2010,827,68,24,919
51580,2011,756,66,29,851
51580,2012,810,74,24,908
51580,2013,690,38,25,753
51580,2014,615,33,69,717
51580,2015,642,109,45,796
51580,2016,616,178,45,839
51580,2017,594,179,45,818
51580,2018,638,173,46,857
51580,2019,609,163,0,772
51580,2020,586,84,0,670
51580,2021,623,5,0,628
51590,2010,8825,987,540,10352
51590,2011,8512,1015,516,10043
51590,2012,8691,1089,274,10054
51590,2013,8503,1050,89,9642
51590,2014,8497,929,157,9583
51590,2015,8546,854,182,9582
51590,2016,8588,614,177,9379
51590,2017,8673,657,169,9499
51590,2018,8601,720,228,9549
51590,2019,8873,812,131,9816
51590,2020,9086,892,64,10042
51590,2021,9115,846,58,10019
51595,2010,1242,55,0,1297
51595,2011,1309,24,0,1333
51595,2012,1386,30,0,1416
51595,2013,1356,45,0,1401
51595,2014,1469,32,0,1501
51595,2015,1409,32,0,1441
51595,2016,1337,58,0,1395
51595,2017,1217,50,0,1267
51595,2018,1240,35,0,1275
51595,2019,1249,81,0,1330
51595,2020,1224,73,0,1297
51595,2021,1334,75,0,1409
51600,2010,2376,87,0,2463
51600,2011,2590,98,24,2712
51600,2012,2561,55,23,2639
51600,2013,2680,119,18,2817
51600,2014,2536,122,26,2684
51600,2015,2542,100,67,2709
51600,2016,2484,99,49,2632
51600,2017,2550,114,45,2709
51600,2018,2487,101,47,2635
51600,2019,2573,110,49,2732
51600,2020,2636,98,0,2734
51600,2021,2702,51,0,2753
51610,2010,1700,201,0,1901
51610,2011,1841,269,0,2110
51610,2012,1833,210,0,2043
51610,2013,2039,224,0,2263
51610,2014,2033,297,0,2330
51610,2015,2135,206,0,2341
51610,2016,2139,197,0,2336
51610,2017,2130,288,0,2418
51610,2018,2019,341,0,2360
51610,2019,2289,270,0,2559
51610,2020,2319,308,0,2627
51610,2021,2401,279,25,2705
51620,2010,1893,60,0,1953
51620,2011,1997,64,0,2061
51620,2012,2017,90,19,2126
51620,2013,2042,97,31,2170
51620,2014,2021,52,39,2112
51620,2015,1805,40,57,1902
51620,2016,1721,83,40,1844
51620,2017,1744,61,0,1805
51620,2018,1771,76,0,1847
51620,2019,1706,100,0,1806
51620,2020,1559,176,0,1735
51620,2021,1672,131,0,1803
51630,2010,5614,442,68,6124
51630,2011,5722,573,41,6336
51630,2012,6055,477,88,6620
51630,2013,6058,490,178,6726
51630,2014,6288,578,227,7093
51630,2015,6607,538,249,7394
51630,2016,6696,391,281,7368
51630,2017,6673,340,256,7269
51630,2018,6753,394,158,7305
51630,2019,6945,285,205,7435
51630,2020,6661,305,147,7113
51630,2021,6809,320,127,7256
51640,2010,1221,160,0,1381
51640,2011,1298,196,0,1494
51640,2012,1186,184,0,1370
51640,2013,1053,197,19,1269
51640,2014,1211,152,33,1396
51640,2015,1196,173,18,1387
51640,2016,1203,190,17,1410
51640,2017,1163,209,18,1390
51640,2018,943,152,0,1095
51640,2019,849,152,0,1001
51640,2020,840,113,0,953
51640,2021,873,76,0,949
51650,2010,21710,2169,1491,25370
51650,2011,20502,2668,1730,24900
51650,2012,20883,2710,1740,25333
51650,2013,20951,2559,1784,25294
51650,2014,21732,2438,1590,25760
51650,2015,22454,2466,1205,26125
51650,2016,23506,1862,884,26252
51650,2017,23084,1939,679,25702
51650,2018,23533,2034,440,26007
51650,2019,23927,1975,354,26256
51650,2020,23614,1841,271,25726
51650,2021,25361,1822,248,27431
51660,2010,9195,311,700,10206
51660,2011,9512,412,813,10737
51660,2012,9747,448,907,11102
51660,2013,10021,401,905,11327
51660,2014,10210,415,908,11533
51660,2015,10483,294,671,11448
51660,2016,10402,267,558,11227
51660,2017,10403,353,433,11189
51660,2018,10370,398,485,11253
51660,2019,10102,442,516,11060
51660,2020,9961,469,472,10902
51660,2021,10349,461,516,11326
51670,2010,4307,781,25,5113
51670,2011,4418,924,0,5342
51670,2012,4266,934,0,5200
51670,2013,4347,901,0,5248
51670,2014,4140,764,0,4904
51670,2015,4236,743,0,4979
51670,2016,4422,538,28,4988
51670,2017,4470,430,28,4928
51670,2018,4621,283,93,4997
51670,2019,4912,310,97,5319
51670,2020,4955,249,87,5291
51670,2021,4657,194,43,4894
51678,2010,1029,0,40,1069
51678,2011,847,36,36,919
51678,2012,821,37,39,897
51678,2013,760,40,90,890
51678,2014,791,38,103,932
51678,2015,697,58,94,849
51678,2016,814,68,86,968
51678,2017,788,78,80,946
51678,2018,934,98,45,1077
51678,2019,1027,64,0,1091
51678,2020,936,92,0,1028
51678,2021,926,123,0,1049
51680,2010,12168,854,299,13321
51680,2011,12717,750,230,13697
51680,2012,12978,785,372,14135
51680,2013,13495,859,489,14843
51680,2014,13629,932,532,15093
51680,2015,14070,872,774,15716
51680,2016,13991,1012,748,15751
51680,2017,14172,846,606,15624
51680,2018,14116,886,548,15550
51680,2019,14499,984,461,15944
51680,2020,14173,1233,261,15667
51680,2021,14731,1583,320,16634
51683,2010,3729,378,35,4142
51683,2011,3989,345,100,4434
51683,2012,4169,315,90,4574
51683,2013,4207,327,135,4669
51683,2014,4338,273,177,4788
51683,2015,4445,250,136,4831
51683,2016,4703,285,134,5122
51683,2017,4561,196,142,4899
51683,2018,4448,193,163,4804
51683,2019,4368,216,111,4695
51683,2020,4008,247,126,4381
51683,2021,3954,179,62,4195
51685,2010,1213,122,43,1378
51685,2011,1371,135,56,1562
51685,2012,1461,85,101,1647
51685,2013,1610,64,104,1778
51685,2014,1633,55,76,1764
51685,2015,1477,0,70,1547
51685,2016,1618,33,62,1713
51685,2017,1554,31,44,1629
51685,2018,1608,27,84,1719
51685,2019,1582,17,135,1734
51685,2020,1806,68,92,1966
51685,2021,1990,65,94,2149
51690,2010,2403,487,39,2929
51690,2011,2514,446,42,3002
51690,2012,2679,330,62,3071
51690,2013,2775,264,18,3057
51690,2014,2691,284,21,2996
51690,2015,2761,366,25,3152
51690,2016,2726,249,51,3026
51690,2017,2575,318,45,2938
51690,2018,2347,326,175,2848
51690,2019,2439,350,198,2987
51690,2020,2476,321,203,3000
51690,2021,2392,289,156,2837
51700,2010,33822,2795,300,36917
51700,2011,33698,3062,304,37064
51700,2012,33719,3500,337,37556
51700,2013,33610,3318,540,37468
51700,2014,34057,3387,877,38321
51700,2015,34379,3267,903,38549
51700,2016,35007,3354,893,39254
51700,2017,34320,3645,861,38826
51700,2018,35281,3744,535,39560
51700,2019,35675,4063,263,40001
51700,2020,36362,3463,306,40131
51700,2021,39324,2940,294,42558
51710,2010,45386,3163,1814,50363
51710,2011,45607,3618,1508,50733
51710,2012,46358,3552,1119,51029
51710,2013,47491,3813,814,52118
51710,2014,48666,3673,513,52852
51710,2015,49192,3564,459,53215
51710,2016,49971,3492,467,53930
51710,2017,49395,3726,542,53663
51710,2018,50126,3426,538,54090
51710,2019,50014,3492,613,54119
51710,2020,50545,3206,612,54363
51710,2021,52438,2790,577,55805
51720,2010,812,83,0,895
51720,2011,791,90,0,881
51720,2012,813,87,0,900
51720,2013,807,80,26,913
51720,2014,777,65,23,865
51720,2015,875,20,21,916
51720,2016,1016,0,18,1034
51720,2017,918,10,21,949
51720,2018,976,11,46,1033
51720,2019,813,38,47,898
51720,2020,905,36,50,991
51720,2021,681,45,48,774
51730,2010,6053,3211,8,9272
51730,2011,6347,3443,0,9790
51730,2012,6521,3309,0,9830
51730,2013,6762,2728,27,9517
51730,2014,6932,2577,37,9546
51730,2015,7502,2043,38,9583
51730,2016,7746,1283,102,9131
51730,2017,7730,842,155,8727
51730,2018,7898,757,127,8782
51730,2019,8053,525,155,8733
51730,2020,8460,543,180,9183
51730,2021,9268,759,126,10153
51735,2010,689,52,0,741
51735,2011,740,61,0,801
51735,2012,704,71,0,775
51735,2013,836,33,0,869
51735,2014,864,0,0,864
51735,2015,831,0,0,831
51735,2016,780,0,0,780
51735,2017,924,0,0,924
51735,2018,766,0,0,766
51735,2019,853,0,0,853
51735,2020,840,20,0,860
51735,2021,835,20,0,855
51740,2010,14355,797,172,15324
51740,2011,14392,947,196,15535
51740,2012,15101,1100,229,16430
51740,2013,15693,1215,268,17176
51740,2014,16236,1205,341,17782
51740,2015,16628,1372,409,18409
51740,2016,17020,1291,356,18667
51740,2017,16680,1328,367,18375
51740,2018,16661,1308,306,18275
51740,2019,16371,1221,244,17836
51740,2020,16393,912,170,17475
51740,2021,17090,902,206,18198
51750,2010,2740,71,290,3101
51750,2011,2900,84,345,3329
51750,2012,2894,177,301,3372
51750,2013,2970,298,232,3500
51750,2014,2815,353,246,3414
51750,2015,3082,368,254,3704
51750,2016,3153,377,205,3735
51750,2017,2944,368,256,3568
51750,2018,2762,227,415,3404
51750,2019,2977,228,364,3569
51750,2020,2941,208,389,3538
51750,2021,3010,176,444,3630
51760,2010,45991,3469,488,49948
51760,2011,46041,4107,412,50560
51760,2012,46870,4701,374,51945
51760,2013,48286,4872,498,53656
51760,2014,49209,4607,768,54584
51760,2015,50349,4136,916,55401
51760,2016,52129,3304,1191,56624
51760,2017,52048,2518,1362,55928
51760,2018,51890,2314,1350,55554
51760,2019,51807,2544,1195,55546
51760,2020,51204,2607,1115,54926
51760,2021,55956,3176,1464,60596
51770,2010,18828,1000,244,20072
51770,2011,18680,944,155,19779
51770,2012,18906,983,112,20001
51770,2013,19223,1067,154,20444
51770,2014,19345,1034,263,20642
51770,2015,19551,1282,308,21141
51770,2016,20384,1579,296,22259
51770,2017,20356,1819,300,22475
51770,2018,20254,1962,227,22443
51770,2019,20261,2124,93,22478
51770,2020,19902,2149,131,22182
51770,2021,20551,2285,197,23033
51775,2010,3090,296,41,3427
51775,2011,3085,294,47,3426
51775,2012,3272,285,87,3644
51775,2013,3309,256,131,3696
51775,2014,3244,164,99,3507
51775,2015,3394,220,87,3701
51775,2016,3596,173,96,3865
51775,2017,3446,264,36,3746
51775,2018,3466,374,14,3854
51775,2019,3610,295,0,3905
51775,2020,3511,301,0,3812
51775,2021,3450,336,0,3786
51790,2010,4118,400,0,4518
51790,2011,4143,352,26,4521
51790,2012,4364,286,32,4682
51790,2013,4441,419,33,4893
51790,2014,4427,395,31,4853
51790,2015,4487,441,27,4955
51790,2016,4355,582,5,4942
51790,2017,4451,580,0,5031
51790,2018,4546,485,67,5098
51790,2019,4525,485,67,5077
51790,2020,4366,450,64,4880
51790,2021,4593,287,125,5005
51800,2010,7488,487,88,8063
51800,2011,7536,528,73,8137
51800,2012,7713,548,58,8319
51800,2013,8119,605,65,8789
51800,2014,8754,571,88,9413
51800,2015,9108,631,98,9837
51800,2016,9749,689,84,10522
51800,2017,9951,716,132,10799
51800,2018,10197,577,112,10886
51800,2019,10556,602,67,11225
51800,2020,10262,513,57,10832
51800,2021,10668,445,127,11240
51810,2010,54845,2012,1532,58389
51810,2011,55876,2284,1507,59667
51810,2012,57716,2453,1503,61672
51810,2013,59105,2784,1433,63322
51810,2014,59297,3416,1391,64104
51810,2015,60641,3553,1244,65438
51810,2016,61676,3428,1283,66387
51810,2017,60635,3796,1248,65679
51810,2018,60804,3173,1294,65271
51810,2019,61983,2864,1263,66110
51810,2020,60935,3269,1211,65415
51810,2021,62048,3297,957,66302
51820,2010,3526,339,97,3962
51820,2011,3621,260,93,3974
51820,2012,3526,314,77,3917
51820,2013,3641,328,37,4006
51820,2014,3772,255,26,4053
51820,2015,3816,217,40,4073
51820,2016,3807,220,49,4076
51820,2017,3752,156,54,3962
51820,2018,3785,147,65,3997
51820,2019,3889,212,64,4165
51820,2020,3751,305,53,4109
51820,2021,3791,298,52,4141
51830,2010,2054,247,138,2439
51830,2011,2376,258,110,2744
51830,2012,2422,216,132,2770
51830,2013,2429,194,146,2769
51830,2014,2342,96,113,2551
51830,2015,2452,49,78,2579
51830,2016,2470,71,70,2611
51830,2017,2451,147,46,2644
51830,2018,2369,223,58,2650
51830,2019,2386,269,56,2711
51830,2020,2145,311,108,2564
51830,2021,2314,356,92,2762
51840,2010,5048,790,61,5899
51840,2011,5093,773,48,5914
51840,2012,5283,576,45,5904
51840,2013,5338,668,77,6083
51840,2014,5597,534,26,6157
51840,2015,5850,452,48,6350
51840,2016,5774,475,102,6351
51840,2017,5718,432,109,6259
51840,2018,5604,360,119,6083
51840,2019,5848,436,131,6415
51840,2020,5902,468,178,6548
51840,2021,6030,486,156,6672
