year,locality,fips,race,est_all,est_owner,est_renter,moe_all,moe_owner,moe_renter
2010,Accomack County,51001,All,14085,10436,3649,488,436,400
2010,Albemarle County,51003,All,37459,24510,12949,568,510,645
2010,Alleghany County,51005,All,6964,5758,1206,225,227,179
2010,Amelia County,51007,All,4901,4080,821,196,261,208
2010,Amherst County,51009,All,12706,9576,3130,365,325,367
2010,Appomattox County,51011,All,5976,4539,1437,204,234,229
2010,Arlington County,51013,All,91892,43168,48724,1246,891,1399
2010,Augusta County,51015,All,27909,22683,5226,486,532,426
2010,Bath County,51017,All,2025,1761,264,192,226,140
2010,Bedford County,51019,All,27150,22933,4217,410,495,425
2010,Bland County,51021,All,2580,2189,391,217,205,117
2010,Botetourt County,51023,All,12918,11264,1654,279,307,249
2010,Brunswick County,51025,All,6086,4263,1823,377,304,250
2010,Buchanan County,51027,All,9123,7254,1869,305,345,267
2010,Buckingham County,51029,All,4859,3632,1227,1425,769,713
2010,Campbell County,51031,All,22005,16657,5348,373,434,375
2010,Caroline County,51033,All,10270,8517,1753,270,296,275
2010,Carroll County,51035,All,12818,9770,3048,428,450,397
2010,Charles City County,51036,All,2713,2306,407,112,125,81
2010,Charlotte County,51037,All,4415,3440,975,276,265,188
2010,Chesterfield County,51041,All,112404,88092,24312,743,1049,1025
2010,Clarke County,51043,All,5535,4195,1340,181,230,206
2010,Craig County,51045,All,1989,1704,285,172,150,115
2010,Culpeper County,51047,All,15834,11498,4336,394,426,376
2010,Cumberland County,51049,All,3969,3089,880,195,225,189
2010,Dickenson County,51051,All,6170,4972,1198,232,271,206
2010,Dinwiddie County,51053,All,9800,7427,2373,254,291,281
2010,Essex County,51057,All,4466,3341,1125,242,217,194
2010,Fairfax County,51059,All,381768,274448,107320,1481,2217,1651
2010,Fauquier County,51061,All,22369,17633,4736,513,494,453
2010,Floyd County,51063,All,6334,4970,1364,250,283,238
2010,Fluvanna County,51065,All,9128,7957,1171,269,314,223
2010,Franklin County,51067,All,23355,18324,5031,462,588,495
2010,Frederick County,51069,All,28558,22495,6063,450,646,489
2010,Giles County,51071,All,7100,5527,1573,255,262,210
2010,Gloucester County,51073,All,14014,11544,2470,342,407,346
2010,Goochland County,51075,All,6831,6233,598,957,700,330
2010,Grayson County,51077,All,6858,5573,1285,243,241,211
2010,Greene County,51079,All,6709,5357,1352,237,313,270
2010,Greensville County,51081,All,3385,2525,860,176,189,156
2010,Halifax County,51083,All,14650,11124,3526,435,473,435
2010,Hanover County,51085,All,36114,30301,5813,463,567,568
2010,Henrico County,51087,All,121767,81504,40263,934,1059,974
2010,Henry County,51089,All,22909,17396,5513,479,584,483
2010,Highland County,51091,All,1130,866,264,96,117,85
2010,Isle of Wight County,51093,All,13553,10995,2558,223,272,274
2010,James City County,51095,All,25851,19772,6079,415,486,448
2010,King and Queen County,51097,All,2815,2263,552,183,200,144
2010,King George County,51099,All,8194,6261,1933,360,307,344
2010,King William County,51101,All,5909,5049,860,167,198,190
2010,Lancaster County,51103,All,5421,4180,1241,224,222,196
2010,Lee County,51105,All,9836,7263,2573,291,291,268
2010,Loudoun County,51107,All,95330,77022,18308,902,984,712
2010,Louisa County,51109,All,13253,10367,2886,368,386,363
2010,Lunenburg County,51111,All,4515,3361,1154,234,220,214
2010,Madison County,51113,All,5213,4221,992,187,271,214
2010,Mathews County,51115,All,3773,3131,642,282,216,203
2010,Mecklenburg County,51117,All,12594,9463,3131,409,340,301
2010,Middlesex County,51119,All,4303,3489,814,277,238,190
2010,Montgomery County,51121,All,34369,19387,14982,739,485,845
2010,Nelson County,51125,All,6534,5086,1448,281,331,327
2010,New Kent County,51127,All,6513,5865,648,231,220,169
2010,Northampton County,51131,All,5088,3617,1471,275,237,208
2010,Northumberland County,51133,All,5478,4619,859,310,268,236
2010,Nottoway County,51135,All,5607,3608,1999,253,272,273
2010,Orange County,51137,All,12669,9937,2732,331,332,279
2010,Page County,51139,All,9629,7282,2347,283,324,322
2010,Patrick County,51141,All,7344,5973,1371,323,317,251
2010,Pittsylvania County,51143,All,26563,21094,5469,500,550,562
2010,Powhatan County,51145,All,8637,7743,894,978,844,292
2010,Prince Edward County,51147,All,7314,4638,2676,435,277,417
2010,Prince George County,51149,All,10474,7893,2581,508,416,341
2010,Prince William County,51153,All,124879,93372,31507,1133,1231,1020
2010,Pulaski County,51155,All,14898,10892,4006,392,404,354
2010,Rappahannock County,51157,All,3163,2294,869,171,159,192
2010,Richmond County,51159,All,3007,2402,605,399,325,157
2010,Roanoke County,51161,All,37833,29401,8432,472,588,487
2010,Rockbridge County,51163,All,9372,7160,2212,240,299,283
2010,Rockingham County,51165,All,29701,22200,7501,445,488,473
2010,Russell County,51167,All,11529,8881,2648,299,340,371
2010,Scott County,51169,All,9610,7403,2207,316,356,279
2010,Shenandoah County,51171,All,17316,12039,5277,397,413,431
2010,Smyth County,51173,All,12992,9474,3518,371,329,300
2010,Southampton County,51175,All,6571,5004,1567,213,231,195
2010,Spotsylvania County,51177,All,41009,32759,8250,569,732,608
2010,Stafford County,51179,All,40183,31502,8681,754,768,529
2010,Surry County,51181,All,2481,1840,641,197,166,175
2010,Sussex County,51183,All,3796,2544,1252,210,177,211
2010,Tazewell County,51185,All,18015,13215,4800,367,429,448
2010,Warren County,51187,All,14160,10591,3569,328,431,364
2010,Washington County,51191,All,22711,16853,5858,468,484,466
2010,Westmoreland County,51193,All,7135,5433,1702,316,265,285
2010,Wise County,51195,All,15750,10973,4777,394,424,406
2010,Wythe County,51197,All,11665,8981,2684,403,441,347
2010,York County,51199,All,24002,18871,5131,799,476,531
2010,Alexandria city,51510,All,63738,29103,34635,831,872,891
2010,Bedford County,51019,All,2782,1852,930,166,214,174
2010,Bristol city,51520,All,7948,4909,3039,275,301,350
2010,Buena Vista city,51530,All,2693,1745,948,144,179,183
2010,Charlottesville city,51540,All,17290,7143,10147,974,366,989
2010,Chesapeake city,51550,All,78778,58988,19790,564,772,751
2010,Colonial Heights city,51570,All,7075,4652,2423,226,209,261
2010,Covington city,51580,All,2641,1814,827,139,134,172
2010,Danville city,51590,All,19448,10623,8825,511,423,506
2010,Emporia city,51595,All,2406,1164,1242,172,163,162
2010,Fairfax city,51600,All,8524,6148,2376,130,244,222
2010,Falls Church city,51610,All,4706,3006,1700,165,182,200
2010,Franklin city,51620,All,3524,1631,1893,166,187,176
2010,Fredericksburg city,51630,All,9206,3592,5614,389,321,447
2010,Galax city,51640,All,3326,2105,1221,472,416,257
2010,Hampton city,51650,All,53283,31573,21710,659,730,727
2010,Harrisonburg city,51660,All,14965,5770,9195,589,378,621
2010,Hopewell city,51670,All,8914,4607,4307,250,325,306
2010,Lexington city,51678,All,2108,1079,1029,387,241,258
2010,Lynchburg city,51680,All,27875,15707,12168,617,548,679
2010,Manassas city,51683,All,11732,8003,3729,326,348,350
2010,Manassas Park city,51685,All,4206,2993,1213,168,210,198
2010,Martinsville city,51690,All,5922,3519,2403,237,226,229
2010,Newport News city,51700,All,70653,36831,33822,994,861,1002
2010,Norfolk city,51710,All,85061,39675,45386,1295,909,1242
2010,Norton city,51720,All,1764,952,812,168,150,152
2010,Petersburg city,51730,All,12305,6252,6053,365,364,373
2010,Poquoson city,51735,All,4524,3835,689,88,171,150
2010,Portsmouth city,51740,All,37325,22970,14355,869,667,678
2010,Radford city,51750,All,5667,2927,2740,358,169,383
2010,Richmond city,51760,All,83498,37507,45991,1080,913,1028
2010,Roanoke city,51770,All,42833,24005,18828,618,638,712
2010,Salem city,51775,All,9890,6800,3090,343,282,355
2010,Staunton city,51790,All,10408,6290,4118,442,445,334
2010,Suffolk city,51800,All,30126,22638,7488,431,495,445
2010,Virginia Beach city,51810,All,163944,109099,54845,1354,1300,1489
2010,Waynesboro city,51820,All,8546,5020,3526,340,331,346
2010,Williamsburg city,51830,All,4069,2015,2054,370,154,361
2010,Winchester city,51840,All,10221,5173,5048,787,531,504
2011,Accomack County,51001,All,13757,10199,3558,506,368,406
2011,Albemarle County,51003,All,37398,24731,12667,579,507,697
2011,Alleghany County,51005,All,6935,5629,1306,220,227,191
2011,Amelia County,51007,All,5001,4049,952,190,247,241
2011,Amherst County,51009,All,12693,9634,3059,285,350,313
2011,Appomattox County,51011,All,5857,4417,1440,187,250,237
2011,Arlington County,51013,All,92436,43096,49340,1020,831,1105
2011,Augusta County,51015,All,28021,22814,5207,552,587,515
2011,Bath County,51017,All,1926,1633,293,206,226,127
2011,Bedford County,51019,All,26979,22704,4275,422,502,466
2011,Bland County,51021,All,2663,2234,429,237,226,133
2011,Botetourt County,51023,All,12789,11230,1559,294,359,252
2011,Brunswick County,51025,All,6126,4314,1812,550,278,446
2011,Buchanan County,51027,All,9135,7192,1943,341,320,280
2011,Buckingham County,51029,All,5699,4175,1524,605,486,329
2011,Campbell County,51031,All,21610,16322,5288,422,515,524
2011,Caroline County,51033,All,10476,8664,1812,264,353,274
2011,Carroll County,51035,All,12556,9737,2819,491,450,391
2011,Charles City County,51036,All,2747,2339,408,111,118,69
2011,Charlotte County,51037,All,4534,3513,1021,287,260,204
2011,Chesterfield County,51041,All,112895,88141,24754,739,1069,954
2011,Clarke County,51043,All,5564,4269,1295,169,203,205
2011,Craig County,51045,All,1976,1756,220,181,211,121
2011,Culpeper County,51047,All,15750,11476,4274,373,393,464
2011,Cumberland County,51049,All,3976,3023,953,204,231,193
2011,Dickenson County,51051,All,6183,4835,1348,258,245,200
2011,Dinwiddie County,51053,All,9598,7442,2156,246,280,249
2011,Essex County,51057,All,4420,3379,1041,232,210,194
2011,Fairfax County,51059,All,385570,273783,111787,1449,2220,1964
2011,Fauquier County,51061,All,22888,17983,4905,404,495,498
2011,Floyd County,51063,All,6148,4757,1391,282,349,270
2011,Fluvanna County,51065,All,9315,8109,1206,335,343,246
2011,Franklin County,51067,All,23581,18695,4886,512,475,497
2011,Frederick County,51069,All,28655,22508,6147,435,521,553
2011,Giles County,51071,All,7054,5494,1560,208,231,190
2011,Gloucester County,51073,All,13892,11680,2212,363,332,303
2011,Goochland County,51075,All,7822,7257,565,251,277,156
2011,Grayson County,51077,All,6760,5412,1348,357,298,227
2011,Greene County,51079,All,6802,5439,1363,230,324,275
2011,Greensville County,51081,All,3264,2360,904,459,320,248
2011,Halifax County,51083,All,14533,11072,3461,390,384,344
2011,Hanover County,51085,All,36489,30595,5894,268,523,459
2011,Henrico County,51087,All,122919,81438,41481,848,1024,913
2011,Henry County,51089,All,22871,17041,5830,461,465,487
2011,Highland County,51091,All,1110,890,220,83,89,72
2011,Isle of Wight County,51093,All,13528,10988,2540,234,348,293
2011,James City County,51095,All,26356,20000,6356,452,485,511
2011,King and Queen County,51097,All,2891,2325,566,155,161,124
2011,King George County,51099,All,8200,6133,2067,303,279,301
2011,King William County,51101,All,5985,4981,1004,154,166,193
2011,Lancaster County,51103,All,5570,4298,1272,217,179,223
2011,Lee County,51105,All,10001,7500,2501,370,418,284
2011,Loudoun County,51107,All,99761,78987,20774,874,882,792
2011,Louisa County,51109,All,13213,10299,2914,350,354,349
2011,Lunenburg County,51111,All,4471,3267,1204,335,304,201
2011,Madison County,51113,All,5185,4110,1075,189,252,221
2011,Mathews County,51115,All,3788,3146,642,276,242,186
2011,Mecklenburg County,51117,All,12547,9346,3201,403,414,323
2011,Middlesex County,51119,All,4339,3539,800,274,240,172
2011,Montgomery County,51121,All,34591,19042,15549,804,489,840
2011,Nelson County,51125,All,6539,4907,1632,349,326,323
2011,New Kent County,51127,All,6552,5953,599,208,215,159
2011,Northampton County,51131,All,5195,3607,1588,295,258,193
2011,Northumberland County,51133,All,5569,4626,943,357,294,269
2011,Nottoway County,51135,All,5571,3771,1800,229,261,273
2011,Orange County,51137,All,12614,9622,2992,374,406,322
2011,Page County,51139,All,9538,7183,2355,280,305,255
2011,Patrick County,51141,All,7191,5738,1453,369,344,260
2011,Pittsylvania County,51143,All,26325,20960,5365,481,484,466
2011,Powhatan County,51145,All,9468,8406,1062,303,296,216
2011,Prince Edward County,51147,All,7334,4817,2517,493,311,437
2011,Prince George County,51149,All,10725,8141,2584,623,445,470
2011,Prince William County,51153,All,127170,94336,32834,872,1165,1047
2011,Pulaski County,51155,All,14884,10798,4086,447,403,448
2011,Rappahannock County,51157,All,3310,2486,824,158,153,185
2011,Richmond County,51159,All,2909,2297,612,273,247,128
2011,Roanoke County,51161,All,37975,29266,8709,400,543,485
2011,Rockbridge County,51163,All,9291,6833,2458,264,326,298
2011,Rockingham County,51165,All,29711,22697,7014,435,450,417
2011,Russell County,51167,All,11302,8666,2636,373,353,306
2011,Scott County,51169,All,9701,7571,2130,282,272,269
2011,Shenandoah County,51171,All,17152,12062,5090,379,395,444
2011,Smyth County,51173,All,12681,9055,3626,311,337,312
2011,Southampton County,51175,All,6618,4884,1734,364,313,228
2011,Spotsylvania County,51177,All,41282,32204,9078,441,635,571
2011,Stafford County,51179,All,40691,32086,8605,519,675,615
2011,Surry County,51181,All,2547,1888,659,169,157,132
2011,Sussex County,51183,All,3600,2315,1285,356,258,260
2011,Tazewell County,51185,All,18019,13105,4914,413,446,452
2011,Warren County,51187,All,14203,10554,3649,331,407,420
2011,Washington County,51191,All,23064,17279,5785,461,457,407
2011,Westmoreland County,51193,All,7077,5309,1768,399,354,301
2011,Wise County,51195,All,15477,10839,4638,488,475,362
2011,Wythe County,51197,All,11610,8563,3047,393,439,431
2011,York County,51199,All,24259,18735,5524,396,385,397
2011,Alexandria city,51510,All,64217,28868,35349,773,850,927
2011,Bedford County,51019,All,2776,1735,1041,192,189,226
2011,Bristol city,51520,All,7873,4769,3104,235,284,315
2011,Buena Vista city,51530,All,2681,1712,969,130,188,206
2011,Charlottesville city,51540,All,17387,7179,10208,419,308,489
2011,Chesapeake city,51550,All,78898,58660,20238,523,892,904
2011,Colonial Heights city,51570,All,7136,4659,2477,205,228,260
2011,Covington city,51580,All,2546,1790,756,139,167,147
2011,Danville city,51590,All,18938,10426,8512,470,350,472
2011,Emporia city,51595,All,2525,1216,1309,170,175,172
2011,Fairfax city,51600,All,8470,5880,2590,131,236,234
2011,Falls Church city,51610,All,4807,2966,1841,182,171,200
2011,Franklin city,51620,All,3472,1475,1997,173,181,216
2011,Fredericksburg city,51630,All,9341,3619,5722,416,245,443
2011,Galax city,51640,All,3525,2227,1298,272,312,276
2011,Hampton city,51650,All,52667,32165,20502,759,753,809
2011,Harrisonburg city,51660,All,15179,5667,9512,454,373,536
2011,Hopewell city,51670,All,8859,4441,4418,307,271,312
2011,Lexington city,51678,All,1727,880,847,838,433,455
2011,Lynchburg city,51680,All,28513,15796,12717,483,509,580
2011,Manassas city,51683,All,11872,7883,3989,301,421,424
2011,Manassas Park city,51685,All,4238,2867,1371,200,193,195
2011,Martinsville city,51690,All,5958,3444,2514,251,224,255
2011,Newport News city,51700,All,69977,36279,33698,796,889,1027
2011,Norfolk city,51710,All,85076,39469,45607,976,770,978
2011,Norton city,51720,All,1750,959,791,167,145,146
2011,Petersburg city,51730,All,12179,5832,6347,381,326,391
2011,Poquoson city,51735,All,4525,3785,740,97,173,166
2011,Portsmouth city,51740,All,36899,22507,14392,840,701,683
2011,Radford city,51750,All,5644,2744,2900,304,211,351
2011,Richmond city,51760,All,83615,37574,46041,1175,959,1096
2011,Roanoke city,51770,All,42892,24212,18680,551,722,781
2011,Salem city,51775,All,9944,6859,3085,260,331,332
2011,Staunton city,51790,All,10517,6374,4143,299,273,321
2011,Suffolk city,51800,All,30305,22769,7536,497,529,457
2011,Virginia Beach city,51810,All,164041,108165,55876,1000,1264,1306
2011,Waynesboro city,51820,All,8750,5129,3621,220,285,316
2011,Williamsburg city,51830,All,4206,1830,2376,378,128,367
2011,Winchester city,51840,All,10147,5054,5093,338,307,337
2012,Accomack County,51001,All,14286,10070,4216,556,397,453
2012,Albemarle County,51003,All,37549,24648,12901,765,591,815
2012,Alleghany County,51005,All,6851,5617,1234,211,199,184
2012,Amelia County,51007,All,4777,3867,910,233,285,239
2012,Amherst County,51009,All,12683,9614,3069,333,343,324
2012,Appomattox County,51011,All,5902,4512,1390,197,257,240
2012,Arlington County,51013,All,92992,42696,50296,935,994,1145
2012,Augusta County,51015,All,28297,23005,5292,396,558,518
2012,Bath County,51017,All,2008,1606,402,213,235,178
2012,Bedford County,51019,All,27017,22899,4118,484,493,383
2012,Bland County,51021,All,2464,2031,433,184,186,120
2012,Botetourt County,51023,All,12822,11217,1605,297,310,222
2012,Brunswick County,51025,All,6029,4257,1772,390,297,273
2012,Buchanan County,51027,All,9384,7339,2045,319,346,280
2012,Buckingham County,51029,All,5728,4301,1427,520,409,298
2012,Campbell County,51031,All,21581,16504,5077,497,497,420
2012,Caroline County,51033,All,10649,8830,1819,277,321,236
2012,Carroll County,51035,All,12622,9872,2750,389,431,394
2012,Charles City County,51036,All,2777,2279,498,106,111,97
2012,Charlotte County,51037,All,4803,3621,1182,231,274,194
2012,Chesterfield County,51041,All,113090,88028,25062,845,974,942
2012,Clarke County,51043,All,5580,4387,1193,189,232,211
2012,Craig County,51045,All,2073,1772,301,174,199,118
2012,Culpeper County,51047,All,15826,11654,4172,421,411,404
2012,Cumberland County,51049,All,4016,3103,913,177,228,178
2012,Dickenson County,51051,All,6404,5034,1370,168,250,200
2012,Dinwiddie County,51053,All,9788,7409,2379,266,344,312
2012,Essex County,51057,All,4351,3309,1042,197,204,169
2012,Fairfax County,51059,All,388452,270928,117524,1334,1881,1807
2012,Fauquier County,51061,All,23031,18216,4815,380,450,458
2012,Floyd County,51063,All,6076,4725,1351,313,313,283
2012,Fluvanna County,51065,All,9419,8254,1165,258,319,239
2012,Franklin County,51067,All,23552,18310,5242,452,497,524
2012,Frederick County,51069,All,29146,23162,5984,362,550,490
2012,Giles County,51071,All,7126,5516,1610,247,247,242
2012,Gloucester County,51073,All,13874,11639,2235,383,435,350
2012,Goochland County,51075,All,7909,7247,662,258,221,173
2012,Grayson County,51077,All,6807,5282,1525,318,291,239
2012,Greene County,51079,All,6884,5347,1537,233,308,294
2012,Greensville County,51081,All,3310,2327,983,576,429,254
2012,Halifax County,51083,All,14685,10856,3829,408,407,354
2012,Hanover County,51085,All,36444,30543,5901,451,523,400
2012,Henrico County,51087,All,123392,81193,42199,803,1040,1034
2012,Henry County,51089,All,22734,17218,5516,493,463,496
2012,Highland County,51091,All,1052,881,171,89,112,57
2012,Isle of Wight County,51093,All,13585,10929,2656,249,344,349
2012,James City County,51095,All,26579,20306,6273,507,499,479
2012,King and Queen County,51097,All,2924,2261,663,184,195,153
2012,King George County,51099,All,8166,6132,2034,306,285,277
2012,King William County,51101,All,6035,5021,1014,173,249,215
2012,Lancaster County,51103,All,5395,4309,1086,272,234,208
2012,Lee County,51105,All,9841,7385,2456,354,345,252
2012,Loudoun County,51107,All,104195,81476,22719,591,925,835
2012,Louisa County,51109,All,13023,10471,2552,391,452,340
2012,Lunenburg County,51111,All,4601,3446,1155,360,251,231
2012,Madison County,51113,All,5069,4014,1055,192,247,240
2012,Mathews County,51115,All,3815,3029,786,269,225,187
2012,Mecklenburg County,51117,All,12642,9204,3438,410,426,312
2012,Middlesex County,51119,All,4393,3653,740,250,218,175
2012,Montgomery County,51121,All,34739,18851,15888,723,593,826
2012,Nelson County,51125,All,6415,4951,1464,347,302,292
2012,New Kent County,51127,All,6719,6019,700,221,239,148
2012,Northampton County,51131,All,5025,3487,1538,286,251,242
2012,Northumberland County,51133,All,5557,4712,845,343,297,249
2012,Nottoway County,51135,All,5504,3741,1763,230,205,235
2012,Orange County,51137,All,12617,9778,2839,348,327,348
2012,Page County,51139,All,9469,7076,2393,293,302,307
2012,Patrick County,51141,All,7519,5873,1646,328,308,280
2012,Pittsylvania County,51143,All,26249,21011,5238,506,517,425
2012,Powhatan County,51145,All,9429,8380,1049,247,309,207
2012,Prince Edward County,51147,All,7227,4979,2248,452,312,419
2012,Prince George County,51149,All,10811,8058,2753,340,379,337
2012,Prince William County,51153,All,129643,94406,35237,853,1187,1021
2012,Pulaski County,51155,All,14874,10668,4206,453,449,391
2012,Rappahannock County,51157,All,3276,2536,740,185,149,170
2012,Richmond County,51159,All,2754,2006,748,252,203,149
2012,Roanoke County,51161,All,37876,28865,9011,406,661,553
2012,Rockbridge County,51163,All,9093,6622,2471,307,346,291
2012,Rockingham County,51165,All,29616,22730,6886,408,464,423
2012,Russell County,51167,All,11140,8590,2550,384,373,323
2012,Scott County,51169,All,9610,7516,2094,263,327,255
2012,Shenandoah County,51171,All,17261,12252,5009,437,458,445
2012,Smyth County,51173,All,12567,8899,3668,365,368,357
2012,Southampton County,51175,All,6532,4770,1762,263,258,204
2012,Spotsylvania County,51177,All,41380,32285,9095,545,727,584
2012,Stafford County,51179,All,41204,32278,8926,515,585,575
2012,Surry County,51181,All,2572,1991,581,156,170,148
2012,Sussex County,51183,All,3639,2387,1252,296,222,191
2012,Tazewell County,51185,All,18136,13098,5038,349,469,457
2012,Warren County,51187,All,14349,10272,4077,301,474,418
2012,Washington County,51191,All,22913,17266,5647,469,522,447
2012,Westmoreland County,51193,All,7077,5409,1668,393,372,284
2012,Wise County,51195,All,15673,10873,4800,315,398,378
2012,Wythe County,51197,All,11610,8381,3229,433,425,414
2012,York County,51199,All,24008,18199,5809,365,409,387
2012,Alexandria city,51510,All,64729,28403,36326,743,673,967
2012,Bedford County,51019,All,2723,1653,1070,164,185,241
2012,Bristol city,51520,All,7757,4546,3211,277,265,312
2012,Buena Vista city,51530,All,2732,1819,913,114,149,196
2012,Charlottesville city,51540,All,17319,7061,10258,387,316,477
2012,Chesapeake city,51550,All,79380,57875,21505,614,857,821
2012,Colonial Heights city,51570,All,7004,4612,2392,198,224,270
2012,Covington city,51580,All,2584,1774,810,118,171,141
2012,Danville city,51590,All,18986,10295,8691,480,457,461
2012,Emporia city,51595,All,2486,1100,1386,193,177,201
2012,Fairfax city,51600,All,8519,5958,2561,112,234,235
2012,Falls Church city,51610,All,4857,3024,1833,186,168,201
2012,Franklin city,51620,All,3532,1515,2017,152,183,215
2012,Fredericksburg city,51630,All,9705,3650,6055,376,288,451
2012,Galax city,51640,All,3354,2168,1186,260,229,236
2012,Hampton city,51650,All,52547,31664,20883,689,790,814
2012,Harrisonburg city,51660,All,15334,5587,9747,400,370,495
2012,Hopewell city,51670,All,8686,4420,4266,325,343,351
2012,Lexington city,51678,All,1801,980,821,856,373,516
2012,Lynchburg city,51680,All,28466,15488,12978,494,469,600
2012,Manassas city,51683,All,12011,7842,4169,288,364,335
2012,Manassas Park city,51685,All,4277,2816,1461,191,245,263
2012,Martinsville city,51690,All,6005,3326,2679,254,212,260
2012,Newport News city,51700,All,69467,35748,33719,753,716,814
2012,Norfolk city,51710,All,85247,38889,46358,1296,814,1157
2012,Norton city,51720,All,1701,888,813,165,158,147
2012,Petersburg city,51730,All,12236,5715,6521,415,376,344
2012,Poquoson city,51735,All,4592,3888,704,104,174,141
2012,Portsmouth city,51740,All,36788,21687,15101,731,662,618
2012,Radford city,51750,All,5624,2730,2894,326,188,317
2012,Richmond city,51760,All,83775,36905,46870,886,812,1018
2012,Roanoke city,51770,All,42644,23738,18906,589,713,802
2012,Salem city,51775,All,9953,6681,3272,273,253,321
2012,Staunton city,51790,All,10613,6249,4364,277,254,376
2012,Suffolk city,51800,All,30502,22789,7713,400,483,464
2012,Virginia Beach city,51810,All,164226,106510,57716,1149,1447,1372
2012,Waynesboro city,51820,All,8734,5208,3526,276,298,273
2012,Williamsburg city,51830,All,4281,1859,2422,335,172,382
2012,Winchester city,51840,All,10454,5171,5283,327,307,349
2013,Accomack County,51001,All,14333,9960,4373,620,408,566
2013,Albemarle County,51003,All,37964,25078,12886,700,598,646
2013,Alleghany County,51005,All,6773,5413,1360,195,215,208
2013,Amelia County,51007,All,4808,3843,965,210,286,250
2013,Amherst County,51009,All,12680,9402,3278,259,390,329
2013,Appomattox County,51011,All,5803,4654,1149,236,251,225
2013,Arlington County,51013,All,94454,42654,51800,1031,926,1091
2013,Augusta County,51015,All,27999,22662,5337,490,466,393
2013,Bath County,51017,All,2101,1600,501,196,241,177
2013,Bedford County,51019,All,27233,23157,4076,463,451,406
2013,Bland County,51021,All,2480,2045,435,186,185,115
2013,Botetourt County,51023,All,12825,11296,1529,305,335,306
2013,Brunswick County,51025,All,5826,4207,1619,381,296,271
2013,Buchanan County,51027,All,9485,7458,2027,287,326,293
2013,Buckingham County,51029,All,5817,4420,1397,426,362,232
2013,Campbell County,51031,All,21774,16545,5229,407,487,491
2013,Caroline County,51033,All,10680,8553,2127,281,376,311
2013,Carroll County,51035,All,12572,9889,2683,431,477,386
2013,Charles City County,51036,All,2850,2294,556,79,118,95
2013,Charlotte County,51037,All,4751,3469,1282,255,275,206
2013,Chesterfield County,51041,All,113637,87479,26158,862,1007,961
2013,Clarke County,51043,All,5580,4447,1133,172,192,206
2013,Craig County,51045,All,2122,1791,331,187,202,117
2013,Culpeper County,51047,All,16039,11711,4328,352,396,423
2013,Cumberland County,51049,All,4049,3134,915,175,227,214
2013,Dickenson County,51051,All,6352,4960,1392,201,225,198
2013,Dinwiddie County,51053,All,9932,7607,2325,276,343,306
2013,Essex County,51057,All,4286,3265,1021,181,216,166
2013,Fairfax County,51059,All,389908,269167,120741,1205,2105,1923
2013,Fauquier County,51061,All,23130,18530,4600,305,442,386
2013,Floyd County,51063,All,6086,4720,1366,461,383,322
2013,Fluvanna County,51065,All,9462,8094,1368,272,354,286
2013,Franklin County,51067,All,23358,18230,5128,477,481,511
2013,Frederick County,51069,All,29172,22852,6320,402,501,484
2013,Giles County,51071,All,7167,5442,1725,222,213,213
2013,Gloucester County,51073,All,13889,11519,2370,377,408,313
2013,Goochland County,51075,All,8058,7271,787,240,219,166
2013,Grayson County,51077,All,6618,5140,1478,252,260,219
2013,Greene County,51079,All,6897,5448,1449,663,536,316
2013,Greensville County,51081,All,3389,2568,821,570,457,209
2013,Halifax County,51083,All,14770,10672,4098,447,389,412
2013,Hanover County,51085,All,36927,30780,6147,359,441,416
2013,Henrico County,51087,All,123683,80690,42993,897,1219,1039
2013,Henry County,51089,All,22690,16919,5771,497,597,506
2013,Highland County,51091,All,1006,868,138,82,97,42
2013,Isle of Wight County,51093,All,13560,10926,2634,247,305,291
2013,James City County,51095,All,26883,20490,6393,478,508,487
2013,King and Queen County,51097,All,2863,2183,680,155,197,165
2013,King George County,51099,All,8314,6114,2200,248,319,292
2013,King William County,51101,All,5998,4982,1016,176,227,211
2013,Lancaster County,51103,All,5182,4106,1076,270,217,185
2013,Lee County,51105,All,9653,7177,2476,393,371,259
2013,Loudoun County,51107,All,106997,83100,23897,728,980,936
2013,Louisa County,51109,All,13046,10422,2624,386,440,379
2013,Lunenburg County,51111,All,4572,3444,1128,305,271,173
2013,Madison County,51113,All,5024,4032,992,216,218,166
2013,Mathews County,51115,All,3856,3078,778,275,206,212
2013,Mecklenburg County,51117,All,12650,9282,3368,412,419,336
2013,Middlesex County,51119,All,4400,3606,794,262,235,159
2013,Montgomery County,51121,All,34789,19012,15777,539,486,670
2013,Nelson County,51125,All,6404,4856,1548,312,296,328
2013,New Kent County,51127,All,6886,6127,759,208,242,182
2013,Northampton County,51131,All,5149,3533,1616,255,206,207
2013,Northumberland County,51133,All,5691,4839,852,340,290,233
2013,Nottoway County,51135,All,5673,3674,1999,255,263,254
2013,Orange County,51137,All,12621,9576,3045,349,361,316
2013,Page County,51139,All,9623,6930,2693,272,249,301
2013,Patrick County,51141,All,7846,6041,1805,327,331,299
2013,Pittsylvania County,51143,All,26092,20787,5305,512,467,424
2013,Powhatan County,51145,All,9544,8466,1078,261,308,184
2013,Prince Edward County,51147,All,7453,4856,2597,365,310,410
2013,Prince George County,51149,All,10848,7803,3045,328,341,363
2013,Prince William County,51153,All,132442,95506,36936,803,1165,1155
2013,Pulaski County,51155,All,14875,10816,4059,354,417,411
2013,Rappahannock County,51157,All,3261,2553,708,151,154,167
2013,Richmond County,51159,All,2853,2138,715,303,293,130
2013,Roanoke County,51161,All,37928,29098,8830,434,467,545
2013,Rockbridge County,51163,All,9234,6761,2473,305,304,336
2013,Rockingham County,51165,All,29440,22603,6837,411,543,504
2013,Russell County,51167,All,11191,8750,2441,314,382,306
2013,Scott County,51169,All,9692,7461,2231,286,319,312
2013,Shenandoah County,51171,All,17397,12259,5138,386,498,413
2013,Smyth County,51173,All,12650,8950,3700,404,315,376
2013,Southampton County,51175,All,6708,4815,1893,205,251,244
2013,Spotsylvania County,51177,All,41709,32318,9391,543,753,590
2013,Stafford County,51179,All,42178,32435,9743,415,611,577
2013,Surry County,51181,All,2602,2080,522,161,138,112
2013,Sussex County,51183,All,3704,2600,1104,307,191,216
2013,Tazewell County,51185,All,18294,13353,4941,316,397,438
2013,Warren County,51187,All,14387,10436,3951,283,401,390
2013,Washington County,51191,All,22755,17242,5513,379,499,519
2013,Westmoreland County,51193,All,7130,5553,1577,334,291,302
2013,Wise County,51195,All,15406,10913,4493,427,462,356
2013,Wythe County,51197,All,11656,8585,3071,409,414,415
2013,York County,51199,All,24071,18068,6003,432,464,415
2013,Alexandria city,51510,All,65369,28337,37032,920,734,1120
2013,Bedford County,51019,All,2800,1644,1156,244,159,268
2013,Bristol city,51520,All,7674,4495,3179,258,249,309
2013,Buena Vista city,51530,All,2738,1810,928,117,176,185
2013,Charlottesville city,51540,All,17443,7071,10372,372,399,474
2013,Chesapeake city,51550,All,79421,57579,21842,735,914,806
2013,Colonial Heights city,51570,All,7017,4493,2524,189,218,226
2013,Covington city,51580,All,2545,1855,690,141,164,151
2013,Danville city,51590,All,18659,10156,8503,488,422,462
2013,Emporia city,51595,All,2488,1132,1356,199,160,196
2013,Fairfax city,51600,All,8492,5812,2680,134,236,246
2013,Falls Church city,51610,All,5020,2981,2039,157,186,210
2013,Franklin city,51620,All,3551,1509,2042,179,192,214
2013,Fredericksburg city,51630,All,9779,3721,6058,303,244,374
2013,Galax city,51640,All,3018,1965,1053,224,204,201
2013,Hampton city,51650,All,52511,31560,20951,729,646,666
2013,Harrisonburg city,51660,All,15701,5680,10021,450,348,507
2013,Hopewell city,51670,All,8766,4419,4347,276,299,331
2013,Lexington city,51678,All,1709,949,760,851,422,470
2013,Lynchburg city,51680,All,28556,15061,13495,529,447,567
2013,Manassas city,51683,All,12072,7865,4207,267,403,416
2013,Manassas Park city,51685,All,4435,2825,1610,200,239,243
2013,Martinsville city,51690,All,5995,3220,2775,252,242,253
2013,Newport News city,51700,All,69211,35601,33610,958,785,1052
2013,Norfolk city,51710,All,85557,38066,47491,1033,860,1027
2013,Norton city,51720,All,1706,899,807,166,137,155
2013,Petersburg city,51730,All,12456,5694,6762,410,346,492
2013,Poquoson city,51735,All,4591,3755,836,78,175,159
2013,Portsmouth city,51740,All,36690,20997,15693,610,500,551
2013,Radford city,51750,All,5516,2546,2970,287,189,298
2013,Richmond city,51760,All,84833,36547,48286,1004,792,1118
2013,Roanoke city,51770,All,42494,23271,19223,523,651,673
2013,Salem city,51775,All,9908,6599,3309,265,273,308
2013,Staunton city,51790,All,10495,6054,4441,254,329,345
2013,Suffolk city,51800,All,30492,22373,8119,408,512,464
2013,Virginia Beach city,51810,All,164944,105839,59105,1049,1215,1367
2013,Waynesboro city,51820,All,8708,5067,3641,270,267,305
2013,Williamsburg city,51830,All,4391,1962,2429,281,160,280
2013,Winchester city,51840,All,10393,5055,5338,330,319,366
2014,Accomack County,51001,All,14289,10053,4236,610,415,538
2014,Albemarle County,51003,All,38537,25135,13402,669,590,644
2014,Alleghany County,51005,All,6714,5337,1377,216,224,187
2014,Amelia County,51007,All,4761,3886,875,203,267,208
2014,Amherst County,51009,All,12577,9373,3204,281,284,339
2014,Appomattox County,51011,All,5964,4839,1125,217,236,179
2014,Arlington County,51013,All,96264,43157,53107,1133,873,1266
2014,Augusta County,51015,All,28124,22813,5311,502,530,462
2014,Bath County,51017,All,2225,1674,551,158,183,155
2014,Bedford County,51019,All,30122,24628,5494,535,479,530
2014,Bland County,51021,All,2591,2078,513,198,179,134
2014,Botetourt County,51023,All,12867,11366,1501,233,286,239
2014,Brunswick County,51025,All,5865,4335,1530,347,261,253
2014,Buchanan County,51027,All,9406,7576,1830,302,276,289
2014,Buckingham County,51029,All,5802,4431,1371,317,273,230
2014,Campbell County,51031,All,21728,16761,4967,381,453,395
2014,Caroline County,51033,All,10728,8737,1991,315,352,264
2014,Carroll County,51035,All,12508,9846,2662,376,367,363
2014,Charles City County,51036,All,2832,2279,553,106,126,89
2014,Charlotte County,51037,All,4691,3416,1275,245,233,195
2014,Chesterfield County,51041,All,115005,88056,26949,782,873,907
2014,Clarke County,51043,All,5619,4275,1344,167,248,242
2014,Craig County,51045,All,2151,1733,418,167,194,130
2014,Culpeper County,51047,All,16436,12039,4397,352,410,359
2014,Cumberland County,51049,All,4038,3070,968,178,192,196
2014,Dickenson County,51051,All,6200,4836,1364,253,230,189
2014,Dinwiddie County,51053,All,9956,7467,2489,281,337,329
2014,Essex County,51057,All,4288,3184,1104,168,185,159
2014,Fairfax County,51059,All,391794,267156,124638,1231,2036,1889
2014,Fauquier County,51061,All,23162,18417,4745,443,422,429
2014,Floyd County,51063,All,6086,4791,1295,305,293,209
2014,Fluvanna County,51065,All,9787,8150,1637,287,358,313
2014,Franklin County,51067,All,23248,18072,5176,512,528,506
2014,Frederick County,51069,All,29184,22682,6502,468,580,512
2014,Giles County,51071,All,7253,5482,1771,250,244,218
2014,Gloucester County,51073,All,14074,11377,2697,340,437,365
2014,Goochland County,51075,All,8212,7194,1018,247,266,200
2014,Grayson County,51077,All,6686,5079,1607,263,269,205
2014,Greene County,51079,All,6965,5353,1612,239,296,250
2014,Greensville County,51081,All,3397,2482,915,620,482,206
2014,Halifax County,51083,All,14472,10574,3898,375,358,385
2014,Hanover County,51085,All,37041,30490,6551,383,556,561
2014,Henrico County,51087,All,123821,79065,44756,1010,1115,1293
2014,Henry County,51089,All,22472,16657,5815,470,487,432
2014,Highland County,51091,All,1067,911,156,93,101,63
2014,Isle of Wight County,51093,All,13519,10679,2840,301,314,276
2014,James City County,51095,All,27665,20616,7049,538,484,530
2014,King and Queen County,51097,All,2832,2121,711,157,190,139
2014,King George County,51099,All,8315,6114,2201,282,302,274
2014,King William County,51101,All,6147,5051,1096,150,236,206
2014,Lancaster County,51103,All,5283,3984,1299,290,259,232
2014,Lee County,51105,All,9597,6954,2643,424,422,331
2014,Loudoun County,51107,All,110047,84662,25385,624,965,831
2014,Louisa County,51109,All,12811,10397,2414,350,378,311
2014,Lunenburg County,51111,All,4634,3429,1205,337,252,194
2014,Madison County,51113,All,5093,3982,1111,163,209,207
2014,Mathews County,51115,All,3792,3082,710,322,258,245
2014,Mecklenburg County,51117,All,12857,9408,3449,465,415,338
2014,Middlesex County,51119,All,4432,3691,741,234,223,144
2014,Montgomery County,51121,All,34803,18850,15953,870,540,824
2014,Nelson County,51125,All,6381,4715,1666,310,291,244
2014,New Kent County,51127,All,7106,6253,853,218,310,220
2014,Northampton County,51131,All,5237,3662,1575,244,229,186
2014,Northumberland County,51133,All,5669,4730,939,306,273,241
2014,Nottoway County,51135,All,5640,3609,2031,220,258,280
2014,Orange County,51137,All,12433,9543,2890,361,432,353
2014,Page County,51139,All,9526,6764,2762,306,393,357
2014,Patrick County,51141,All,7678,5840,1838,354,291,251
2014,Pittsylvania County,51143,All,26029,20420,5609,528,494,464
2014,Powhatan County,51145,All,9590,8425,1165,247,289,230
2014,Prince Edward County,51147,All,7604,5021,2583,362,274,425
2014,Prince George County,51149,All,10906,7683,3223,364,311,367
2014,Prince William County,51153,All,134737,96757,37980,810,1381,1096
2014,Pulaski County,51155,All,15125,11036,4089,331,434,331
2014,Rappahannock County,51157,All,3281,2600,681,144,156,134
2014,Richmond County,51159,All,2800,2122,678,400,341,148
2014,Roanoke County,51161,All,38197,28749,9448,401,550,539
2014,Rockbridge County,51163,All,9226,6928,2298,313,337,344
2014,Rockingham County,51165,All,29483,22529,6954,480,549,438
2014,Russell County,51167,All,11037,8599,2438,362,393,335
2014,Scott County,51169,All,9363,7361,2002,287,276,238
2014,Shenandoah County,51171,All,17246,12381,4865,293,405,419
2014,Smyth County,51173,All,12852,8946,3906,300,326,285
2014,Southampton County,51175,All,6654,4777,1877,261,249,245
2014,Spotsylvania County,51177,All,42280,32204,10076,531,792,601
2014,Stafford County,51179,All,42763,32769,9994,544,562,511
2014,Surry County,51181,All,2652,2088,564,142,150,159
2014,Sussex County,51183,All,3261,2124,1137,517,308,280
2014,Tazewell County,51185,All,18306,13447,4859,380,377,401
2014,Warren County,51187,All,14324,10708,3616,341,426,367
2014,Washington County,51191,All,22842,17600,5242,359,447,404
2014,Westmoreland County,51193,All,6981,5381,1600,362,355,301
2014,Wise County,51195,All,15517,10739,4778,343,402,349
2014,Wythe County,51197,All,11984,8485,3499,368,399,425
2014,York County,51199,All,23970,17619,6351,372,405,446
2014,Alexandria city,51510,All,65916,28146,37770,754,828,936
2014,Bristol city,51520,All,7764,4292,3472,254,300,331
2014,Buena Vista city,51530,All,2741,1757,984,121,192,198
2014,Charlottesville city,51540,All,17604,7329,10275,362,340,452
2014,Chesapeake city,51550,All,80388,57644,22744,786,922,862
2014,Colonial Heights city,51570,All,7025,4542,2483,156,191,203
2014,Covington city,51580,All,2468,1853,615,121,140,121
2014,Danville city,51590,All,18520,10023,8497,411,401,473
2014,Emporia city,51595,All,2420,951,1469,168,141,149
2014,Fairfax city,51600,All,8480,5944,2536,141,237,239
2014,Falls Church city,51610,All,4966,2933,2033,180,207,209
2014,Franklin city,51620,All,3580,1559,2021,153,184,228
2014,Fredericksburg city,51630,All,9849,3561,6288,380,291,372
2014,Galax city,51640,All,2968,1757,1211,187,180,196
2014,Hampton city,51650,All,52700,30968,21732,724,689,789
2014,Harrisonburg city,51660,All,15881,5671,10210,356,338,452
2014,Hopewell city,51670,All,8774,4634,4140,277,302,341
2014,Lexington city,51678,All,1727,936,791,847,419,470
2014,Lynchburg city,51680,All,28424,14795,13629,556,488,624
2014,Manassas city,51683,All,12274,7936,4338,286,387,380
2014,Manassas Park city,51685,All,4526,2893,1633,176,244,220
2014,Martinsville city,51690,All,5974,3283,2691,231,230,269
2014,Newport News city,51700,All,68987,34930,34057,901,786,1026
2014,Norfolk city,51710,All,86397,37731,48666,1112,664,1030
2014,Norton city,51720,All,1655,878,777,136,189,169
2014,Petersburg city,51730,All,12515,5583,6932,300,343,361
2014,Poquoson city,51735,All,4627,3763,864,76,187,167
2014,Portsmouth city,51740,All,36764,20528,16236,677,572,631
2014,Radford city,51750,All,5333,2518,2815,342,224,344
2014,Richmond city,51760,All,85913,36704,49209,1272,776,1316
2014,Roanoke city,51770,All,42549,23204,19345,604,691,746
2014,Salem city,51775,All,9953,6709,3244,256,284,283
2014,Staunton city,51790,All,10503,6076,4427,297,296,345
2014,Suffolk city,51800,All,30798,22044,8754,392,592,499
2014,Virginia Beach city,51810,All,165296,105999,59297,936,1268,1214
2014,Waynesboro city,51820,All,8878,5106,3772,264,356,373
2014,Williamsburg city,51830,All,4365,2023,2342,260,160,279
2014,Winchester city,51840,All,10692,5095,5597,336,275,408
2015,Accomack County,51001,All,13961,9919,4042,570,477,511
2015,Albemarle County,51003,All,38853,25281,13572,835,668,746
2015,Alleghany County,51005,All,6781,5337,1444,192,216,178
2015,Amelia County,51007,All,4704,3824,880,223,291,247
2015,Amherst County,51009,All,12502,9534,2968,288,294,324
2015,Appomattox County,51011,All,5931,4794,1137,220,211,218
2015,Arlington County,51013,All,98441,43697,54744,1023,962,1364
2015,Augusta County,51015,All,28150,22341,5809,481,593,447
2015,Bath County,51017,All,2146,1495,651,171,186,173
2015,Bedford County,51019,All,30591,24850,5741,493,483,526
2015,Bland County,51021,All,2614,2089,525,235,214,127
2015,Botetourt County,51023,All,12913,11314,1599,263,290,219
2015,Brunswick County,51025,All,5916,4319,1597,291,278,256
2015,Buchanan County,51027,All,9442,7449,1993,262,259,291
2015,Buckingham County,51029,All,5603,4347,1256,251,253,198
2015,Campbell County,51031,All,21791,16572,5219,460,465,439
2015,Caroline County,51033,All,10970,8855,2115,431,389,290
2015,Carroll County,51035,All,12548,9915,2633,434,395,352
2015,Charles City County,51036,All,2883,2344,539,82,105,87
2015,Charlotte County,51037,All,4723,3281,1442,242,223,212
2015,Chesterfield County,51041,All,116797,89151,27646,806,987,929
2015,Clarke County,51043,All,5526,4195,1331,160,213,215
2015,Craig County,51045,All,2214,1794,420,185,209,122
2015,Culpeper County,51047,All,16515,12023,4492,357,418,397
2015,Cumberland County,51049,All,4012,2893,1119,191,222,230
2015,Dickenson County,51051,All,6205,4805,1400,199,230,198
2015,Dinwiddie County,51053,All,9939,7617,2322,264,343,280
2015,Essex County,51057,All,4332,3189,1143,201,176,175
2015,Fairfax County,51059,All,392355,265693,126662,1164,1892,1894
2015,Fauquier County,51061,All,23595,18674,4921,381,453,367
2015,Floyd County,51063,All,6271,4872,1399,276,306,271
2015,Fluvanna County,51065,All,9891,8124,1767,243,336,292
2015,Franklin County,51067,All,23189,17950,5239,459,540,472
2015,Frederick County,51069,All,29455,23010,6445,397,563,484
2015,Giles County,51071,All,7230,5499,1731,213,236,247
2015,Gloucester County,51073,All,14280,11282,2998,352,372,365
2015,Goochland County,51075,All,8148,7088,1060,215,277,169
2015,Grayson County,51077,All,6795,5059,1736,318,258,240
2015,Greene County,51079,All,7111,5512,1599,228,318,270
2015,Greensville County,51081,All,3486,2495,991,633,501,250
2015,Halifax County,51083,All,14300,10344,3956,398,423,394
2015,Hanover County,51085,All,37463,30348,7115,343,550,485
2015,Henrico County,51087,All,124589,78341,46248,874,1280,1154
2015,Henry County,51089,All,22415,16711,5704,375,470,450
2015,Highland County,51091,All,1071,883,188,88,100,60
2015,Isle of Wight County,51093,All,13769,10749,3020,288,300,296
2015,James City County,51095,All,28000,20984,7016,480,575,583
2015,King and Queen County,51097,All,2894,2196,698,126,155,117
2015,King George County,51099,All,8379,6120,2259,245,240,261
2015,King William County,51101,All,6036,4931,1105,195,248,211
2015,Lancaster County,51103,All,5164,3874,1290,301,237,203
2015,Lee County,51105,All,9445,6906,2539,411,386,246
2015,Loudoun County,51107,All,113432,87461,25971,710,1078,1007
2015,Louisa County,51109,All,12829,10204,2625,394,440,353
2015,Lunenburg County,51111,All,4516,3326,1190,482,356,207
2015,Madison County,51113,All,5003,3635,1368,223,243,216
2015,Mathews County,51115,All,3806,3152,654,299,252,225
2015,Mecklenburg County,51117,All,12482,9242,3240,363,381,328
2015,Middlesex County,51119,All,4342,3613,729,283,240,159
2015,Montgomery County,51121,All,35199,19093,16106,687,565,840
2015,Nelson County,51125,All,6339,4568,1771,291,281,263
2015,New Kent County,51127,All,7299,6240,1059,190,271,254
2015,Northampton County,51131,All,5248,3614,1634,250,225,202
2015,Northumberland County,51133,All,5861,4906,955,334,265,310
2015,Nottoway County,51135,All,5589,3651,1938,259,280,296
2015,Orange County,51137,All,12810,9669,3141,319,342,362
2015,Page County,51139,All,9372,6596,2776,284,310,266
2015,Patrick County,51141,All,7790,5974,1816,306,344,268
2015,Pittsylvania County,51143,All,26204,20121,6083,484,476,492
2015,Powhatan County,51145,All,9730,8499,1231,206,286,226
2015,Prince Edward County,51147,All,7409,4801,2608,383,262,348
2015,Prince George County,51149,All,11102,7835,3267,343,320,383
2015,Prince William County,51153,All,136794,97744,39050,649,1053,1141
2015,Pulaski County,51155,All,14619,10416,4203,370,350,389
2015,Rappahannock County,51157,All,3273,2492,781,158,137,168
2015,Richmond County,51159,All,2875,2138,737,204,184,158
2015,Roanoke County,51161,All,38164,28496,9668,371,581,627
2015,Rockbridge County,51163,All,9319,6927,2392,285,322,294
2015,Rockingham County,51165,All,29625,22449,7176,334,444,409
2015,Russell County,51167,All,11045,8614,2431,268,366,328
2015,Scott County,51169,All,9379,7289,2090,303,350,242
2015,Shenandoah County,51171,All,17096,12417,4679,372,444,455
2015,Smyth County,51173,All,12795,8942,3853,296,312,290
2015,Southampton County,51175,All,6682,4656,2026,240,233,271
2015,Spotsylvania County,51177,All,42823,32589,10234,449,743,560
2015,Stafford County,51179,All,43405,33314,10091,515,631,593
2015,Surry County,51181,All,2668,2134,534,126,119,113
2015,Sussex County,51183,All,3149,2061,1088,533,297,293
2015,Tazewell County,51185,All,17832,13438,4394,331,422,445
2015,Warren County,51187,All,14364,11020,3344,341,372,307
2015,Washington County,51191,All,22673,17273,5400,409,452,403
2015,Westmoreland County,51193,All,6944,5179,1765,383,310,292
2015,Wise County,51195,All,15254,10627,4627,319,394,360
2015,Wythe County,51197,All,11863,8270,3593,357,393,382
2015,York County,51199,All,23997,17512,6485,330,398,456
2015,Alexandria city,51510,All,66879,28410,38469,816,737,935
2015,Bristol city,51520,All,7718,4257,3461,254,297,336
2015,Buena Vista city,51530,All,2737,1605,1132,134,194,240
2015,Charlottesville city,51540,All,17752,7735,10017,370,383,437
2015,Chesapeake city,51550,All,81518,57374,24144,695,974,933
2015,Colonial Heights city,51570,All,7106,4461,2645,178,272,280
2015,Covington city,51580,All,2476,1834,642,152,185,176
2015,Danville city,51590,All,18559,10013,8546,440,368,392
2015,Emporia city,51595,All,2459,1050,1409,193,171,147
2015,Fairfax city,51600,All,8467,5925,2542,146,244,227
2015,Falls Church city,51610,All,5166,3031,2135,150,173,211
2015,Franklin city,51620,All,3453,1648,1805,197,173,218
2015,Fredericksburg city,51630,All,10080,3473,6607,338,310,390
2015,Galax city,51640,All,2961,1765,1196,180,206,211
2015,Hampton city,51650,All,52940,30486,22454,835,649,936
2015,Harrisonburg city,51660,All,16409,5926,10483,296,374,438
2015,Hopewell city,51670,All,8706,4470,4236,283,305,304
2015,Lexington city,51678,All,1638,941,697,1071,517,579
2015,Lynchburg city,51680,All,28528,14458,14070,537,428,638
2015,Manassas city,51683,All,12433,7988,4445,264,379,348
2015,Manassas Park city,51685,All,4723,3246,1477,98,218,241
2015,Martinsville city,51690,All,5857,3096,2761,207,206,245
2015,Newport News city,51700,All,69073,34694,34379,815,660,900
2015,Norfolk city,51710,All,87045,37853,49192,1126,810,992
2015,Norton city,51720,All,1783,908,875,137,155,178
2015,Petersburg city,51730,All,12803,5301,7502,382,332,428
2015,Poquoson city,51735,All,4642,3811,831,72,157,151
2015,Portsmouth city,51740,All,36757,20129,16628,559,618,680
2015,Radford city,51750,All,5477,2395,3082,400,227,387
2015,Richmond city,51760,All,87224,36875,50349,947,829,988
2015,Roanoke city,51770,All,42239,22688,19551,588,631,818
2015,Salem city,51775,All,10045,6651,3394,261,355,329
2015,Staunton city,51790,All,10387,5900,4487,265,280,324
2015,Suffolk city,51800,All,30990,21882,9108,381,488,523
2015,Virginia Beach city,51810,All,166242,105601,60641,1143,1326,1305
2015,Waynesboro city,51820,All,9031,5215,3816,249,355,376
2015,Williamsburg city,51830,All,4538,2086,2452,248,177,262
2015,Winchester city,51840,All,10608,4758,5850,278,316,381
2016,Accomack County,51001,All,13819,9605,4214,537,523,462
2016,Albemarle County,51003,All,39431,25584,13847,687,637,648
2016,Alleghany County,51005,All,6845,5396,1449,221,218,173
2016,Amelia County,51007,All,4540,3845,695,247,278,224
2016,Amherst County,51009,All,12306,9434,2872,349,386,300
2016,Appomattox County,51011,All,5972,4757,1215,192,238,227
2016,Arlington County,51013,All,100707,44531,56176,913,847,1219
2016,Augusta County,51015,All,28425,22601,5824,471,584,566
2016,Bath County,51017,All,2104,1430,674,194,215,191
2016,Bedford County,51019,All,30821,25056,5765,405,538,504
2016,Bland County,51021,All,2561,2107,454,243,233,118
2016,Botetourt County,51023,All,13305,11442,1863,264,304,255
2016,Brunswick County,51025,All,6148,4391,1757,254,259,282
2016,Buchanan County,51027,All,9124,7163,1961,296,280,250
2016,Buckingham County,51029,All,5689,4351,1338,243,234,226
2016,Campbell County,51031,All,22294,16897,5397,447,375,461
2016,Caroline County,51033,All,10965,8523,2442,490,452,320
2016,Carroll County,51035,All,12642,9849,2793,398,361,328
2016,Charles City County,51036,All,2854,2350,504,81,87,82
2016,Charlotte County,51037,All,4594,3154,1440,245,254,167
2016,Chesterfield County,51041,All,118908,89857,29051,746,1035,968
2016,Clarke County,51043,All,5591,4162,1429,180,239,248
2016,Craig County,51045,All,2314,1678,636,171,202,170
2016,Culpeper County,51047,All,16904,12118,4786,287,354,348
2016,Cumberland County,51049,All,4085,2977,1108,172,224,228
2016,Dickenson County,51051,All,6055,4541,1514,232,270,220
2016,Dinwiddie County,51053,All,10344,7800,2544,287,375,334
2016,Essex County,51057,All,4447,3177,1270,213,242,210
2016,Fairfax County,51059,All,393358,265351,128007,1141,1957,1655
2016,Fauquier County,51061,All,23890,18660,5230,374,535,427
2016,Floyd County,51063,All,6303,4903,1400,249,273,287
2016,Fluvanna County,51065,All,9829,7804,2025,224,367,325
2016,Franklin County,51067,All,22976,18209,4767,488,516,507
2016,Frederick County,51069,All,29914,23366,6548,485,570,571
2016,Giles County,51071,All,7290,5466,1824,232,247,233
2016,Gloucester County,51073,All,14511,11130,3381,293,422,371
2016,Goochland County,51075,All,8177,7033,1144,240,254,214
2016,Grayson County,51077,All,6710,5294,1416,224,201,212
2016,Greene County,51079,All,7107,5546,1561,210,345,272
2016,Greensville County,51081,All,3705,2815,890,157,175,184
2016,Halifax County,51083,All,14264,10152,4112,377,347,365
2016,Hanover County,51085,All,37724,30630,7094,412,508,458
2016,Henrico County,51087,All,125478,78606,46872,888,1187,1007
2016,Henry County,51089,All,22136,16253,5883,369,388,481
2016,Highland County,51091,All,1121,957,164,91,94,71
2016,Isle of Wight County,51093,All,13902,10851,3051,282,241,281
2016,James City County,51095,All,28352,21308,7044,517,514,523
2016,King and Queen County,51097,All,2807,2214,593,146,182,146
2016,King George County,51099,All,8669,6349,2320,240,285,288
2016,King William County,51101,All,6066,5100,966,166,230,210
2016,Lancaster County,51103,All,5097,3822,1275,279,248,197
2016,Lee County,51105,All,9282,6655,2627,358,297,293
2016,Loudoun County,51107,All,117073,90656,26417,667,993,828
2016,Louisa County,51109,All,13146,10288,2858,415,386,322
2016,Lunenburg County,51111,All,4670,3319,1351,190,175,170
2016,Madison County,51113,All,5042,3657,1385,211,239,252
2016,Mathews County,51115,All,3837,3246,591,266,247,196
2016,Mecklenburg County,51117,All,12066,8660,3406,426,389,376
2016,Middlesex County,51119,All,4474,3678,796,266,263,141
2016,Montgomery County,51121,All,35701,19130,16571,559,552,769
2016,Nelson County,51125,All,6378,4649,1729,318,291,268
2016,New Kent County,51127,All,7537,6335,1202,159,278,274
2016,Northampton County,51131,All,5075,3412,1663,244,220,196
2016,Northumberland County,51133,All,5776,4990,786,327,313,261
2016,Nottoway County,51135,All,5676,3578,2098,263,283,266
2016,Orange County,51137,All,13245,10331,2914,298,432,343
2016,Page County,51139,All,9523,6712,2811,269,298,259
2016,Patrick County,51141,All,7805,6014,1791,324,336,250
2016,Pittsylvania County,51143,All,26327,20094,6233,499,541,479
2016,Powhatan County,51145,All,9866,8737,1129,228,308,260
2016,Prince Edward County,51147,All,7294,4711,2583,406,291,325
2016,Prince George County,51149,All,11191,7667,3524,315,296,358
2016,Prince William County,51153,All,138102,98292,39810,709,1206,1185
2016,Pulaski County,51155,All,14553,10455,4098,388,395,383
2016,Rappahannock County,51157,All,3247,2412,835,154,154,162
2016,Richmond County,51159,All,3084,2259,825,213,178,169
2016,Roanoke County,51161,All,38322,28492,9830,387,575,563
2016,Rockbridge County,51163,All,9277,7176,2101,270,361,301
2016,Rockingham County,51165,All,29883,22148,7735,374,476,519
2016,Russell County,51167,All,10937,8505,2432,369,334,351
2016,Scott County,51169,All,9104,6982,2122,265,265,197
2016,Shenandoah County,51171,All,17222,12189,5033,389,475,459
2016,Smyth County,51173,All,12930,9061,3869,305,315,350
2016,Southampton County,51175,All,6727,4610,2117,186,225,223
2016,Spotsylvania County,51177,All,43105,33249,9856,401,535,448
2016,Stafford County,51179,All,44311,33330,10981,498,623,637
2016,Surry County,51181,All,2707,2212,495,126,127,119
2016,Sussex County,51183,All,3793,2456,1337,576,267,404
2016,Tazewell County,51185,All,17595,13208,4387,390,586,486
2016,Warren County,51187,All,14174,10737,3437,283,378,340
2016,Washington County,51191,All,22512,17178,5334,368,415,374
2016,Westmoreland County,51193,All,7124,5510,1614,345,316,276
2016,Wise County,51195,All,15225,10447,4778,339,379,380
2016,Wythe County,51197,All,12039,8643,3396,364,351,339
2016,York County,51199,All,23872,17207,6665,411,418,477
2016,Alexandria city,51510,All,68063,28710,39353,685,640,794
2016,Bristol city,51520,All,7671,4423,3248,249,252,308
2016,Buena Vista city,51530,All,2709,1608,1101,126,198,211
2016,Charlottesville city,51540,All,17980,7579,10401,313,340,415
2016,Chesapeake city,51550,All,82573,57851,24722,645,996,957
2016,Colonial Heights city,51570,All,7206,4350,2856,186,272,272
2016,Covington city,51580,All,2472,1856,616,149,157,166
2016,Danville city,51590,All,18653,10065,8588,402,388,425
2016,Emporia city,51595,All,2210,873,1337,156,125,164
2016,Fairfax city,51600,All,8476,5992,2484,134,206,218
2016,Falls Church city,51610,All,5301,3162,2139,129,178,202
2016,Franklin city,51620,All,3424,1703,1721,154,175,200
2016,Fredericksburg city,51630,All,10271,3575,6696,359,281,387
2016,Galax city,51640,All,2767,1564,1203,209,195,184
2016,Hampton city,51650,All,53656,30150,23506,713,715,798
2016,Harrisonburg city,51660,All,16626,6224,10402,277,383,443
2016,Hopewell city,51670,All,8866,4444,4422,285,384,374
2016,Lexington city,51678,All,1856,1042,814,232,194,161
2016,Lynchburg city,51680,All,28282,14291,13991,520,523,638
2016,Manassas city,51683,All,12430,7727,4703,232,351,346
2016,Manassas Park city,51685,All,4730,3112,1618,114,242,237
2016,Martinsville city,51690,All,5787,3061,2726,220,193,263
2016,Newport News city,51700,All,69247,34240,35007,810,793,903
2016,Norfolk city,51710,All,87367,37396,49971,988,770,1027
2016,Norton city,51720,All,1858,842,1016,148,160,177
2016,Petersburg city,51730,All,13175,5429,7746,326,319,448
2016,Poquoson city,51735,All,4610,3830,780,110,184,164
2016,Portsmouth city,51740,All,36840,19820,17020,537,597,674
2016,Radford city,51750,All,5604,2451,3153,328,213,355
2016,Richmond city,51760,All,88958,36829,52129,800,858,1128
2016,Roanoke city,51770,All,42541,22157,20384,579,756,848
2016,Salem city,51775,All,10060,6464,3596,239,295,326
2016,Staunton city,51790,All,10383,6028,4355,314,286,335
2016,Suffolk city,51800,All,31741,21992,9749,396,448,392
2016,Virginia Beach city,51810,All,167509,105833,61676,1094,1228,1156
2016,Waynesboro city,51820,All,9044,5237,3807,252,361,371
2016,Williamsburg city,51830,All,4627,2157,2470,205,165,236
2016,Winchester city,51840,All,10596,4822,5774,323,364,434
2017,Accomack County,51001,All,13528,9466,4062,562,445,495
2017,Albemarle County,51003,All,40015,25459,14556,605,623,761
2017,Alleghany County,51005,All,6866,5225,1641,189,212,210
2017,Amelia County,51007,All,4699,3928,771,213,282,203
2017,Amherst County,51009,All,12110,9313,2797,333,336,307
2017,Appomattox County,51011,All,5948,4817,1131,179,216,190
2017,Arlington County,51013,All,102310,45525,56785,945,888,1019
2017,Augusta County,51015,All,28790,22774,6016,557,626,469
2017,Bath County,51017,All,1847,1365,482,228,188,152
2017,Bedford County,51019,All,30927,25167,5760,444,608,475
2017,Bland County,51021,All,2561,2116,445,345,284,134
2017,Botetourt County,51023,All,13238,11274,1964,242,336,246
2017,Brunswick County,51025,All,6048,4472,1576,229,195,238
2017,Buchanan County,51027,All,9022,7116,1906,309,251,259
2017,Buckingham County,51029,All,5705,4298,1407,229,245,219
2017,Campbell County,51031,All,22608,16947,5661,402,431,408
2017,Caroline County,51033,All,10815,8668,2147,463,406,313
2017,Carroll County,51035,All,12517,9760,2757,337,335,380
2017,Charles City County,51036,All,2899,2415,484,90,106,64
2017,Charlotte County,51037,All,4493,3198,1295,214,200,161
2017,Chesterfield County,51041,All,120907,91047,29860,692,1062,1071
2017,Clarke County,51043,All,5568,4176,1392,193,219,211
2017,Craig County,51045,All,2344,1734,610,164,198,160
2017,Culpeper County,51047,All,16837,12272,4565,287,379,331
2017,Cumberland County,51049,All,3972,2870,1102,230,213,234
2017,Dickenson County,51051,All,6096,4630,1466,239,213,238
2017,Dinwiddie County,51053,All,10347,7982,2365,266,344,324
2017,Essex County,51057,All,4470,3153,1317,181,197,180
2017,Fairfax County,51059,All,393380,266707,126673,1346,2225,1904
2017,Fauquier County,51061,All,23981,18803,5178,359,481,476
2017,Floyd County,51063,All,6434,5196,1238,263,266,234
2017,Fluvanna County,51065,All,9794,7911,1883,220,375,334
2017,Franklin County,51067,All,23203,18393,4810,512,473,450
2017,Frederick County,51069,All,30495,23620,6875,471,560,488
2017,Giles County,51071,All,7088,5300,1788,254,277,238
2017,Gloucester County,51073,All,14746,11378,3368,318,396,372
2017,Goochland County,51075,All,8257,7186,1071,258,300,193
2017,Grayson County,51077,All,6653,5238,1415,263,235,217
2017,Greene County,51079,All,7260,5852,1408,206,302,261
2017,Greensville County,51081,All,3649,2754,895,197,216,174
2017,Halifax County,51083,All,14084,10220,3864,411,387,398
2017,Hanover County,51085,All,38208,31070,7138,357,481,407
2017,Henrico County,51087,All,126115,79311,46804,760,1128,1168
2017,Henry County,51089,All,22161,16220,5941,444,485,513
2017,Highland County,51091,All,1163,994,169,75,90,71
2017,Isle of Wight County,51093,All,14157,10939,3218,266,296,299
2017,James City County,51095,All,28410,21117,7293,540,597,633
2017,King and Queen County,51097,All,2811,2213,598,164,177,136
2017,King George County,51099,All,8972,6780,2192,213,259,251
2017,King William County,51101,All,6079,5233,846,173,242,197
2017,Lancaster County,51103,All,5081,3719,1362,240,242,208
2017,Lee County,51105,All,9278,6671,2607,359,287,314
2017,Loudoun County,51107,All,121299,94437,26862,538,873,900
2017,Louisa County,51109,All,13451,10721,2730,457,493,311
2017,Lunenburg County,51111,All,4480,3227,1253,187,198,185
2017,Madison County,51113,All,5107,3749,1358,221,234,265
2017,Mathews County,51115,All,3766,3248,518,309,293,208
2017,Mecklenburg County,51117,All,11785,8503,3282,339,291,289
2017,Middlesex County,51119,All,4522,3659,863,260,233,168
2017,Montgomery County,51121,All,35577,19520,16057,657,598,762
2017,Nelson County,51125,All,6523,4685,1838,295,279,268
2017,New Kent County,51127,All,7555,6182,1373,199,250,268
2017,Northampton County,51131,All,5177,3344,1833,267,219,258
2017,Northumberland County,51133,All,5774,4917,857,322,334,251
2017,Nottoway County,51135,All,5633,3318,2315,271,288,351
2017,Orange County,51137,All,13470,10406,3064,439,415,433
2017,Page County,51139,All,9467,6525,2942,271,342,347
2017,Patrick County,51141,All,7713,5942,1771,348,303,274
2017,Pittsylvania County,51143,All,26687,20068,6619,497,588,513
2017,Powhatan County,51145,All,9974,8954,1020,221,297,224
2017,Prince Edward County,51147,All,7281,4722,2559,481,258,404
2017,Prince George County,51149,All,11298,7710,3588,298,339,330
2017,Prince William County,51153,All,139306,100948,38358,731,1104,994
2017,Pulaski County,51155,All,14577,10615,3962,410,352,349
2017,Rappahannock County,51157,All,3131,2354,777,171,135,156
2017,Richmond County,51159,All,3250,2338,912,208,196,167
2017,Roanoke County,51161,All,38434,28751,9683,402,505,513
2017,Rockbridge County,51163,All,9160,7040,2120,328,339,329
2017,Rockingham County,51165,All,30503,22351,8152,371,413,471
2017,Russell County,51167,All,11102,8643,2459,312,372,334
2017,Scott County,51169,All,8976,6931,2045,311,337,268
2017,Shenandoah County,51171,All,17262,12035,5227,298,373,392
2017,Smyth County,51173,All,12829,9015,3814,325,279,261
2017,Southampton County,51175,All,6664,4773,1891,181,257,243
2017,Spotsylvania County,51177,All,43279,33482,9797,378,577,437
2017,Stafford County,51179,All,45345,34377,10968,404,751,744
2017,Surry County,51181,All,2773,2110,663,150,144,129
2017,Sussex County,51183,All,3388,2395,993,589,309,341
2017,Tazewell County,51185,All,17330,13304,4026,411,447,437
2017,Warren County,51187,All,14190,10887,3303,360,316,311
2017,Washington County,51191,All,22388,16926,5462,389,455,398
2017,Westmoreland County,51193,All,7412,5695,1717,329,362,291
2017,Wise County,51195,All,15104,10455,4649,319,381,392
2017,Wythe County,51197,All,11892,9036,2856,392,401,423
2017,York County,51199,All,24333,17547,6786,392,428,460
2017,Alexandria city,51510,All,68663,29576,39087,662,813,846
2017,Bristol city,51520,All,7418,4372,3046,278,321,299
2017,Buena Vista city,51530,All,2606,1623,983,154,182,179
2017,Charlottesville city,51540,All,18408,8116,10292,349,349,460
2017,Chesapeake city,51550,All,83031,58843,24188,736,884,930
2017,Colonial Heights city,51570,All,7092,4471,2621,207,250,222
2017,Covington city,51580,All,2399,1805,594,152,160,140
2017,Danville city,51590,All,18517,9844,8673,382,349,421
2017,Emporia city,51595,All,2119,902,1217,178,131,177
2017,Fairfax city,51600,All,8499,5949,2550,143,247,244
2017,Falls Church city,51610,All,5308,3178,2130,161,158,197
2017,Franklin city,51620,All,3470,1726,1744,161,176,206
2017,Fredericksburg city,51630,All,10419,3746,6673,319,265,381
2017,Galax city,51640,All,2837,1674,1163,201,183,183
2017,Hampton city,51650,All,53555,30471,23084,722,777,934
2017,Harrisonburg city,51660,All,16848,6445,10403,325,396,451
2017,Hopewell city,51670,All,9123,4653,4470,299,354,378
2017,Lexington city,51678,All,1935,1147,788,244,180,182
2017,Lynchburg city,51680,All,28150,13978,14172,457,518,543
2017,Manassas city,51683,All,12540,7979,4561,243,314,333
2017,Manassas Park city,51685,All,4778,3224,1554,97,203,200
2017,Martinsville city,51690,All,5740,3165,2575,214,235,260
2017,Newport News city,51700,All,68665,34345,34320,765,914,963
2017,Norfolk city,51710,All,87249,37854,49395,848,862,901
2017,Norton city,51720,All,1786,868,918,149,163,161
2017,Petersburg city,51730,All,13262,5532,7730,339,326,394
2017,Poquoson city,51735,All,4583,3659,924,113,180,179
2017,Portsmouth city,51740,All,36616,19936,16680,426,503,576
2017,Radford city,51750,All,5503,2559,2944,319,240,333
2017,Richmond city,51760,All,89238,37190,52048,771,905,938
2017,Roanoke city,51770,All,42333,21977,20356,542,710,740
2017,Salem city,51775,All,9997,6551,3446,297,298,293
2017,Staunton city,51790,All,10477,6026,4451,264,319,331
2017,Suffolk city,51800,All,32331,22380,9951,369,520,555
2017,Virginia Beach city,51810,All,167731,107096,60635,1214,1240,1230
2017,Waynesboro city,51820,All,9128,5376,3752,246,377,381
2017,Williamsburg city,51830,All,4649,2198,2451,230,155,252
2017,Winchester city,51840,All,10520,4802,5718,339,316,438
2018,Accomack County,51001,All,13401,9093,4308,507,454,417
2018,Albemarle County,51003,All,40612,25391,15221,683,621,708
2018,Alleghany County,51005,All,6741,5237,1504,186,216,202
2018,Amelia County,51007,All,4789,4036,753,193,233,185
2018,Amherst County,51009,All,12044,9349,2695,313,405,261
2018,Appomattox County,51011,All,6095,4733,1362,218,272,213
2018,Arlington County,51013,All,104716,45504,59212,828,745,983
2018,Augusta County,51015,All,29297,23110,6187,491,537,559
2018,Bath County,51017,All,1999,1443,556,191,223,182
2018,Bedford County,51019,All,31206,25472,5734,493,488,494
2018,Bland County,51021,All,2523,2087,436,138,146,111
2018,Botetourt County,51023,All,13161,11353,1808,260,324,251
2018,Brunswick County,51025,All,6048,4336,1712,231,254,251
2018,Buchanan County,51027,All,8871,6925,1946,315,301,262
2018,Buckingham County,51029,All,5827,4385,1442,233,253,195
2018,Campbell County,51031,All,22957,17271,5686,425,483,439
2018,Caroline County,51033,All,10911,8868,2043,437,343,344
2018,Carroll County,51035,All,12375,9526,2849,346,432,405
2018,Charles City County,51036,All,2856,2387,469,87,101,71
2018,Charlotte County,51037,All,4543,3156,1387,274,250,220
2018,Chesterfield County,51041,All,123010,92822,30188,632,1030,1032
2018,Clarke County,51043,All,5639,4216,1423,184,219,207
2018,Craig County,51045,All,2266,1636,630,179,239,201
2018,Culpeper County,51047,All,16903,12539,4364,303,382,360
2018,Cumberland County,51049,All,3963,2892,1071,201,217,227
2018,Dickenson County,51051,All,5841,4456,1385,254,291,225
2018,Dinwiddie County,51053,All,10391,7900,2491,308,357,304
2018,Essex County,51057,All,4463,3108,1355,227,221,197
2018,Fairfax County,51059,All,394447,268346,126101,1221,1923,1663
2018,Fauquier County,51061,All,24333,19017,5316,361,453,419
2018,Floyd County,51063,All,6480,5326,1154,238,265,253
2018,Fluvanna County,51065,All,9842,8256,1586,242,347,291
2018,Franklin County,51067,All,23104,18447,4657,417,469,524
2018,Frederick County,51069,All,30973,24065,6908,452,646,527
2018,Giles County,51071,All,6987,5363,1624,237,229,216
2018,Gloucester County,51073,All,14759,11261,3498,286,424,421
2018,Goochland County,51075,All,8426,7157,1269,219,281,239
2018,Grayson County,51077,All,6542,5184,1358,382,323,193
2018,Greene County,51079,All,7357,5898,1459,230,292,231
2018,Greensville County,51081,All,3688,2698,990,205,215,188
2018,Halifax County,51083,All,14025,10476,3549,380,344,329
2018,Hanover County,51085,All,38599,31513,7086,446,550,437
2018,Henrico County,51087,All,127111,79703,47408,870,1126,1117
2018,Henry County,51089,All,21598,15629,5969,518,492,516
2018,Highland County,51091,All,1123,920,203,64,100,75
2018,Isle of Wight County,51093,All,14304,10692,3612,278,351,347
2018,James City County,51095,All,28766,21434,7332,522,557,574
2018,King and Queen County,51097,All,2826,2362,464,159,180,122
2018,King George County,51099,All,9103,7014,2089,208,282,267
2018,King William County,51101,All,6170,5321,849,212,235,184
2018,Lancaster County,51103,All,5142,3890,1252,248,268,228
2018,Lee County,51105,All,9149,6465,2684,346,291,348
2018,Loudoun County,51107,All,125309,97513,27796,536,934,854
2018,Louisa County,51109,All,13575,10818,2757,410,430,357
2018,Lunenburg County,51111,All,4331,3088,1243,221,191,173
2018,Madison County,51113,All,5078,3714,1364,236,259,275
2018,Mathews County,51115,All,3908,3406,502,279,249,196
2018,Mecklenburg County,51117,All,11815,8257,3558,385,336,340
2018,Middlesex County,51119,All,4454,3585,869,228,212,181
2018,Montgomery County,51121,All,35483,19530,15953,638,680,818
2018,Nelson County,51125,All,6445,4787,1658,341,311,264
2018,New Kent County,51127,All,7754,6606,1148,235,292,235
2018,Northampton County,51131,All,5151,3371,1780,229,178,231
2018,Northumberland County,51133,All,5686,4852,834,319,269,240
2018,Nottoway County,51135,All,5542,3396,2146,303,334,345
2018,Orange County,51137,All,13453,10448,3005,367,497,394
2018,Page County,51139,All,9338,6546,2792,327,285,284
2018,Patrick County,51141,All,7685,5878,1807,245,279,248
2018,Pittsylvania County,51143,All,26330,19750,6580,444,452,505
2018,Powhatan County,51145,All,10178,9119,1059,257,312,234
2018,Prince Edward County,51147,All,7187,4808,2379,405,324,364
2018,Prince George County,51149,All,11415,7648,3767,319,343,320
2018,Prince William County,51153,All,140473,102811,37662,767,1165,1120
2018,Pulaski County,51155,All,14525,10507,4018,409,412,377
2018,Rappahannock County,51157,All,2976,2196,780,214,179,154
2018,Richmond County,51159,All,3139,2262,877,261,211,185
2018,Roanoke County,51161,All,38343,28403,9940,407,637,551
2018,Rockbridge County,51163,All,8979,7033,1946,369,340,299
2018,Rockingham County,51165,All,30946,22832,8114,408,616,572
2018,Russell County,51167,All,10965,8343,2622,346,342,318
2018,Scott County,51169,All,8767,6833,1934,274,260,238
2018,Shenandoah County,51171,All,17315,12229,5086,370,406,414
2018,Smyth County,51173,All,12881,9193,3688,333,292,273
2018,Southampton County,51175,All,6522,4771,1751,216,275,256
2018,Spotsylvania County,51177,All,43677,33923,9754,434,607,559
2018,Stafford County,51179,All,46328,35289,11039,398,704,678
2018,Surry County,51181,All,2760,2121,639,164,132,151
2018,Sussex County,51183,All,3814,2564,1250,460,311,221
2018,Tazewell County,51185,All,17042,12923,4119,460,464,376
2018,Warren County,51187,All,14379,11072,3307,314,355,323
2018,Washington County,51191,All,22331,16799,5532,391,410,387
2018,Westmoreland County,51193,All,7612,5669,1943,357,381,357
2018,Wise County,51195,All,15126,9980,5146,377,413,415
2018,Wythe County,51197,All,11955,9112,2843,349,402,354
2018,York County,51199,All,24617,17676,6941,405,503,441
2018,Alexandria city,51510,All,69979,29989,39990,585,697,793
2018,Bristol city,51520,All,7402,4362,3040,251,293,331
2018,Buena Vista city,51530,All,2539,1694,845,191,215,194
2018,Charlottesville city,51540,All,18613,8045,10568,341,416,490
2018,Chesapeake city,51550,All,84230,60083,24147,772,911,1034
2018,Colonial Heights city,51570,All,7054,4484,2570,159,225,216
2018,Covington city,51580,All,2409,1771,638,123,142,139
2018,Danville city,51590,All,18479,9878,8601,455,321,467
2018,Emporia city,51595,All,2119,879,1240,182,135,185
2018,Fairfax city,51600,All,8553,6066,2487,170,237,249
2018,Falls Church city,51610,All,5262,3243,2019,193,167,194
2018,Franklin city,51620,All,3526,1755,1771,144,185,210
2018,Fredericksburg city,51630,All,10582,3829,6753,314,324,403
2018,Galax city,51640,All,2742,1799,943,164,217,186
2018,Hampton city,51650,All,53700,30167,23533,650,803,908
2018,Harrisonburg city,51660,All,16768,6398,10370,338,376,459
2018,Hopewell city,51670,All,9193,4572,4621,286,309,309
2018,Lexington city,51678,All,1984,1050,934,236,186,182
2018,Lynchburg city,51680,All,28069,13953,14116,633,469,641
2018,Manassas city,51683,All,12749,8301,4448,210,335,347
2018,Manassas Park city,51685,All,4706,3098,1608,118,202,218
2018,Martinsville city,51690,All,5630,3283,2347,217,257,261
2018,Newport News city,51700,All,69324,34043,35281,840,776,1013
2018,Norfolk city,51710,All,88155,38029,50126,867,720,867
2018,Norton city,51720,All,1819,843,976,145,143,165
2018,Petersburg city,51730,All,13274,5376,7898,322,340,401
2018,Poquoson city,51735,All,4615,3849,766,86,160,151
2018,Portsmouth city,51740,All,36471,19810,16661,510,516,589
2018,Radford city,51750,All,5438,2676,2762,289,266,337
2018,Richmond city,51760,All,89846,37956,51890,793,736,895
2018,Roanoke city,51770,All,42037,21783,20254,532,704,736
2018,Salem city,51775,All,9881,6415,3466,256,276,297
2018,Staunton city,51790,All,10520,5974,4546,260,309,353
2018,Suffolk city,51800,All,33198,23001,10197,360,556,591
2018,Virginia Beach city,51810,All,169290,108486,60804,882,1264,1338
2018,Waynesboro city,51820,All,9144,5359,3785,270,357,359
2018,Williamsburg city,51830,All,4670,2301,2369,206,169,216
2018,Winchester city,51840,All,10554,4950,5604,292,312,375
2019,Accomack County,51001,All,13438,8977,4461,530,372,539
2019,Albemarle County,51003,All,41496,26265,15231,632,664,716
2019,Alleghany County,51005,All,6600,5032,1568,206,214,184
2019,Amelia County,51007,All,4954,4181,773,198,256,172
2019,Amherst County,51009,All,12160,9378,2782,344,365,342
2019,Appomattox County,51011,All,6091,4737,1354,218,221,212
2019,Arlington County,51013,All,107032,45752,61280,813,988,1045
2019,Augusta County,51015,All,29539,23430,6109,529,562,516
2019,Bath County,51017,All,1801,1357,444,236,224,146
2019,Bedford County,51019,All,31317,25712,5605,515,548,448
2019,Bland County,51021,All,2367,1927,440,191,180,125
2019,Botetourt County,51023,All,13264,11447,1817,283,298,282
2019,Brunswick County,51025,All,6037,4268,1769,257,235,271
2019,Buchanan County,51027,All,8569,6625,1944,372,310,350
2019,Buckingham County,51029,All,5826,4381,1445,249,224,201
2019,Campbell County,51031,All,23071,17242,5829,356,510,471
2019,Caroline County,51033,All,10946,8669,2277,475,465,378
2019,Carroll County,51035,All,12357,9674,2683,415,465,355
2019,Charles City County,51036,All,2896,2430,466,93,101,85
2019,Charlotte County,51037,All,4661,3322,1339,237,229,181
2019,Chesterfield County,51041,All,124971,94698,30273,690,968,996
2019,Clarke County,51043,All,5612,4209,1403,173,234,236
2019,Craig County,51045,All,2297,1756,541,177,202,156
2019,Culpeper County,51047,All,17071,12412,4659,328,407,438
2019,Cumberland County,51049,All,3975,2936,1039,176,246,225
2019,Dickenson County,51051,All,5778,4374,1404,237,228,196
2019,Dinwiddie County,51053,All,10401,8027,2374,307,337,287
2019,Essex County,51057,All,4555,3056,1499,206,227,204
2019,Fairfax County,51059,All,396501,269528,126973,1351,2042,1953
2019,Fauquier County,51061,All,24562,19229,5333,339,444,439
2019,Floyd County,51063,All,6493,5267,1226,248,263,215
2019,Fluvanna County,51065,All,9923,8432,1491,215,288,235
2019,Franklin County,51067,All,22997,18798,4199,552,461,512
2019,Frederick County,51069,All,31503,24450,7053,418,537,514
2019,Giles County,51071,All,6910,5187,1723,238,252,220
2019,Gloucester County,51073,All,14786,11569,3217,360,415,382
2019,Goochland County,51075,All,8506,7220,1286,276,255,237
2019,Grayson County,51077,All,6498,5282,1216,458,330,248
2019,Greene County,51079,All,7548,5857,1691,206,302,281
2019,Greensville County,51081,All,3647,2673,974,184,208,187
2019,Halifax County,51083,All,14158,10494,3664,448,424,387
2019,Hanover County,51085,All,38987,32174,6813,377,485,504
2019,Henrico County,51087,All,128464,80489,47975,906,1180,1279
2019,Henry County,51089,All,21218,15262,5956,589,420,535
2019,Highland County,51091,All,1078,894,184,76,82,71
2019,Isle of Wight County,51093,All,14587,11055,3532,243,392,363
2019,James City County,51095,All,28920,22093,6827,510,497,530
2019,King and Queen County,51097,All,2707,2261,446,168,178,144
2019,King George County,51099,All,9202,7247,1955,246,275,257
2019,King William County,51101,All,6078,5310,768,227,214,174
2019,Lancaster County,51103,All,5062,3840,1222,250,258,218
2019,Lee County,51105,All,9149,6477,2672,357,306,320
2019,Loudoun County,51107,All,128637,100400,28237,607,971,932
2019,Louisa County,51109,All,13871,11103,2768,411,478,325
2019,Lunenburg County,51111,All,4293,3082,1211,228,223,215
2019,Madison County,51113,All,4949,3685,1264,234,267,264
2019,Mathews County,51115,All,3920,3331,589,343,311,249
2019,Mecklenburg County,51117,All,12075,8580,3495,389,337,302
2019,Middlesex County,51119,All,4603,3621,982,263,233,202
2019,Montgomery County,51121,All,35685,19758,15927,649,683,720
2019,Nelson County,51125,All,6419,4904,1515,310,267,293
2019,New Kent County,51127,All,7961,6886,1075,227,324,234
2019,Northampton County,51131,All,5148,3356,1792,266,232,260
2019,Northumberland County,51133,All,5584,4981,603,312,265,209
2019,Nottoway County,51135,All,5446,3522,1924,280,316,315
2019,Orange County,51137,All,13679,10777,2902,352,387,347
2019,Page County,51139,All,9286,6600,2686,308,324,375
2019,Patrick County,51141,All,7755,6124,1631,321,332,277
2019,Pittsylvania County,51143,All,26267,19800,6467,513,522,527
2019,Powhatan County,51145,All,10265,9253,1012,261,334,247
2019,Prince Edward County,51147,All,7185,4625,2560,420,284,360
2019,Prince George County,51149,All,11507,7774,3733,282,305,278
2019,Prince William County,51153,All,142000,104061,37939,667,1117,1041
2019,Pulaski County,51155,All,14533,10370,4163,338,376,375
2019,Rappahannock County,51157,All,2913,2162,751,156,137,143
2019,Richmond County,51159,All,3069,2146,923,188,216,169
2019,Roanoke County,51161,All,38222,28591,9631,465,562,487
2019,Rockbridge County,51163,All,9248,6958,2290,361,371,397
2019,Rockingham County,51165,All,30994,23080,7914,386,481,506
2019,Russell County,51167,All,10812,8232,2580,352,346,350
2019,Scott County,51169,All,8773,6787,1986,288,278,230
2019,Shenandoah County,51171,All,17402,12344,5058,408,388,387
2019,Smyth County,51173,All,12686,9070,3616,340,331,342
2019,Southampton County,51175,All,6562,4910,1652,221,271,245
2019,Spotsylvania County,51177,All,44436,34700,9736,389,618,537
2019,Stafford County,51179,All,47075,36427,10648,466,703,667
2019,Surry County,51181,All,2730,2028,702,146,151,123
2019,Sussex County,51183,All,3794,2624,1170,215,179,160
2019,Tazewell County,51185,All,16531,12320,4211,426,474,458
2019,Warren County,51187,All,14651,11243,3408,303,376,332
2019,Washington County,51191,All,22321,16780,5541,379,414,386
2019,Westmoreland County,51193,All,7923,5796,2127,365,353,313
2019,Wise County,51195,All,14925,9946,4979,399,486,416
2019,Wythe County,51197,All,11983,9343,2640,345,363,346
2019,York County,51199,All,25103,17896,7207,399,537,477
2019,Alexandria city,51510,All,70598,30553,40045,558,804,857
2019,Bristol city,51520,All,7334,4429,2905,291,345,331
2019,Buena Vista city,51530,All,2517,1711,806,155,206,173
2019,Charlottesville city,51540,All,18617,7977,10640,327,390,451
2019,Chesapeake city,51550,All,84849,60540,24309,815,909,927
2019,Colonial Heights city,51570,All,7036,4426,2610,183,214,242
2019,Covington city,51580,All,2384,1775,609,150,165,138
2019,Danville city,51590,All,18293,9420,8873,480,389,553
2019,Emporia city,51595,All,2086,837,1249,174,139,183
2019,Fairfax city,51600,All,8577,6004,2573,168,227,231
2019,Falls Church city,51610,All,5493,3204,2289,165,159,205
2019,Franklin city,51620,All,3522,1816,1706,148,188,236
2019,Fredericksburg city,51630,All,10762,3817,6945,284,284,320
2019,Galax city,51640,All,2663,1814,849,191,171,169
2019,Hampton city,51650,All,54050,30123,23927,656,814,930
2019,Harrisonburg city,51660,All,16723,6621,10102,380,354,501
2019,Hopewell city,51670,All,9224,4312,4912,287,375,417
2019,Lexington city,51678,All,2158,1131,1027,278,174,210
2019,Lynchburg city,51680,All,28273,13774,14499,618,536,575
2019,Manassas city,51683,All,12898,8530,4368,238,333,308
2019,Manassas Park city,51685,All,4641,3059,1582,143,252,257
2019,Martinsville city,51690,All,5532,3093,2439,268,227,255
2019,Newport News city,51700,All,69835,34160,35675,817,809,964
2019,Norfolk city,51710,All,88353,38339,50014,959,863,1124
2019,Norton city,51720,All,1628,815,813,155,130,166
2019,Petersburg city,51730,All,13165,5112,8053,351,341,448
2019,Poquoson city,51735,All,4593,3740,853,113,175,166
2019,Portsmouth city,51740,All,36370,19999,16371,457,592,559
2019,Radford city,51750,All,5573,2596,2977,366,284,352
2019,Richmond city,51760,All,90301,38494,51807,863,860,1057
2019,Roanoke city,51770,All,41740,21479,20261,659,728,859
2019,Salem city,51775,All,9912,6302,3610,280,276,335
2019,Staunton city,51790,All,10597,6072,4525,319,323,305
2019,Suffolk city,51800,All,33774,23218,10556,365,571,494
2019,Virginia Beach city,51810,All,170798,108815,61983,1061,1245,1374
2019,Waynesboro city,51820,All,9193,5304,3889,273,316,314
2019,Williamsburg city,51830,All,4706,2320,2386,268,154,279
2019,Winchester city,51840,All,10490,4642,5848,354,381,446
2020,Accomack County,51001,All,13641,8861,4780,569,485,487
2020,Albemarle County,51003,All,42381,27625,14756,723,707,756
2020,Alleghany County,51005,All,6529,5170,1359,240,244,225
2020,Amelia County,51007,All,5034,4184,850,205,283,251
2020,Amherst County,51009,All,12161,9408,2753,357,414,315
2020,Appomattox County,51011,All,6158,4741,1417,233,303,295
2020,Arlington County,51013,All,108604,46205,62399,802,1188,1488
2020,Augusta County,51015,All,30165,23938,6227,542,666,591
2020,Bath County,51017,All,1831,1499,332,196,205,143
2020,Bedford County,51019,All,31424,26448,4976,498,566,486
2020,Bland County,51021,All,2326,1919,407,221,207,121
2020,Botetourt County,51023,All,13171,11291,1880,292,336,286
2020,Brunswick County,51025,All,6138,4545,1593,268,260,241
2020,Buchanan County,51027,All,8270,6602,1668,354,348,293
2020,Buckingham County,51029,All,5948,4391,1557,248,268,230
2020,Campbell County,51031,All,23157,16916,6241,385,573,537
2020,Caroline County,51033,All,10978,8823,2155,660,543,357
2020,Carroll County,51035,All,12134,9619,2515,378,491,427
2020,Charles City County,51036,All,2998,2531,467,74,99,73
2020,Charlotte County,51037,All,4836,3295,1541,207,210,239
2020,Chesterfield County,51041,All,127230,97590,29640,576,1121,1136
2020,Clarke County,51043,All,5690,4415,1275,184,225,227
2020,Craig County,51045,All,2219,1575,644,210,231,199
2020,Culpeper County,51047,All,17474,12829,4645,349,433,468
2020,Cumberland County,51049,All,4112,3128,984,188,246,230
2020,Dickenson County,51051,All,5727,4298,1429,220,237,194
2020,Dinwiddie County,51053,All,10403,8033,2370,349,387,311
2020,Essex County,51057,All,4551,3100,1451,229,286,269
2020,Fairfax County,51059,All,398653,273428,125225,1053,1998,1934
2020,Fauquier County,51061,All,24617,18939,5678,387,474,450
2020,Floyd County,51063,All,6657,5726,931,214,254,198
2020,Fluvanna County,51065,All,9967,8215,1752,280,355,310
2020,Franklin County,51067,All,22730,18549,4181,606,703,636
2020,Frederick County,51069,All,32094,24939,7155,439,678,581
2020,Giles County,51071,All,6715,5128,1587,303,300,258
2020,Gloucester County,51073,All,14792,11830,2962,384,477,374
2020,Goochland County,51075,All,8711,7466,1245,268,279,205
2020,Grayson County,51077,All,6388,5367,1021,268,262,204
2020,Greene County,51079,All,7491,6061,1430,231,324,276
2020,Greensville County,51081,All,3441,2473,968,225,216,178
2020,Halifax County,51083,All,14155,10592,3563,370,424,408
2020,Hanover County,51085,All,39226,32519,6707,442,697,545
2020,Henrico County,51087,All,130434,83448,46986,877,1547,1539
2020,Henry County,51089,All,21012,15121,5891,508,539,586
2020,Highland County,51091,All,987,862,125,108,114,53
2020,Isle of Wight County,51093,All,14611,11220,3391,327,463,381
2020,James City County,51095,All,29681,22709,6972,617,651,589
2020,King and Queen County,51097,All,2816,2382,434,150,183,122
2020,King George County,51099,All,9387,7137,2250,221,318,312
2020,King William County,51101,All,6393,5651,742,195,235,180
2020,Lancaster County,51103,All,5287,4010,1277,281,278,270
2020,Lee County,51105,All,8843,6130,2713,656,562,418
2020,Loudoun County,51107,All,132565,103019,29546,526,1152,1191
2020,Louisa County,51109,All,14383,11407,2976,403,522,428
2020,Lunenburg County,51111,All,4472,3187,1285,238,232,219
2020,Madison County,51113,All,5098,4004,1094,225,275,269
2020,Mathews County,51115,All,3881,3247,634,306,317,227
2020,Mecklenburg County,51117,All,12371,8962,3409,377,278,340
2020,Middlesex County,51119,All,4764,3746,1018,270,247,211
2020,Montgomery County,51121,All,35388,19618,15770,662,687,804
2020,Nelson County,51125,All,6398,4805,1593,440,350,361
2020,New Kent County,51127,All,8117,7302,815,242,276,224
2020,Northampton County,51131,All,5151,3244,1907,268,253,275
2020,Northumberland County,51133,All,5686,5081,605,407,357,198
2020,Nottoway County,51135,All,5568,3748,1820,319,310,281
2020,Orange County,51137,All,13926,10890,3036,308,372,366
2020,Page County,51139,All,9413,6760,2653,346,408,327
2020,Patrick County,51141,All,7830,6064,1766,325,339,295
2020,Pittsylvania County,51143,All,26205,19866,6339,475,614,484
2020,Powhatan County,51145,All,10392,9647,745,284,349,202
2020,Prince Edward County,51147,All,7394,4671,2723,368,311,355
2020,Prince George County,51149,All,11763,8065,3698,258,359,285
2020,Prince William County,51153,All,144159,105332,38827,718,1422,1342
2020,Pulaski County,51155,All,14666,10184,4482,432,411,443
2020,Rappahannock County,51157,All,2827,2181,646,202,166,157
2020,Richmond County,51159,All,2939,1886,1053,247,236,218
2020,Roanoke County,51161,All,38234,28547,9687,470,749,689
2020,Rockbridge County,51163,All,9301,6973,2328,339,382,394
2020,Rockingham County,51165,All,31306,23289,8017,406,654,646
2020,Russell County,51167,All,10975,8207,2768,313,435,405
2020,Scott County,51169,All,8710,6918,1792,293,322,251
2020,Shenandoah County,51171,All,17541,12219,5322,433,522,479
2020,Smyth County,51173,All,12694,8901,3793,312,311,272
2020,Southampton County,51175,All,6618,4923,1695,274,320,269
2020,Spotsylvania County,51177,All,45463,35937,9526,374,661,608
2020,Stafford County,51179,All,48160,37266,10894,493,734,684
2020,Surry County,51181,All,2794,2014,780,183,183,155
2020,Sussex County,51183,All,3792,2769,1023,198,227,190
2020,Tazewell County,51185,All,16371,12227,4144,570,582,502
2020,Warren County,51187,All,14641,11077,3564,327,353,340
2020,Washington County,51191,All,22104,16820,5284,448,462,436
2020,Westmoreland County,51193,All,7910,5848,2062,348,412,294
2020,Wise County,51195,All,14916,10262,4654,366,511,455
2020,Wythe County,51197,All,12393,9539,2854,436,388,352
2020,York County,51199,All,25517,18383,7134,347,521,521
2020,Alexandria city,51510,All,71289,30931,40358,687,879,898
2020,Bristol city,51520,All,7482,4600,2882,268,333,342
2020,Buena Vista city,51530,All,2509,1539,970,175,185,196
2020,Charlottesville city,51540,All,18814,7550,11264,350,472,449
2020,Chesapeake city,51550,All,86524,62590,23934,728,1053,1068
2020,Colonial Heights city,51570,All,7094,4674,2420,189,250,256
2020,Covington city,51580,All,2382,1796,586,147,165,133
2020,Danville city,51590,All,18266,9180,9086,437,451,541
2020,Emporia city,51595,All,2076,852,1224,177,174,172
2020,Fairfax city,51600,All,8751,6115,2636,135,276,273
2020,Falls Church city,51610,All,5631,3312,2319,153,241,285
2020,Franklin city,51620,All,3516,1957,1559,184,170,228
2020,Fredericksburg city,51630,All,11059,4398,6661,311,306,379
2020,Galax city,51640,All,2614,1774,840,209,243,204
2020,Hampton city,51650,All,54847,31233,23614,669,929,903
2020,Harrisonburg city,51660,All,16751,6790,9961,413,428,556
2020,Hopewell city,51670,All,9362,4407,4955,321,365,457
2020,Lexington city,51678,All,2066,1130,936,253,237,209
2020,Lynchburg city,51680,All,28223,14050,14173,618,530,676
2020,Manassas city,51683,All,13066,9058,4008,280,365,390
2020,Manassas Park city,51685,All,4596,2790,1806,150,290,337
2020,Martinsville city,51690,All,5597,3121,2476,217,242,222
2020,Newport News city,51700,All,70376,34014,36362,706,970,1074
2020,Norfolk city,51710,All,89398,38853,50545,856,1025,1296
2020,Norton city,51720,All,1877,972,905,190,198,221
2020,Petersburg city,51730,All,13231,4771,8460,298,360,426
2020,Poquoson city,51735,All,4632,3792,840,105,201,204
2020,Portsmouth city,51740,All,36650,20257,16393,406,637,591
2020,Radford city,51750,All,5677,2736,2941,255,289,376
2020,Richmond city,51760,All,91005,39801,51204,876,1116,1302
2020,Roanoke city,51770,All,41694,21792,19902,718,898,956
2020,Salem city,51775,All,9876,6365,3511,280,309,390
2020,Staunton city,51790,All,10638,6272,4366,315,358,336
2020,Suffolk city,51800,All,34603,24341,10262,357,611,625
2020,Virginia Beach city,51810,All,172452,111517,60935,1029,1618,1638
2020,Waynesboro city,51820,All,9169,5418,3751,316,373,369
2020,Williamsburg city,51830,All,4485,2340,2145,281,217,314
2020,Winchester city,51840,All,10669,4767,5902,302,380,426
2021,Accomack County,51001,All,14152,9463,4689,483,481,487
2021,Albemarle County,51003,All,43066,28425,14641,825,735,842
2021,Alleghany County,51005,All,6405,5161,1244,206,282,199
2021,Amelia County,51007,All,5190,4300,890,227,326,302
2021,Amherst County,51009,All,12538,9454,3084,346,401,363
2021,Appomattox County,51011,All,6187,4764,1423,243,281,244
2021,Arlington County,51013,All,109528,46308,63220,819,1126,1284
2021,Augusta County,51015,All,29880,23460,6420,499,745,673
2021,Bath County,51017,All,1823,1419,404,181,191,152
2021,Bedford County,51019,All,32269,27049,5220,464,551,494
2021,Bland County,51021,All,2260,1885,375,212,197,112
2021,Botetourt County,51023,All,13076,11227,1849,280,345,272
2021,Brunswick County,51025,All,5905,4468,1437,314,261,262
2021,Buchanan County,51027,All,7440,6071,1369,371,412,238
2021,Buckingham County,51029,All,5724,4240,1484,244,240,224
2021,Campbell County,51031,All,22243,16245,5998,388,535,530
2021,Caroline County,51033,All,11000,8967,2033,389,423,357
2021,Carroll County,51035,All,12127,9434,2693,376,448,367
2021,Charles City County,51036,All,2932,2481,451,62,89,77
2021,Charlotte County,51037,All,4606,3146,1460,196,214,178
2021,Chesterfield County,51041,All,131350,100642,30708,664,1154,1148
2021,Clarke County,51043,All,5692,4346,1346,194,256,249
2021,Craig County,51045,All,1941,1509,432,186,209,194
2021,Culpeper County,51047,All,17692,12987,4705,396,521,493
2021,Cumberland County,51049,All,3990,3074,916,179,224,193
2021,Dickenson County,51051,All,5573,4290,1283,230,272,222
2021,Dinwiddie County,51053,All,10268,7870,2398,359,445,378
2021,Essex County,51057,All,4299,2865,1434,158,236,232
2021,Fairfax County,51059,All,408673,280077,128596,1255,2094,2019
2021,Fauquier County,51061,All,25472,19510,5962,432,529,490
2021,Floyd County,51063,All,6695,5734,961,219,276,236
2021,Fluvanna County,51065,All,9979,8577,1402,258,340,282
2021,Franklin County,51067,All,22033,17721,4312,518,632,652
2021,Frederick County,51069,All,32723,24821,7902,431,704,616
2021,Giles County,51071,All,6824,5208,1616,307,296,259
2021,Gloucester County,51073,All,14882,11865,3017,383,476,414
2021,Goochland County,51075,All,9454,8119,1335,271,301,238
2021,Grayson County,51077,All,6112,5013,1099,257,262,171
2021,Greene County,51079,All,7533,6016,1517,266,265,253
2021,Greensville County,51081,All,3183,2339,844,237,250,160
2021,Halifax County,51083,All,13506,10007,3499,400,439,405
2021,Hanover County,51085,All,40310,33385,6925,399,639,498
2021,Henrico County,51087,All,132465,85336,47129,1011,1393,1422
2021,Henry County,51089,All,20516,14847,5669,482,585,576
2021,Highland County,51091,All,987,823,164,87,90,62
2021,Isle of Wight County,51093,All,15063,11731,3332,337,397,373
2021,James City County,51095,All,29748,22934,6814,479,626,631
2021,King and Queen County,51097,All,2803,2314,489,132,166,114
2021,King George County,51099,All,9445,7076,2369,211,294,310
2021,King William County,51101,All,6667,5798,869,176,265,217
2021,Lancaster County,51103,All,5197,4177,1020,284,285,236
2021,Lee County,51105,All,8244,5783,2461,385,375,350
2021,Loudoun County,51107,All,135690,105236,30454,464,1060,1015
2021,Louisa County,51109,All,14192,11498,2694,370,464,311
2021,Lunenburg County,51111,All,4304,2958,1346,193,228,240
2021,Madison County,51113,All,5175,4262,913,242,272,202
2021,Mathews County,51115,All,3558,2994,564,300,252,202
2021,Mecklenburg County,51117,All,12655,9001,3654,407,391,398
2021,Middlesex County,51119,All,4579,3865,714,248,222,188
2021,Montgomery County,51121,All,35533,19650,15883,746,640,771
2021,Nelson County,51125,All,6149,4725,1424,385,295,317
2021,New Kent County,51127,All,8306,7468,838,238,293,224
2021,Northampton County,51131,All,5292,3318,1974,235,257,254
2021,Northumberland County,51133,All,5127,4565,562,356,292,190
2021,Nottoway County,51135,All,5309,3783,1526,287,299,269
2021,Orange County,51137,All,13970,11010,2960,386,471,393
2021,Page County,51139,All,9355,6626,2729,291,349,353
2021,Patrick County,51141,All,7732,6051,1681,360,358,277
2021,Pittsylvania County,51143,All,24663,18882,5781,418,632,572
2021,Powhatan County,51145,All,10722,9809,913,301,415,252
2021,Prince Edward County,51147,All,7113,4386,2727,410,298,351
2021,Prince George County,51149,All,12492,8795,3697,403,435,427
2021,Prince William County,51153,All,150488,111213,39275,771,1443,1265
2021,Pulaski County,51155,All,14534,10065,4469,393,423,464
2021,Rappahannock County,51157,All,2773,2031,742,174,211,154
2021,Richmond County,51159,All,2811,1897,914,221,240,247
2021,Roanoke County,51161,All,39087,29402,9685,419,556,593
2021,Rockbridge County,51163,All,9045,6910,2135,369,363,351
2021,Rockingham County,51165,All,31189,23688,7501,414,559,561
2021,Russell County,51167,All,10355,7885,2470,311,397,385
2021,Scott County,51169,All,8612,6915,1697,284,264,229
2021,Shenandoah County,51171,All,17487,12633,4854,324,436,492
2021,Smyth County,51173,All,12607,8631,3976,318,345,350
2021,Southampton County,51175,All,6661,5060,1601,270,305,224
2021,Spotsylvania County,51177,All,47944,37629,10315,489,794,689
2021,Stafford County,51179,All,49469,38650,10819,507,887,858
2021,Surry County,51181,All,2720,2001,719,131,163,165
2021,Sussex County,51183,All,3656,2640,1016,182,203,173
2021,Tazewell County,51185,All,15759,11698,4061,489,480,428
2021,Warren County,51187,All,15082,11351,3731,319,455,423
2021,Washington County,51191,All,21845,16545,5300,388,471,489
2021,Westmoreland County,51193,All,7873,5941,1932,371,408,313
2021,Wise County,51195,All,14025,9933,4092,397,417,341
2021,Wythe County,51197,All,12125,9316,2809,356,440,327
2021,York County,51199,All,25389,18418,6971,376,446,489
2021,Alexandria city,51510,All,74224,31857,42367,679,880,966
2021,Bristol city,51520,All,7347,4595,2752,271,329,311
2021,Buena Vista city,51530,All,2581,1414,1167,194,238,256
2021,Charlottesville city,51540,All,19312,7979,11333,332,463,574
2021,Chesapeake city,51550,All,89413,64970,24443,621,1132,1102
2021,Colonial Heights city,51570,All,7465,4929,2536,198,291,242
2021,Covington city,51580,All,2547,1924,623,149,196,157
2021,Danville city,51590,All,18590,9475,9115,385,464,493
2021,Emporia city,51595,All,2240,906,1334,217,166,240
2021,Fairfax city,51600,All,9090,6388,2702,145,292,280
2021,Falls Church city,51610,All,5630,3229,2401,159,221,243
2021,Franklin city,51620,All,3474,1802,1672,190,223,245
2021,Fredericksburg city,51630,All,11198,4389,6809,356,321,463
2021,Galax city,51640,All,2780,1907,873,211,199,198
2021,Hampton city,51650,All,57116,31755,25361,664,913,936
2021,Harrisonburg city,51660,All,17102,6753,10349,450,511,590
2021,Hopewell city,51670,All,9269,4612,4657,303,408,445
2021,Lexington city,51678,All,2005,1079,926,275,236,211
2021,Lynchburg city,51680,All,28939,14208,14731,643,588,762
2021,Manassas city,51683,All,13562,9608,3954,258,412,384
2021,Manassas Park city,51685,All,5155,3165,1990,182,315,359
2021,Martinsville city,51690,All,5656,3264,2392,243,266,262
2021,Newport News city,51700,All,74922,35598,39324,693,1040,1150
2021,Norfolk city,51710,All,92877,40439,52438,1200,1174,1576
2021,Norton city,51720,All,1540,859,681,142,167,161
2021,Petersburg city,51730,All,14464,5196,9268,343,439,499
2021,Poquoson city,51735,All,4617,3782,835,116,181,166
2021,Portsmouth city,51740,All,38553,21463,17090,527,637,686
2021,Radford city,51750,All,5545,2535,3010,262,230,323
2021,Richmond city,51760,All,98821,42865,55956,1000,1111,1291
2021,Roanoke city,51770,All,42766,22215,20551,664,830,912
2021,Salem city,51775,All,9971,6521,3450,297,295,356
2021,Staunton city,51790,All,11125,6532,4593,283,327,347
2021,Suffolk city,51800,All,35249,24581,10668,375,688,623
2021,Virginia Beach city,51810,All,177046,114998,62048,963,1493,1507
2021,Waynesboro city,51820,All,9419,5628,3791,310,420,365
2021,Williamsburg city,51830,All,4778,2464,2314,308,224,333
2021,Winchester city,51840,All,11018,4988,6030,314,333,410
2010,Accomack County,51001,Black or African American ,3834,2643,1191,239,295,234
2010,Albemarle County,51003,Black or African American ,3570,1330,2240,250,187,268
2010,Alleghany County,51005,Black or African American ,377,232,145,74,66,82
2010,Amelia County,51007,Black or African American ,1067,874,193,143,159,96
2010,Amherst County,51009,Black or African American ,2494,1761,733,223,177,211
2010,Appomattox County,51011,Black or African American ,1150,692,458,120,117,124
2010,Arlington County,51013,Black or African American ,7876,2103,5773,421,254,456
2010,Augusta County,51015,Black or African American ,500,278,222,129,88,112
2010,Bath County,51017,Black or African American ,104,80,24,70,63,28
2010,Bedford County,51019,Black or African American ,1725,1163,562,165,173,182
2010,Bland County,51021,Black or African American ,53,33,20,30,40,30
2010,Botetourt County,51023,Black or African American ,406,339,67,91,88,58
2010,Brunswick County,51025,Black or African American ,3292,1862,1430,264,204,227
2010,Buchanan County,51027,Black or African American ,10,0,10,20,127,20
2010,Buckingham County,51029,Black or African American ,1995,1350,645,691,399,365
2010,Campbell County,51031,Black or African American ,2798,1680,1118,189,165,196
2010,Caroline County,51033,Black or African American ,2903,2261,642,183,168,158
2010,Carroll County,51035,Black or African American ,249,249,0,201,201,127
2010,Charles City County,51036,Black or African American ,1185,1047,138,93,93,50
2010,Charlotte County,51037,Black or African American ,1348,931,417,162,164,148
2010,Chesterfield County,51041,Black or African American ,22621,14881,7740,526,509,590
2010,Clarke County,51043,Black or African American ,246,96,150,75,47,77
2010,Craig County,51045,Black or African American ,0,0,0,127,127,127
2010,Culpeper County,51047,Black or African American ,2292,1307,985,190,156,202
2010,Cumberland County,51049,Black or African American ,1328,940,388,177,149,134
2010,Dickenson County,51051,Black or African American ,18,18,0,13,13,127
2010,Dinwiddie County,51053,Black or African American ,2907,1940,967,190,201,183
2010,Essex County,51057,Black or African American ,1593,1002,591,185,148,127
2010,Fairfax County,51059,Black or African American ,34382,16844,17538,730,709,765
2010,Fauquier County,51061,Black or African American ,1738,1173,565,185,194,207
2010,Floyd County,51063,Black or African American ,144,77,67,69,54,57
2010,Fluvanna County,51065,Black or African American ,1180,1010,170,135,125,91
2010,Franklin County,51067,Black or African American ,1927,1392,535,208,150,177
2010,Frederick County,51069,Black or African American ,859,530,329,108,129,115
2010,Giles County,51071,Black or African American ,95,93,2,51,51,4
2010,Gloucester County,51073,Black or African American ,1362,972,390,133,146,135
2010,Goochland County,51075,Black or African American ,1201,1134,67,180,168,50
2010,Grayson County,51077,Black or African American ,133,123,10,55,54,15
2010,Greene County,51079,Black or African American ,367,254,113,73,64,90
2010,Greensville County,51081,Black or African American ,1679,1132,547,162,164,160
2010,Halifax County,51083,Black or African American ,5103,3679,1424,277,300,241
2010,Hanover County,51085,Black or African American ,3042,2200,842,194,190,195
2010,Henrico County,51087,Black or African American ,33806,18327,15479,581,580,623
2010,Henry County,51089,Black or African American ,4928,3225,1703,234,276,268
2010,Highland County,51091,Black or African American ,0,0,0,127,127,127
2010,Isle of Wight County,51093,Black or African American ,3514,2251,1263,168,184,216
2010,James City County,51095,Black or African American ,3078,1800,1278,277,293,227
2010,King and Queen County,51097,Black or African American ,778,667,111,139,134,77
2010,King George County,51099,Black or African American ,1404,918,486,140,132,138
2010,King William County,51101,Black or African American ,1173,936,237,126,135,93
2010,Lancaster County,51103,Black or African American ,1466,884,582,186,140,156
2010,Lee County,51105,Black or African American ,107,45,62,51,47,56
2010,Loudoun County,51107,Black or African American ,7436,4836,2600,361,373,380
2010,Louisa County,51109,Black or African American ,2403,1558,845,174,138,209
2010,Lunenburg County,51111,Black or African American ,1471,992,479,155,138,149
2010,Madison County,51113,Black or African American ,663,531,132,109,135,80
2010,Mathews County,51115,Black or African American ,419,275,144,95,87,94
2010,Mecklenburg County,51117,Black or African American ,4167,2639,1528,314,247,218
2010,Middlesex County,51119,Black or African American ,653,482,171,124,124,90
2010,Montgomery County,51121,Black or African American ,1510,499,1011,186,111,212
2010,Nelson County,51125,Black or African American ,897,728,169,135,159,111
2010,New Kent County,51127,Black or African American ,881,725,156,169,138,116
2010,Northampton County,51131,Black or African American ,1772,1035,737,167,148,154
2010,Northumberland County,51133,Black or African American ,1164,916,248,126,142,112
2010,Nottoway County,51135,Black or African American ,2023,925,1098,223,170,219
2010,Orange County,51137,Black or African American ,1520,981,539,162,146,144
2010,Page County,51139,Black or African American ,176,92,84,54,51,56
2010,Patrick County,51141,Black or African American ,375,193,182,96,59,91
2010,Pittsylvania County,51143,Black or African American ,5769,3996,1773,224,248,255
2010,Powhatan County,51145,Black or African American ,696,593,103,149,136,62
2010,Prince Edward County,51147,Black or African American ,2492,1384,1108,235,190,244
2010,Prince George County,51149,Black or African American ,3108,1951,1157,196,229,218
2010,Prince William County,51153,Black or African American ,25514,15653,9861,608,703,689
2010,Pulaski County,51155,Black or African American ,663,390,273,136,108,138
2010,Rappahannock County,51157,Black or African American ,109,93,16,59,52,30
2010,Richmond County,51159,Black or African American ,595,448,147,265,205,92
2010,Roanoke County,51161,Black or African American ,1863,972,891,201,172,162
2010,Rockbridge County,51163,Black or African American ,237,152,85,106,85,80
2010,Rockingham County,51165,Black or African American ,463,314,149,143,129,88
2010,Russell County,51167,Black or African American ,128,82,46,54,54,54
2010,Scott County,51169,Black or African American ,23,3,20,18,7,20
2010,Shenandoah County,51171,Black or African American ,286,169,117,55,61,61
2010,Smyth County,51173,Black or African American ,120,32,88,69,31,66
2010,Southampton County,51175,Black or African American ,2269,1543,726,162,173,134
2010,Spotsylvania County,51177,Black or African American ,6398,4594,1804,249,334,293
2010,Stafford County,51179,Black or African American ,6554,4398,2156,308,311,345
2010,Surry County,51181,Black or African American ,1113,781,332,126,106,109
2010,Sussex County,51183,Black or African American ,2010,1199,811,180,163,176
2010,Tazewell County,51185,Black or African American ,638,137,501,165,80,151
2010,Warren County,51187,Black or African American ,663,454,209,103,102,98
2010,Washington County,51191,Black or African American ,310,120,190,70,71,85
2010,Westmoreland County,51193,Black or African American ,1773,1306,467,193,155,168
2010,Wise County,51195,Black or African American ,203,174,29,54,57,32
2010,Wythe County,51197,Black or African American ,364,259,105,95,84,60
2010,York County,51199,Black or African American ,3299,2139,1160,226,180,254
2010,Alexandria city,51510,Black or African American ,12475,2618,9857,516,340,496
2010,Bedford County,51019,Black or African American ,597,252,345,127,111,135
2010,Bristol city,51520,Black or African American ,456,86,370,102,48,121
2010,Buena Vista city,51530,Black or African American ,196,160,36,43,64,38
2010,Charlottesville city,51540,Black or African American ,3058,844,2214,238,152,258
2010,Chesapeake city,51550,Black or African American ,23387,14469,8918,461,475,575
2010,Colonial Heights city,51570,Black or African American ,736,155,581,102,72,112
2010,Covington city,51580,Black or African American ,388,275,113,62,67,65
2010,Danville city,51590,Black or African American ,8652,3534,5118,325,275,388
2010,Emporia city,51595,Black or African American ,1425,551,874,149,119,148
2010,Fairfax city,51600,Black or African American ,364,109,255,68,35,69
2010,Falls Church city,51610,Black or African American ,125,28,97,33,25,35
2010,Franklin city,51620,Black or African American ,2007,470,1537,139,129,168
2010,Fredericksburg city,51630,Black or African American ,1994,491,1503,213,116,210
2010,Galax city,51640,Black or African American ,107,68,39,69,48,49
2010,Hampton city,51650,Black or African American ,24979,12592,12387,595,534,660
2010,Harrisonburg city,51660,Black or African American ,1083,216,867,193,146,231
2010,Hopewell city,51670,Black or African American ,3132,1010,2122,212,176,210
2010,Lexington city,51678,Black or African American ,139,63,76,49,46,52
2010,Lynchburg city,51680,Black or African American ,8102,3484,4618,350,311,432
2010,Manassas city,51683,Black or African American ,1350,856,494,186,165,187
2010,Manassas Park city,51685,Black or African American ,619,249,370,75,102,102
2010,Martinsville city,51690,Black or African American ,2393,1067,1326,216,165,197
2010,Newport News city,51700,Black or African American ,29432,10438,18994,586,544,655
2010,Norfolk city,51710,Black or African American ,34548,10927,23621,781,550,779
2010,Norton city,51720,Black or African American ,87,15,72,62,17,60
2010,Petersburg city,51730,Black or African American ,9556,4537,5019,318,293,357
2010,Poquoson city,51735,Black or African American ,11,11,0,17,17,127
2010,Portsmouth city,51740,Black or African American ,18747,8915,9832,531,464,536
2010,Radford city,51750,Black or African American ,387,212,175,124,56,116
2010,Richmond city,51760,Black or African American ,40096,14565,25531,851,563,773
2010,Roanoke city,51770,Black or African American ,11104,4895,6209,452,375,487
2010,Salem city,51775,Black or African American ,505,77,428,109,52,95
2010,Staunton city,51790,Black or African American ,1029,441,588,181,127,160
2010,Suffolk city,51800,Black or African American ,12384,7570,4814,427,440,388
2010,Virginia Beach city,51810,Black or African American ,30401,14458,15943,704,621,807
2010,Waynesboro city,51820,Black or African American ,812,293,519,146,88,154
2010,Williamsburg city,51830,Black or African American ,691,249,442,123,82,122
2010,Winchester city,51840,Black or African American ,638,245,393,454,241,243
2011,Accomack County,51001,Black or African American ,3675,2374,1301,300,274,229
2011,Albemarle County,51003,Black or African American ,3703,1612,2091,314,230,310
2011,Alleghany County,51005,Black or African American ,329,276,53,63,62,41
2011,Amelia County,51007,Black or African American ,1087,796,291,144,178,118
2011,Amherst County,51009,Black or African American ,2645,1853,792,202,217,174
2011,Appomattox County,51011,Black or African American ,1087,680,407,134,119,120
2011,Arlington County,51013,Black or African American ,7864,2104,5760,353,238,416
2011,Augusta County,51015,Black or African American ,534,332,202,155,124,108
2011,Bath County,51017,Black or African American ,57,29,28,36,28,25
2011,Bedford County,51019,Black or African American ,1592,974,618,208,177,196
2011,Bland County,51021,Black or African American ,68,41,27,50,44,39
2011,Botetourt County,51023,Black or African American ,385,307,78,78,71,56
2011,Brunswick County,51025,Black or African American ,3334,1941,1393,514,240,409
2011,Buchanan County,51027,Black or African American ,18,0,18,31,95,31
2011,Buckingham County,51029,Black or African American ,1968,1283,685,344,269,198
2011,Campbell County,51031,Black or African American ,2819,1639,1180,223,198,261
2011,Caroline County,51033,Black or African American ,3060,2348,712,190,210,157
2011,Carroll County,51035,Black or African American ,190,190,0,128,128,95
2011,Charles City County,51036,Black or African American ,1235,1085,150,78,73,47
2011,Charlotte County,51037,Black or African American ,1408,897,511,117,143,132
2011,Chesterfield County,51041,Black or African American ,22957,15368,7589,516,589,561
2011,Clarke County,51043,Black or African American ,275,99,176,80,54,89
2011,Craig County,51045,Black or African American ,0,0,0,95,95,95
2011,Culpeper County,51047,Black or African American ,2241,1354,887,275,237,201
2011,Cumberland County,51049,Black or African American ,1342,923,419,191,175,135
2011,Dickenson County,51051,Black or African American ,23,23,0,12,12,95
2011,Dinwiddie County,51053,Black or African American ,3006,2015,991,210,226,179
2011,Essex County,51057,Black or African American ,1558,1032,526,149,143,135
2011,Fairfax County,51059,Black or African American ,35151,16942,18209,738,802,838
2011,Fauquier County,51061,Black or African American ,1664,1157,507,169,169,177
2011,Floyd County,51063,Black or African American ,120,51,69,93,57,74
2011,Fluvanna County,51065,Black or African American ,1148,960,188,181,153,86
2011,Franklin County,51067,Black or African American ,2046,1412,634,162,197,190
2011,Frederick County,51069,Black or African American ,884,612,272,142,156,126
2011,Giles County,51071,Black or African American ,88,86,2,41,41,4
2011,Gloucester County,51073,Black or African American ,1332,1049,283,142,128,112
2011,Goochland County,51075,Black or African American ,1086,986,100,194,171,72
2011,Grayson County,51077,Black or African American ,157,143,14,69,69,20
2011,Greene County,51079,Black or African American ,403,295,108,77,63,75
2011,Greensville County,51081,Black or African American ,1644,1078,566,243,170,170
2011,Halifax County,51083,Black or African American ,5161,3618,1543,278,246,216
2011,Hanover County,51085,Black or African American ,3212,2354,858,194,173,165
2011,Henrico County,51087,Black or African American ,34848,18764,16084,614,655,673
2011,Henry County,51089,Black or African American ,4781,3081,1700,249,277,250
2011,Highland County,51091,Black or African American ,0,0,0,95,95,95
2011,Isle of Wight County,51093,Black or African American ,3450,2249,1201,188,201,204
2011,James City County,51095,Black or African American ,3069,1719,1350,245,234,242
2011,King and Queen County,51097,Black or African American ,874,773,101,94,104,53
2011,King George County,51099,Black or African American ,1495,968,527,162,168,118
2011,King William County,51101,Black or African American ,1117,934,183,109,116,91
2011,Lancaster County,51103,Black or African American ,1428,860,568,154,128,144
2011,Lee County,51105,Black or African American ,50,15,35,57,33,47
2011,Loudoun County,51107,Black or African American ,8014,5032,2982,359,418,369
2011,Louisa County,51109,Black or African American ,2384,1650,734,172,141,174
2011,Lunenburg County,51111,Black or African American ,1364,910,454,223,161,140
2011,Madison County,51113,Black or African American ,589,458,131,102,124,85
2011,Mathews County,51115,Black or African American ,412,306,106,73,91,75
2011,Mecklenburg County,51117,Black or African American ,4220,2530,1690,327,289,269
2011,Middlesex County,51119,Black or African American ,700,529,171,128,110,74
2011,Montgomery County,51121,Black or African American ,1541,519,1022,193,122,219
2011,Nelson County,51125,Black or African American ,857,638,219,125,130,136
2011,New Kent County,51127,Black or African American ,875,733,142,100,91,102
2011,Northampton County,51131,Black or African American ,1832,1043,789,185,123,135
2011,Northumberland County,51133,Black or African American ,1157,875,282,136,127,118
2011,Nottoway County,51135,Black or African American ,1961,962,999,202,169,224
2011,Orange County,51137,Black or African American ,1431,960,471,144,144,143
2011,Page County,51139,Black or African American ,177,103,74,60,47,69
2011,Patrick County,51141,Black or African American ,389,208,181,90,49,92
2011,Pittsylvania County,51143,Black or African American ,5626,4014,1612,255,279,269
2011,Powhatan County,51145,Black or African American ,658,551,107,274,230,72
2011,Prince Edward County,51147,Black or African American ,2563,1531,1032,235,195,228
2011,Prince George County,51149,Black or African American ,2909,1881,1028,441,259,295
2011,Prince William County,51153,Black or African American ,26423,15725,10698,531,626,672
2011,Pulaski County,51155,Black or African American ,561,295,266,95,91,116
2011,Rappahannock County,51157,Black or African American ,137,137,0,43,43,95
2011,Richmond County,51159,Black or African American ,612,470,142,195,177,73
2011,Roanoke County,51161,Black or African American ,1836,1015,821,212,177,200
2011,Rockbridge County,51163,Black or African American ,310,152,158,75,54,78
2011,Rockingham County,51165,Black or African American ,362,295,67,87,92,53
2011,Russell County,51167,Black or African American ,92,52,40,51,46,48
2011,Scott County,51169,Black or African American ,45,36,9,30,36,14
2011,Shenandoah County,51171,Black or African American ,258,121,137,70,68,84
2011,Smyth County,51173,Black or African American ,121,39,82,52,38,41
2011,Southampton County,51175,Black or African American ,2317,1526,791,218,183,173
2011,Spotsylvania County,51177,Black or African American ,6621,4351,2270,323,382,330
2011,Stafford County,51179,Black or African American ,6483,4379,2104,308,267,317
2011,Surry County,51181,Black or African American ,1117,784,333,131,100,94
2011,Sussex County,51183,Black or African American ,1828,1064,764,281,183,212
2011,Tazewell County,51185,Black or African American ,568,186,382,133,86,150
2011,Warren County,51187,Black or African American ,640,450,190,117,118,112
2011,Washington County,51191,Black or African American ,247,96,151,84,86,68
2011,Westmoreland County,51193,Black or African American ,1811,1271,540,226,173,191
2011,Wise County,51195,Black or African American ,176,143,33,101,101,31
2011,Wythe County,51197,Black or African American ,239,165,74,128,116,43
2011,York County,51199,Black or African American ,3333,1947,1386,211,226,196
2011,Alexandria city,51510,Black or African American ,12392,2769,9623,580,342,569
2011,Bedford County,51019,Black or African American ,594,209,385,130,103,142
2011,Bristol city,51520,Black or African American ,378,65,313,106,37,114
2011,Buena Vista city,51530,Black or African American ,198,163,35,71,83,36
2011,Charlottesville city,51540,Black or African American ,3092,925,2167,231,144,260
2011,Chesapeake city,51550,Black or African American ,23341,14510,8831,569,515,569
2011,Colonial Heights city,51570,Black or African American ,777,133,644,97,59,95
2011,Covington city,51580,Black or African American ,360,243,117,76,78,65
2011,Danville city,51590,Black or African American ,8537,3601,4936,306,238,355
2011,Emporia city,51595,Black or African American ,1617,643,974,161,133,156
2011,Fairfax city,51600,Black or African American ,348,94,254,91,50,94
2011,Falls Church city,51610,Black or African American ,142,28,114,52,31,59
2011,Franklin city,51620,Black or African American ,1921,373,1548,150,113,188
2011,Fredericksburg city,51630,Black or African American ,1994,536,1458,216,114,222
2011,Galax city,51640,Black or African American ,109,65,44,81,49,55
2011,Hampton city,51650,Black or African American ,24960,13101,11859,579,470,626
2011,Harrisonburg city,51660,Black or African American ,1092,189,903,196,112,203
2011,Hopewell city,51670,Black or African American ,3111,928,2183,204,166,197
2011,Lexington city,51678,Black or African American ,178,64,114,109,47,86
2011,Lynchburg city,51680,Black or African American ,8173,3398,4775,279,265,336
2011,Manassas city,51683,Black or African American ,1523,907,616,186,161,193
2011,Manassas Park city,51685,Black or African American ,694,266,428,79,89,112
2011,Martinsville city,51690,Black or African American ,2528,1080,1448,178,167,226
2011,Newport News city,51700,Black or African American ,29066,10597,18469,588,557,742
2011,Norfolk city,51710,Black or African American ,34525,11287,23238,774,453,748
2011,Norton city,51720,Black or African American ,111,23,88,71,25,69
2011,Petersburg city,51730,Black or African American ,9475,4187,5288,369,324,330
2011,Poquoson city,51735,Black or African American ,8,8,0,13,13,95
2011,Portsmouth city,51740,Black or African American ,18694,8936,9758,528,466,552
2011,Radford city,51750,Black or African American ,384,151,233,103,57,98
2011,Richmond city,51760,Black or African American ,39726,14724,25002,771,721,723
2011,Roanoke city,51770,Black or African American ,10908,4744,6164,378,409,499
2011,Salem city,51775,Black or African American ,540,102,438,118,62,113
2011,Staunton city,51790,Black or African American ,939,463,476,122,93,118
2011,Suffolk city,51800,Black or African American ,12346,7750,4596,445,397,389
2011,Virginia Beach city,51810,Black or African American ,30801,14966,15835,614,568,687
2011,Waynesboro city,51820,Black or African American ,883,281,602,124,86,147
2011,Williamsburg city,51830,Black or African American ,616,185,431,147,66,127
2011,Winchester city,51840,Black or African American ,869,339,530,166,102,163
2012,Accomack County,51001,Black or African American ,4010,2469,1541,305,261,281
2012,Albemarle County,51003,Black or African American ,3531,1402,2129,316,201,326
2012,Alleghany County,51005,Black or African American ,307,293,14,66,70,25
2012,Amelia County,51007,Black or African American ,1090,842,248,140,153,114
2012,Amherst County,51009,Black or African American ,2597,1833,764,213,196,180
2012,Appomattox County,51011,Black or African American ,1139,762,377,132,142,118
2012,Arlington County,51013,Black or African American ,7658,1970,5688,382,263,410
2012,Augusta County,51015,Black or African American ,499,288,211,109,85,103
2012,Bath County,51017,Black or African American ,62,34,28,44,36,30
2012,Bedford County,51019,Black or African American ,1613,1133,480,176,184,170
2012,Bland County,51021,Black or African American ,31,11,20,29,20,32
2012,Botetourt County,51023,Black or African American ,398,315,83,71,77,60
2012,Brunswick County,51025,Black or African American ,3238,1929,1309,293,214,240
2012,Buchanan County,51027,Black or African American ,21,0,21,39,23,39
2012,Buckingham County,51029,Black or African American ,1920,1297,623,262,205,191
2012,Campbell County,51031,Black or African American ,2757,1698,1059,207,172,203
2012,Caroline County,51033,Black or African American ,3065,2456,609,187,170,162
2012,Carroll County,51035,Black or African American ,64,64,0,29,29,23
2012,Charles City County,51036,Black or African American ,1251,1031,220,82,85,69
2012,Charlotte County,51037,Black or African American ,1446,956,490,116,136,119
2012,Chesterfield County,51041,Black or African American ,23134,15309,7825,524,488,599
2012,Clarke County,51043,Black or African American ,261,139,122,60,46,61
2012,Craig County,51045,Black or African American ,0,0,0,17,17,17
2012,Culpeper County,51047,Black or African American ,2217,1382,835,208,173,225
2012,Cumberland County,51049,Black or African American ,1351,940,411,160,164,121
2012,Dickenson County,51051,Black or African American ,11,11,0,16,16,19
2012,Dinwiddie County,51053,Black or African American ,3278,2167,1111,206,242,224
2012,Essex County,51057,Black or African American ,1576,1079,497,135,135,101
2012,Fairfax County,51059,Black or African American ,35160,16268,18892,687,546,746
2012,Fauquier County,51061,Black or African American ,1838,1292,546,197,169,159
2012,Floyd County,51063,Black or African American ,117,60,57,75,56,50
2012,Fluvanna County,51065,Black or African American ,1214,1000,214,143,142,103
2012,Franklin County,51067,Black or African American ,1919,1344,575,180,190,169
2012,Frederick County,51069,Black or African American ,1037,741,296,163,152,140
2012,Giles County,51071,Black or African American ,94,94,0,48,48,19
2012,Gloucester County,51073,Black or African American ,1369,1064,305,127,139,107
2012,Goochland County,51075,Black or African American ,1173,1041,132,158,125,87
2012,Grayson County,51077,Black or African American ,141,101,40,45,28,42
2012,Greene County,51079,Black or African American ,423,272,151,76,73,95
2012,Greensville County,51081,Black or African American ,1695,1158,537,326,256,169
2012,Halifax County,51083,Black or African American ,5333,3600,1733,292,295,223
2012,Hanover County,51085,Black or African American ,3285,2448,837,210,186,173
2012,Henrico County,51087,Black or African American ,35232,18570,16662,605,587,657
2012,Henry County,51089,Black or African American ,4692,3138,1554,283,234,243
2012,Highland County,51091,Black or African American ,0,0,0,12,12,12
2012,Isle of Wight County,51093,Black or African American ,3473,2259,1214,179,179,180
2012,James City County,51095,Black or African American ,3158,2009,1149,225,230,183
2012,King and Queen County,51097,Black or African American ,841,697,144,107,113,67
2012,King George County,51099,Black or African American ,1461,871,590,171,162,121
2012,King William County,51101,Black or African American ,1159,945,214,133,160,106
2012,Lancaster County,51103,Black or African American ,1346,837,509,159,139,147
2012,Lee County,51105,Black or African American ,57,22,35,60,30,50
2012,Loudoun County,51107,Black or African American ,8058,5090,2968,343,315,335
2012,Louisa County,51109,Black or African American ,2242,1675,567,158,159,133
2012,Lunenburg County,51111,Black or African American ,1485,950,535,202,131,160
2012,Madison County,51113,Black or African American ,615,531,84,111,118,62
2012,Mathews County,51115,Black or African American ,367,267,100,82,75,77
2012,Mecklenburg County,51117,Black or African American ,4363,2503,1860,277,244,220
2012,Middlesex County,51119,Black or African American ,736,563,173,81,85,67
2012,Montgomery County,51121,Black or African American ,1413,533,880,151,153,184
2012,Nelson County,51125,Black or African American ,995,784,211,147,149,144
2012,New Kent County,51127,Black or African American ,873,728,145,100,93,92
2012,Northampton County,51131,Black or African American ,1764,992,772,174,148,146
2012,Northumberland County,51133,Black or African American ,1180,910,270,130,119,126
2012,Nottoway County,51135,Black or African American ,1944,1012,932,200,137,205
2012,Orange County,51137,Black or African American ,1509,1006,503,149,125,134
2012,Page County,51139,Black or African American ,155,80,75,73,48,63
2012,Patrick County,51141,Black or African American ,420,278,142,85,51,73
2012,Pittsylvania County,51143,Black or African American ,5267,3824,1443,246,292,220
2012,Powhatan County,51145,Black or African American ,780,612,168,154,162,88
2012,Prince Edward County,51147,Black or African American ,2501,1569,932,238,193,255
2012,Prince George County,51149,Black or African American ,3071,1814,1257,234,212,221
2012,Prince William County,51153,Black or African American ,26984,15812,11172,519,677,558
2012,Pulaski County,51155,Black or African American ,573,299,274,106,96,120
2012,Rappahannock County,51157,Black or African American ,155,141,14,31,24,24
2012,Richmond County,51159,Black or African American ,589,394,195,182,157,104
2012,Roanoke County,51161,Black or African American ,1925,996,929,211,185,217
2012,Rockbridge County,51163,Black or African American ,285,144,141,80,60,87
2012,Rockingham County,51165,Black or African American ,364,301,63,83,73,55
2012,Russell County,51167,Black or African American ,90,36,54,54,36,55
2012,Scott County,51169,Black or African American ,50,38,12,36,40,19
2012,Shenandoah County,51171,Black or African American ,272,107,165,65,60,75
2012,Smyth County,51173,Black or African American ,158,34,124,67,39,63
2012,Southampton County,51175,Black or African American ,2236,1407,829,203,191,177
2012,Spotsylvania County,51177,Black or African American ,6610,4305,2305,305,357,305
2012,Stafford County,51179,Black or African American ,6679,4513,2166,294,282,300
2012,Surry County,51181,Black or African American ,1126,804,322,114,111,112
2012,Sussex County,51183,Black or African American ,1936,1107,829,199,155,153
2012,Tazewell County,51185,Black or African American ,552,190,362,128,88,141
2012,Warren County,51187,Black or African American ,678,351,327,132,125,120
2012,Washington County,51191,Black or African American ,298,87,211,67,80,83
2012,Westmoreland County,51193,Black or African American ,1871,1376,495,209,180,159
2012,Wise County,51195,Black or African American ,232,143,89,78,83,58
2012,Wythe County,51197,Black or African American ,205,131,74,109,88,41
2012,York County,51199,Black or African American ,3288,1840,1448,205,208,209
2012,Alexandria city,51510,Black or African American ,12622,2478,10144,568,281,582
2012,Bedford County,51019,Black or African American ,618,209,409,123,102,139
2012,Bristol city,51520,Black or African American ,368,23,345,84,21,89
2012,Buena Vista city,51530,Black or African American ,212,166,46,70,85,56
2012,Charlottesville city,51540,Black or African American ,3064,908,2156,263,152,266
2012,Chesapeake city,51550,Black or African American ,23463,14053,9410,464,531,560
2012,Colonial Heights city,51570,Black or African American ,792,93,699,98,49,111
2012,Covington city,51580,Black or African American ,381,243,138,78,87,73
2012,Danville city,51590,Black or African American ,8621,3616,5005,316,291,380
2012,Emporia city,51595,Black or African American ,1621,549,1072,190,127,182
2012,Fairfax city,51600,Black or African American ,385,101,284,99,51,100
2012,Falls Church city,51610,Black or African American ,236,86,150,74,91,82
2012,Franklin city,51620,Black or African American ,2006,367,1639,129,114,189
2012,Fredericksburg city,51630,Black or African American ,2164,535,1629,217,161,237
2012,Galax city,51640,Black or African American ,128,88,40,67,55,50
2012,Hampton city,51650,Black or African American ,25465,13048,12417,671,509,650
2012,Harrisonburg city,51660,Black or African American ,1177,249,928,202,136,232
2012,Hopewell city,51670,Black or African American ,3186,1002,2184,226,189,232
2012,Lexington city,51678,Black or African American ,187,72,115,102,54,96
2012,Lynchburg city,51680,Black or African American ,8285,3445,4840,342,279,402
2012,Manassas city,51683,Black or African American ,1672,899,773,223,183,184
2012,Manassas Park city,51685,Black or African American ,698,295,403,106,106,109
2012,Martinsville city,51690,Black or African American ,2399,955,1444,189,144,182
2012,Newport News city,51700,Black or African American ,28691,10326,18365,619,514,633
2012,Norfolk city,51710,Black or African American ,34595,10816,23779,730,499,741
2012,Norton city,51720,Black or African American ,111,14,97,68,24,67
2012,Petersburg city,51730,Black or African American ,9630,4068,5562,413,359,334
2012,Poquoson city,51735,Black or African American ,11,11,0,17,17,19
2012,Portsmouth city,51740,Black or African American ,18846,8613,10233,433,473,467
2012,Radford city,51750,Black or African American ,320,105,215,126,64,110
2012,Richmond city,51760,Black or African American ,39224,14296,24928,622,593,790
2012,Roanoke city,51770,Black or African American ,10891,4640,6251,409,348,423
2012,Salem city,51775,Black or African American ,609,172,437,123,100,113
2012,Staunton city,51790,Black or African American ,1045,436,609,137,96,137
2012,Suffolk city,51800,Black or African American ,12522,7827,4695,369,399,394
2012,Virginia Beach city,51810,Black or African American ,30316,14364,15952,723,719,805
2012,Waynesboro city,51820,Black or African American ,935,256,679,120,87,130
2012,Williamsburg city,51830,Black or African American ,842,190,652,122,70,137
2012,Winchester city,51840,Black or African American ,898,328,570,167,116,134
2013,Accomack County,51001,Black or African American ,4092,2484,1608,339,280,324
2013,Albemarle County,51003,Black or African American ,3353,1399,1954,284,194,285
2013,Alleghany County,51005,Black or African American ,300,265,35,47,49,28
2013,Amelia County,51007,Black or African American ,1073,820,253,126,145,85
2013,Amherst County,51009,Black or African American ,2399,1579,820,150,150,154
2013,Appomattox County,51011,Black or African American ,1062,752,310,137,133,86
2013,Arlington County,51013,Black or African American ,7774,1943,5831,373,257,375
2013,Augusta County,51015,Black or African American ,486,330,156,105,105,72
2013,Bath County,51017,Black or African American ,77,33,44,56,33,49
2013,Bedford County,51019,Black or African American ,1578,1071,507,204,206,145
2013,Bland County,51021,Black or African American ,29,9,20,25,15,29
2013,Botetourt County,51023,Black or African American ,437,384,53,76,80,41
2013,Brunswick County,51025,Black or African American ,3073,1846,1227,288,201,247
2013,Buchanan County,51027,Black or African American ,57,0,57,53,23,53
2013,Buckingham County,51029,Black or African American ,1864,1298,566,226,197,164
2013,Campbell County,51031,Black or African American ,2771,1709,1062,224,207,221
2013,Caroline County,51033,Black or African American ,3081,2356,725,170,190,186
2013,Carroll County,51035,Black or African American ,63,63,0,32,32,23
2013,Charles City County,51036,Black or African American ,1277,1030,247,76,89,68
2013,Charlotte County,51037,Black or African American ,1400,847,553,144,140,149
2013,Chesterfield County,51041,Black or African American ,23139,15312,7827,565,430,573
2013,Clarke County,51043,Black or African American ,260,149,111,60,49,56
2013,Craig County,51045,Black or African American ,0,0,0,17,17,17
2013,Culpeper County,51047,Black or African American ,2122,1320,802,206,182,161
2013,Cumberland County,51049,Black or African American ,1392,966,426,185,185,156
2013,Dickenson County,51051,Black or African American ,9,9,0,19,19,19
2013,Dinwiddie County,51053,Black or African American ,3161,2185,976,217,265,214
2013,Essex County,51057,Black or African American ,1508,1036,472,139,148,109
2013,Fairfax County,51059,Black or African American ,35525,16391,19134,600,617,696
2013,Fauquier County,51061,Black or African American ,1797,1240,557,212,155,159
2013,Floyd County,51063,Black or African American ,113,70,43,68,57,40
2013,Fluvanna County,51065,Black or African American ,1246,1007,239,183,158,127
2013,Franklin County,51067,Black or African American ,1706,1192,514,193,196,154
2013,Frederick County,51069,Black or African American ,1073,707,366,137,198,147
2013,Giles County,51071,Black or African American ,60,60,0,36,36,19
2013,Gloucester County,51073,Black or African American ,1335,961,374,136,133,134
2013,Goochland County,51075,Black or African American ,1289,1071,218,161,150,114
2013,Grayson County,51077,Black or African American ,143,91,52,49,52,42
2013,Greene County,51079,Black or African American ,396,274,122,139,105,88
2013,Greensville County,51081,Black or African American ,1796,1273,523,325,256,163
2013,Halifax County,51083,Black or African American ,5266,3357,1909,309,261,250
2013,Hanover County,51085,Black or African American ,3452,2400,1052,205,207,193
2013,Henrico County,51087,Black or African American ,35598,18575,17023,664,699,749
2013,Henry County,51089,Black or African American ,4642,2997,1645,313,239,236
2013,Highland County,51091,Black or African American ,0,0,0,12,12,12
2013,Isle of Wight County,51093,Black or African American ,3389,2241,1148,164,174,169
2013,James City County,51095,Black or African American ,3267,2082,1185,218,227,226
2013,King and Queen County,51097,Black or African American ,839,656,183,92,108,80
2013,King George County,51099,Black or African American ,1512,864,648,175,168,155
2013,King William County,51101,Black or African American ,1076,909,167,121,125,106
2013,Lancaster County,51103,Black or African American ,1235,777,458,128,119,115
2013,Lee County,51105,Black or African American ,11,11,0,14,14,23
2013,Loudoun County,51107,Black or African American ,8333,5043,3290,357,383,358
2013,Louisa County,51109,Black or African American ,2202,1718,484,183,166,138
2013,Lunenburg County,51111,Black or African American ,1369,833,536,172,140,129
2013,Madison County,51113,Black or African American ,548,462,86,94,84,58
2013,Mathews County,51115,Black or African American ,385,269,116,120,82,89
2013,Mecklenburg County,51117,Black or African American ,4188,2426,1762,283,207,240
2013,Middlesex County,51119,Black or African American ,751,519,232,114,105,97
2013,Montgomery County,51121,Black or African American ,1423,537,886,202,178,218
2013,Nelson County,51125,Black or African American ,880,582,298,107,125,133
2013,New Kent County,51127,Black or African American ,858,753,105,92,101,76
2013,Northampton County,51131,Black or African American ,1914,1053,861,156,151,152
2013,Northumberland County,51133,Black or African American ,1211,914,297,142,122,140
2013,Nottoway County,51135,Black or African American ,1836,927,909,191,158,173
2013,Orange County,51137,Black or African American ,1476,851,625,186,138,168
2013,Page County,51139,Black or African American ,124,124,0,72,72,23
2013,Patrick County,51141,Black or African American ,472,300,172,96,66,97
2013,Pittsylvania County,51143,Black or African American ,5247,3796,1451,234,249,186
2013,Powhatan County,51145,Black or African American ,766,627,139,162,162,84
2013,Prince Edward County,51147,Black or African American ,2656,1456,1200,236,211,307
2013,Prince George County,51149,Black or African American ,2878,1658,1220,261,204,270
2013,Prince William County,51153,Black or African American ,27709,16517,11192,681,648,815
2013,Pulaski County,51155,Black or African American ,653,329,324,104,92,116
2013,Rappahannock County,51157,Black or African American ,148,137,11,44,36,20
2013,Richmond County,51159,Black or African American ,600,478,122,213,212,74
2013,Roanoke County,51161,Black or African American ,1917,980,937,231,161,193
2013,Rockbridge County,51163,Black or African American ,266,129,137,62,51,72
2013,Rockingham County,51165,Black or African American ,310,225,85,82,84,53
2013,Russell County,51167,Black or African American ,110,49,61,58,41,58
2013,Scott County,51169,Black or African American ,41,30,11,33,35,17
2013,Shenandoah County,51171,Black or African American ,301,138,163,62,75,75
2013,Smyth County,51173,Black or African American ,180,27,153,85,31,83
2013,Southampton County,51175,Black or African American ,2365,1399,966,156,170,154
2013,Spotsylvania County,51177,Black or African American ,6518,3982,2536,272,316,290
2013,Stafford County,51179,Black or African American ,6879,4553,2326,239,302,311
2013,Surry County,51181,Black or African American ,1086,813,273,125,103,86
2013,Sussex County,51183,Black or African American ,2003,1270,733,223,153,173
2013,Tazewell County,51185,Black or African American ,522,210,312,134,92,151
2013,Warren County,51187,Black or African American ,611,306,305,103,106,103
2013,Washington County,51191,Black or African American ,280,91,189,61,71,68
2013,Westmoreland County,51193,Black or African American ,1933,1439,494,228,195,191
2013,Wise County,51195,Black or African American ,236,147,89,131,114,74
2013,Wythe County,51197,Black or African American ,213,116,97,97,62,62
2013,York County,51199,Black or African American ,3249,1809,1440,210,191,197
2013,Alexandria city,51510,Black or African American ,12817,2411,10406,547,287,525
2013,Bedford County,51019,Black or African American ,643,220,423,150,98,168
2013,Bristol city,51520,Black or African American ,379,45,334,105,35,105
2013,Buena Vista city,51530,Black or African American ,176,135,41,71,85,51
2013,Charlottesville city,51540,Black or African American ,3042,880,2162,197,137,224
2013,Chesapeake city,51550,Black or African American ,23362,13905,9457,535,481,551
2013,Colonial Heights city,51570,Black or African American ,851,106,745,98,64,109
2013,Covington city,51580,Black or African American ,418,300,118,84,91,79
2013,Danville city,51590,Black or African American ,8639,3723,4916,371,250,417
2013,Emporia city,51595,Black or African American ,1564,498,1066,184,118,186
2013,Fairfax city,51600,Black or African American ,462,93,369,80,44,87
2013,Falls Church city,51610,Black or African American ,314,91,223,94,92,101
2013,Franklin city,51620,Black or African American ,1927,398,1529,156,104,181
2013,Fredericksburg city,51630,Black or African American ,2177,589,1588,176,155,229
2013,Galax city,51640,Black or African American ,87,67,20,50,43,28
2013,Hampton city,51650,Black or African American ,25539,13045,12494,610,534,613
2013,Harrisonburg city,51660,Black or African American ,1116,233,883,176,125,193
2013,Hopewell city,51670,Black or African American ,3272,905,2367,205,187,251
2013,Lexington city,51678,Black or African American ,215,100,115,120,74,93
2013,Lynchburg city,51680,Black or African American ,8144,3251,4893,333,244,332
2013,Manassas city,51683,Black or African American ,1869,1061,808,216,202,199
2013,Manassas Park city,51685,Black or African American ,793,357,436,121,129,152
2013,Martinsville city,51690,Black or African American ,2496,955,1541,184,148,207
2013,Newport News city,51700,Black or African American ,28245,9846,18399,716,522,707
2013,Norfolk city,51710,Black or African American ,34652,10615,24037,788,536,798
2013,Norton city,51720,Black or African American ,107,17,90,65,27,61
2013,Petersburg city,51730,Black or African American ,9722,4042,5680,399,287,443
2013,Poquoson city,51735,Black or African American ,10,10,0,17,17,19
2013,Portsmouth city,51740,Black or African American ,18713,8333,10380,471,384,390
2013,Radford city,51750,Black or African American ,296,76,220,115,55,99
2013,Richmond city,51760,Black or African American ,39199,14032,25167,856,586,786
2013,Roanoke city,51770,Black or African American ,10779,4687,6092,409,347,424
2013,Salem city,51775,Black or African American ,697,221,476,86,91,108
2013,Staunton city,51790,Black or African American ,1059,489,570,138,102,138
2013,Suffolk city,51800,Black or African American ,12431,7601,4830,400,402,390
2013,Virginia Beach city,51810,Black or African American ,29993,14017,15976,668,585,693
2013,Waynesboro city,51820,Black or African American ,1102,327,775,152,107,157
2013,Williamsburg city,51830,Black or African American ,847,197,650,120,90,108
2013,Winchester city,51840,Black or African American ,923,329,594,143,103,154
2014,Accomack County,51001,Black or African American ,4145,2544,1601,366,252,310
2014,Albemarle County,51003,Black or African American ,3490,1351,2139,265,166,277
2014,Alleghany County,51005,Black or African American ,261,192,69,50,46,35
2014,Amelia County,51007,Black or African American ,1151,847,304,123,155,125
2014,Amherst County,51009,Black or African American ,2405,1584,821,143,146,138
2014,Appomattox County,51011,Black or African American ,1136,872,264,111,113,90
2014,Arlington County,51013,Black or African American ,8333,2030,6303,376,262,377
2014,Augusta County,51015,Black or African American ,542,272,270,101,72,87
2014,Bath County,51017,Black or African American ,77,37,40,68,40,61
2014,Bedford County,51019,Black or African American ,2081,1107,974,262,184,219
2014,Bland County,51021,Black or African American ,12,3,9,46,15,36
2014,Botetourt County,51023,Black or African American ,427,370,57,68,62,40
2014,Brunswick County,51025,Black or African American ,2941,1888,1053,282,175,207
2014,Buchanan County,51027,Black or African American ,25,0,25,36,22,36
2014,Buckingham County,51029,Black or African American ,1826,1326,500,188,154,146
2014,Campbell County,51031,Black or African American ,2630,1781,849,165,194,186
2014,Caroline County,51033,Black or African American ,3004,2373,631,146,171,149
2014,Carroll County,51035,Black or African American ,50,50,0,33,33,22
2014,Charles City County,51036,Black or African American ,1278,1013,265,71,77,62
2014,Charlotte County,51037,Black or African American ,1487,847,640,145,129,151
2014,Chesterfield County,51041,Black or African American ,23871,15720,8151,600,584,599
2014,Clarke County,51043,Black or African American ,257,116,141,85,50,82
2014,Craig County,51045,Black or African American ,0,0,0,17,17,17
2014,Culpeper County,51047,Black or African American ,2173,1417,756,219,169,173
2014,Cumberland County,51049,Black or African American ,1477,1088,389,136,122,147
2014,Dickenson County,51051,Black or African American ,16,15,1,15,15,2
2014,Dinwiddie County,51053,Black or African American ,3201,2202,999,238,217,232
2014,Essex County,51057,Black or African American ,1550,1021,529,128,113,118
2014,Fairfax County,51059,Black or African American ,36859,16236,20623,831,590,821
2014,Fauquier County,51061,Black or African American ,1856,1359,497,215,194,131
2014,Floyd County,51063,Black or African American ,131,97,34,78,71,32
2014,Fluvanna County,51065,Black or African American ,1122,901,221,182,166,139
2014,Franklin County,51067,Black or African American ,1758,1131,627,213,163,214
2014,Frederick County,51069,Black or African American ,1119,753,366,170,169,141
2014,Giles County,51071,Black or African American ,83,83,0,27,27,19
2014,Gloucester County,51073,Black or African American ,1286,944,342,138,133,115
2014,Goochland County,51075,Black or African American ,1385,1018,367,168,131,127
2014,Grayson County,51077,Black or African American ,150,64,86,53,50,54
2014,Greene County,51079,Black or African American ,460,247,213,87,70,107
2014,Greensville County,51081,Black or African American ,1864,1238,626,383,309,148
2014,Halifax County,51083,Black or African American ,5072,3257,1815,223,220,231
2014,Hanover County,51085,Black or African American ,3370,2402,968,220,226,205
2014,Henrico County,51087,Black or African American ,36221,18285,17936,570,664,818
2014,Henry County,51089,Black or African American ,4568,2977,1591,270,205,257
2014,Highland County,51091,Black or African American ,0,0,0,12,12,12
2014,Isle of Wight County,51093,Black or African American ,3304,2135,1169,189,148,173
2014,James City County,51095,Black or African American ,3350,2080,1270,247,210,252
2014,King and Queen County,51097,Black or African American ,812,536,276,91,97,103
2014,King George County,51099,Black or African American ,1370,854,516,209,194,146
2014,King William County,51101,Black or African American ,1022,814,208,143,123,120
2014,Lancaster County,51103,Black or African American ,1317,751,566,133,130,152
2014,Lee County,51105,Black or African American ,103,50,53,130,51,107
2014,Loudoun County,51107,Black or African American ,8571,5135,3436,345,320,314
2014,Louisa County,51109,Black or African American ,2088,1714,374,166,164,120
2014,Lunenburg County,51111,Black or African American ,1367,881,486,187,132,123
2014,Madison County,51113,Black or African American ,421,309,112,105,111,71
2014,Mathews County,51115,Black or African American ,385,246,139,115,78,108
2014,Mecklenburg County,51117,Black or African American ,4330,2611,1719,309,222,257
2014,Middlesex County,51119,Black or African American ,739,532,207,96,87,73
2014,Montgomery County,51121,Black or African American ,1257,425,832,202,110,192
2014,Nelson County,51125,Black or African American ,776,432,344,119,97,122
2014,New Kent County,51127,Black or African American ,781,720,61,106,88,54
2014,Northampton County,51131,Black or African American ,1921,1156,765,139,132,121
2014,Northumberland County,51133,Black or African American ,1330,982,348,162,154,155
2014,Nottoway County,51135,Black or African American ,1910,938,972,217,152,254
2014,Orange County,51137,Black or African American ,1511,810,701,185,144,205
2014,Page County,51139,Black or African American ,156,107,49,78,75,43
2014,Patrick County,51141,Black or African American ,378,270,108,68,47,64
2014,Pittsylvania County,51143,Black or African American ,5257,3818,1439,259,250,204
2014,Powhatan County,51145,Black or African American ,748,584,164,166,156,86
2014,Prince Edward County,51147,Black or African American ,2562,1449,1113,227,200,281
2014,Prince George County,51149,Black or African American ,2850,1682,1168,277,167,262
2014,Prince William County,51153,Black or African American ,28119,16411,11708,626,735,716
2014,Pulaski County,51155,Black or African American ,632,404,228,115,96,102
2014,Rappahannock County,51157,Black or African American ,142,130,12,40,33,21
2014,Richmond County,51159,Black or African American ,561,422,139,296,223,97
2014,Roanoke County,51161,Black or African American ,1952,1016,936,244,202,221
2014,Rockbridge County,51163,Black or African American ,261,145,116,59,59,68
2014,Rockingham County,51165,Black or African American ,328,206,122,97,80,83
2014,Russell County,51167,Black or African American ,95,53,42,57,31,50
2014,Scott County,51169,Black or African American ,61,36,25,39,38,18
2014,Shenandoah County,51171,Black or African American ,342,146,196,72,72,103
2014,Smyth County,51173,Black or African American ,213,39,174,84,33,88
2014,Southampton County,51175,Black or African American ,2386,1418,968,173,169,179
2014,Spotsylvania County,51177,Black or African American ,6424,3736,2688,290,294,346
2014,Stafford County,51179,Black or African American ,6961,4660,2301,312,318,335
2014,Surry County,51181,Black or African American ,1114,805,309,127,113,112
2014,Sussex County,51183,Black or African American ,1539,947,592,411,225,227
2014,Tazewell County,51185,Black or African American ,422,208,214,134,82,141
2014,Warren County,51187,Black or African American ,606,339,267,128,99,110
2014,Washington County,51191,Black or African American ,195,78,117,58,49,53
2014,Westmoreland County,51193,Black or African American ,1834,1324,510,223,194,183
2014,Wise County,51195,Black or African American ,195,91,104,72,67,62
2014,Wythe County,51197,Black or African American ,216,99,117,97,58,68
2014,York County,51199,Black or African American ,3219,1749,1470,251,169,219
2014,Alexandria city,51510,Black or African American ,12913,2460,10453,527,262,551
2014,Bristol city,51520,Black or African American ,342,70,272,72,44,75
2014,Buena Vista city,51530,Black or African American ,105,83,22,131,121,44
2014,Charlottesville city,51540,Black or African American ,3194,834,2360,219,147,276
2014,Chesapeake city,51550,Black or African American ,23508,13282,10226,625,488,565
2014,Colonial Heights city,51570,Black or African American ,804,80,724,78,55,91
2014,Covington city,51580,Black or African American ,344,181,163,89,70,83
2014,Danville city,51590,Black or African American ,8609,3451,5158,291,243,366
2014,Emporia city,51595,Black or African American ,1585,397,1188,166,94,150
2014,Fairfax city,51600,Black or African American ,471,107,364,82,44,89
2014,Falls Church city,51610,Black or African American ,346,86,260,154,112,126
2014,Franklin city,51620,Black or African American ,2082,588,1494,144,130,160
2014,Fredericksburg city,51630,Black or African American ,2081,416,1665,215,128,199
2014,Galax city,51640,Black or African American ,147,102,45,69,61,40
2014,Hampton city,51650,Black or African American ,25741,12626,13115,614,546,639
2014,Harrisonburg city,51660,Black or African American ,1183,150,1033,152,71,160
2014,Hopewell city,51670,Black or African American ,3154,1090,2064,206,164,248
2014,Lexington city,51678,Black or African American ,121,60,61,91,55,65
2014,Lynchburg city,51680,Black or African American ,8215,3155,5060,357,275,371
2014,Manassas city,51683,Black or African American ,1872,1018,854,233,214,183
2014,Manassas Park city,51685,Black or African American ,805,413,392,130,119,124
2014,Martinsville city,51690,Black or African American ,2468,979,1489,170,139,186
2014,Newport News city,51700,Black or African American ,27860,9668,18192,696,500,730
2014,Norfolk city,51710,Black or African American ,35459,10827,24632,738,453,693
2014,Norton city,51720,Black or African American ,116,37,79,72,42,64
2014,Petersburg city,51730,Black or African American ,9617,3914,5703,314,345,326
2014,Poquoson city,51735,Black or African American ,41,41,0,32,32,19
2014,Portsmouth city,51740,Black or African American ,18784,8277,10507,455,417,476
2014,Radford city,51750,Black or African American ,365,79,286,118,62,107
2014,Richmond city,51760,Black or African American ,39399,14045,25354,775,587,798
2014,Roanoke city,51770,Black or African American ,10588,4583,6005,454,279,458
2014,Salem city,51775,Black or African American ,671,250,421,112,95,130
2014,Staunton city,51790,Black or African American ,983,436,547,132,96,139
2014,Suffolk city,51800,Black or African American ,12567,7359,5208,335,369,408
2014,Virginia Beach city,51810,Black or African American ,30262,13770,16492,653,675,733
2014,Waynesboro city,51820,Black or African American ,981,251,730,125,89,133
2014,Williamsburg city,51830,Black or African American ,914,228,686,113,84,121
2014,Winchester city,51840,Black or African American ,912,210,702,127,69,137
2015,Accomack County,51001,Black or African American ,3889,2435,1454,392,305,316
2015,Albemarle County,51003,Black or African American ,3385,1344,2041,278,186,304
2015,Alleghany County,51005,Black or African American ,274,175,99,48,40,39
2015,Amelia County,51007,Black or African American ,1240,968,272,145,157,130
2015,Amherst County,51009,Black or African American ,2357,1570,787,188,163,171
2015,Appomattox County,51011,Black or African American ,1050,805,245,92,103,90
2015,Arlington County,51013,Black or African American ,8624,2036,6588,429,296,484
2015,Augusta County,51015,Black or African American ,561,306,255,111,91,107
2015,Bath County,51017,Black or African American ,48,37,11,39,38,19
2015,Bedford County,51019,Black or African American ,1993,1159,834,204,160,202
2015,Bland County,51021,Black or African American ,9,9,0,13,13,17
2015,Botetourt County,51023,Black or African American ,414,299,115,71,74,71
2015,Brunswick County,51025,Black or African American ,3005,1898,1107,220,207,192
2015,Buchanan County,51027,Black or African American ,101,0,101,109,22,109
2015,Buckingham County,51029,Black or African American ,1614,1258,356,176,156,116
2015,Campbell County,51031,Black or African American ,2774,1788,986,198,166,170
2015,Caroline County,51033,Black or African American ,3129,2374,755,201,165,181
2015,Carroll County,51035,Black or African American ,42,42,0,38,38,22
2015,Charles City County,51036,Black or African American ,1297,1035,262,63,67,65
2015,Charlotte County,51037,Black or African American ,1507,845,662,138,137,134
2015,Chesterfield County,51041,Black or African American ,24358,15643,8715,566,548,505
2015,Clarke County,51043,Black or African American ,370,170,200,40,86,91
2015,Craig County,51045,Black or African American ,0,0,0,17,17,17
2015,Culpeper County,51047,Black or African American ,2175,1363,812,214,196,174
2015,Cumberland County,51049,Black or African American ,1341,929,412,140,148,148
2015,Dickenson County,51051,Black or African American ,16,15,1,15,14,2
2015,Dinwiddie County,51053,Black or African American ,3134,2381,753,248,238,208
2015,Essex County,51057,Black or African American ,1715,1094,621,127,122,117
2015,Fairfax County,51059,Black or African American ,36564,15952,20612,715,573,759
2015,Fauquier County,51061,Black or African American ,1771,1286,485,187,191,127
2015,Floyd County,51063,Black or African American ,178,137,41,73,71,39
2015,Fluvanna County,51065,Black or African American ,1227,952,275,157,158,170
2015,Franklin County,51067,Black or African American ,1774,962,812,186,141,208
2015,Frederick County,51069,Black or African American ,1227,837,390,192,153,162
2015,Giles County,51071,Black or African American ,93,66,27,55,31,38
2015,Gloucester County,51073,Black or African American ,1200,837,363,136,127,119
2015,Goochland County,51075,Black or African American ,1320,984,336,136,143,119
2015,Grayson County,51077,Black or African American ,181,67,114,84,48,76
2015,Greene County,51079,Black or African American ,480,273,207,99,92,106
2015,Greensville County,51081,Black or African American ,1915,1261,654,367,339,167
2015,Halifax County,51083,Black or African American ,5049,3226,1823,250,227,243
2015,Hanover County,51085,Black or African American ,3399,2379,1020,245,182,238
2015,Henrico County,51087,Black or African American ,36253,17832,18421,733,761,902
2015,Henry County,51089,Black or African American ,4695,2990,1705,262,200,227
2015,Highland County,51091,Black or African American ,0,0,0,12,12,12
2015,Isle of Wight County,51093,Black or African American ,3380,2218,1162,168,159,168
2015,James City County,51095,Black or African American ,3329,2053,1276,254,208,234
2015,King and Queen County,51097,Black or African American ,726,496,230,79,91,73
2015,King George County,51099,Black or African American ,1343,774,569,167,157,125
2015,King William County,51101,Black or African American ,1040,827,213,137,114,109
2015,Lancaster County,51103,Black or African American ,1225,760,465,150,119,140
2015,Lee County,51105,Black or African American ,104,65,39,101,61,73
2015,Loudoun County,51107,Black or African American ,8608,5338,3270,390,383,391
2015,Louisa County,51109,Black or African American ,2037,1575,462,173,164,162
2015,Lunenburg County,51111,Black or African American ,1389,850,539,258,173,132
2015,Madison County,51113,Black or African American ,310,198,112,97,80,77
2015,Mathews County,51115,Black or African American ,384,257,127,103,78,94
2015,Mecklenburg County,51117,Black or African American ,4023,2486,1537,229,181,246
2015,Middlesex County,51119,Black or African American ,724,537,187,119,91,85
2015,Montgomery County,51121,Black or African American ,1153,411,742,155,103,144
2015,Nelson County,51125,Black or African American ,752,460,292,113,102,115
2015,New Kent County,51127,Black or African American ,766,682,84,85,79,55
2015,Northampton County,51131,Black or African American ,1959,1131,828,159,131,154
2015,Northumberland County,51133,Black or African American ,1392,1059,333,177,137,165
2015,Nottoway County,51135,Black or African American ,1894,959,935,199,173,213
2015,Orange County,51137,Black or African American ,1640,836,804,182,150,205
2015,Page County,51139,Black or African American ,146,76,70,65,31,55
2015,Patrick County,51141,Black or African American ,359,233,126,66,55,57
2015,Pittsylvania County,51143,Black or African American ,5260,3725,1535,236,261,282
2015,Powhatan County,51145,Black or African American ,751,609,142,124,118,74
2015,Prince Edward County,51147,Black or African American ,2492,1427,1065,245,170,226
2015,Prince George County,51149,Black or African American ,2917,1737,1180,268,193,239
2015,Prince William County,51153,Black or African American ,29141,16835,12306,617,667,726
2015,Pulaski County,51155,Black or African American ,550,368,182,123,75,100
2015,Rappahannock County,51157,Black or African American ,173,130,43,54,40,46
2015,Richmond County,51159,Black or African American ,677,517,160,140,129,79
2015,Roanoke County,51161,Black or African American ,1889,983,906,160,164,196
2015,Rockbridge County,51163,Black or African American ,241,152,89,56,52,58
2015,Rockingham County,51165,Black or African American ,423,295,128,96,111,68
2015,Russell County,51167,Black or African American ,75,24,51,60,16,70
2015,Scott County,51169,Black or African American ,68,35,33,41,37,31
2015,Shenandoah County,51171,Black or African American ,365,173,192,55,75,87
2015,Smyth County,51173,Black or African American ,270,55,215,95,44,105
2015,Southampton County,51175,Black or African American ,2439,1385,1054,189,171,210
2015,Spotsylvania County,51177,Black or African American ,6437,3861,2576,247,228,304
2015,Stafford County,51179,Black or African American ,7033,4690,2343,292,348,354
2015,Surry County,51181,Black or African American ,1102,795,307,95,88,96
2015,Sussex County,51183,Black or African American ,1480,919,561,394,199,237
2015,Tazewell County,51185,Black or African American ,403,264,139,134,75,126
2015,Warren County,51187,Black or African American ,672,368,304,102,89,106
2015,Washington County,51191,Black or African American ,197,82,115,75,52,67
2015,Westmoreland County,51193,Black or African American ,1791,1228,563,220,196,190
2015,Wise County,51195,Black or African American ,198,86,112,114,57,101
2015,Wythe County,51197,Black or African American ,221,84,137,113,55,81
2015,York County,51199,Black or African American ,3218,1755,1463,226,184,213
2015,Alexandria city,51510,Black or African American ,12913,2400,10513,586,298,603
2015,Bristol city,51520,Black or African American ,290,66,224,65,40,70
2015,Buena Vista city,51530,Black or African American ,0,0,0,17,17,17
2015,Charlottesville city,51540,Black or African American ,3144,858,2286,236,139,244
2015,Chesapeake city,51550,Black or African American ,23722,12836,10886,671,505,678
2015,Colonial Heights city,51570,Black or African American ,787,78,709,99,42,102
2015,Covington city,51580,Black or African American ,301,160,141,95,67,86
2015,Danville city,51590,Black or African American ,8572,3467,5105,330,236,296
2015,Emporia city,51595,Black or African American ,1387,364,1023,171,116,164
2015,Fairfax city,51600,Black or African American ,458,115,343,114,46,120
2015,Falls Church city,51610,Black or African American ,176,52,124,80,46,74
2015,Franklin city,51620,Black or African American ,1925,600,1325,169,125,179
2015,Fredericksburg city,51630,Black or African American ,2282,423,1859,228,144,241
2015,Galax city,51640,Black or African American ,150,92,58,70,53,42
2015,Hampton city,51650,Black or African American ,25690,12303,13387,642,442,700
2015,Harrisonburg city,51660,Black or African American ,1225,179,1046,166,84,188
2015,Hopewell city,51670,Black or African American ,3224,1090,2134,200,143,191
2015,Lexington city,51678,Black or African American ,291,202,89,164,103,82
2015,Lynchburg city,51680,Black or African American ,8361,2974,5387,370,219,375
2015,Manassas city,51683,Black or African American ,1945,1189,756,209,206,204
2015,Manassas Park city,51685,Black or African American ,663,471,192,93,105,108
2015,Martinsville city,51690,Black or African American ,2418,928,1490,178,133,179
2015,Newport News city,51700,Black or African American ,28039,9611,18428,645,464,680
2015,Norfolk city,51710,Black or African American ,35656,10599,25057,612,546,605
2015,Norton city,51720,Black or African American ,95,21,74,72,32,68
2015,Petersburg city,51730,Black or African American ,9819,3675,6144,367,296,381
2015,Poquoson city,51735,Black or African American ,52,52,0,27,27,19
2015,Portsmouth city,51740,Black or African American ,18644,8303,10341,433,426,470
2015,Radford city,51750,Black or African American ,395,62,333,175,52,159
2015,Richmond city,51760,Black or African American ,39752,13842,25910,711,603,838
2015,Roanoke city,51770,Black or African American ,10123,4395,5728,460,293,448
2015,Salem city,51775,Black or African American ,686,196,490,99,96,108
2015,Staunton city,51790,Black or African American ,974,453,521,117,87,127
2015,Suffolk city,51800,Black or African American ,12653,7188,5465,416,398,432
2015,Virginia Beach city,51810,Black or African American ,30995,13844,17151,755,750,733
2015,Waynesboro city,51820,Black or African American ,1163,355,808,200,126,212
2015,Williamsburg city,51830,Black or African American ,846,236,610,104,67,115
2015,Winchester city,51840,Black or African American ,933,269,664,153,90,186
2016,Accomack County,51001,Black or African American ,3869,2225,1644,287,296,266
2016,Albemarle County,51003,Black or African American ,3316,1249,2067,201,160,216
2016,Alleghany County,51005,Black or African American ,287,158,129,52,40,54
2016,Amelia County,51007,Black or African American ,1062,896,166,147,140,108
2016,Amherst County,51009,Black or African American ,2342,1460,882,154,155,151
2016,Appomattox County,51011,Black or African American ,1085,811,274,93,122,108
2016,Arlington County,51013,Black or African American ,9117,2072,7045,435,326,422
2016,Augusta County,51015,Black or African American ,569,298,271,118,96,108
2016,Bath County,51017,Black or African American ,43,0,43,50,12,50
2016,Bedford County,51019,Black or African American ,2040,1248,792,225,188,242
2016,Bland County,51021,Black or African American ,3,3,0,19,19,17
2016,Botetourt County,51023,Black or African American ,341,268,73,61,69,46
2016,Brunswick County,51025,Black or African American ,3132,1973,1159,203,185,208
2016,Buchanan County,51027,Black or African American ,131,0,131,108,22,108
2016,Buckingham County,51029,Black or African American ,1667,1241,426,182,157,111
2016,Campbell County,51031,Black or African American ,2955,1912,1043,208,188,193
2016,Caroline County,51033,Black or African American ,3058,2249,809,245,251,184
2016,Carroll County,51035,Black or African American ,26,26,0,40,40,22
2016,Charles City County,51036,Black or African American ,1253,1012,241,58,69,63
2016,Charlotte County,51037,Black or African American ,1414,844,570,129,128,97
2016,Chesterfield County,51041,Black or African American ,25362,15747,9615,517,620,559
2016,Clarke County,51043,Black or African American ,322,111,211,68,63,100
2016,Craig County,51045,Black or African American ,0,0,0,17,17,17
2016,Culpeper County,51047,Black or African American ,2295,1355,940,221,186,185
2016,Cumberland County,51049,Black or African American ,1389,876,513,163,161,163
2016,Dickenson County,51051,Black or African American ,7,6,1,7,6,2
2016,Dinwiddie County,51053,Black or African American ,3203,2396,807,216,221,208
2016,Essex County,51057,Black or African American ,1715,1020,695,142,143,141
2016,Fairfax County,51059,Black or African American ,37365,16114,21251,620,593,646
2016,Fauquier County,51061,Black or African American ,1775,1258,517,183,193,131
2016,Floyd County,51063,Black or African American ,158,133,25,65,65,25
2016,Fluvanna County,51065,Black or African American ,1188,870,318,149,147,175
2016,Franklin County,51067,Black or African American ,1680,972,708,215,133,223
2016,Frederick County,51069,Black or African American ,1135,686,449,163,158,175
2016,Giles County,51071,Black or African American ,134,103,31,40,54,34
2016,Gloucester County,51073,Black or African American ,1302,913,389,150,122,122
2016,Goochland County,51075,Black or African American ,1286,992,294,113,111,119
2016,Grayson County,51077,Black or African American ,101,50,51,55,48,37
2016,Greene County,51079,Black or African American ,498,250,248,126,104,112
2016,Greensville County,51081,Black or African American ,2040,1488,552,138,173,133
2016,Halifax County,51083,Black or African American ,4924,3056,1868,245,237,253
2016,Hanover County,51085,Black or African American ,3371,2376,995,201,192,209
2016,Henrico County,51087,Black or African American ,36303,17809,18494,690,732,803
2016,Henry County,51089,Black or African American ,4802,2889,1913,261,213,259
2016,Highland County,51091,Black or African American ,0,0,0,12,12,12
2016,Isle of Wight County,51093,Black or African American ,3334,2289,1045,188,171,167
2016,James City County,51095,Black or African American ,3148,1925,1223,250,190,233
2016,King and Queen County,51097,Black or African American ,766,556,210,96,88,86
2016,King George County,51099,Black or African American ,1331,746,585,131,122,145
2016,King William County,51101,Black or African American ,964,779,185,104,109,107
2016,Lancaster County,51103,Black or African American ,1214,780,434,135,121,133
2016,Lee County,51105,Black or African American ,79,57,22,28,26,32
2016,Loudoun County,51107,Black or African American ,8778,5507,3271,398,356,410
2016,Louisa County,51109,Black or African American ,2068,1589,479,182,162,166
2016,Lunenburg County,51111,Black or African American ,1479,874,605,134,102,117
2016,Madison County,51113,Black or African American ,310,194,116,101,83,73
2016,Mathews County,51115,Black or African American ,355,273,82,92,62,74
2016,Mecklenburg County,51117,Black or African American ,3963,2365,1598,295,222,231
2016,Middlesex County,51119,Black or African American ,739,556,183,103,93,79
2016,Montgomery County,51121,Black or African American ,1178,391,787,150,99,150
2016,Nelson County,51125,Black or African American ,800,515,285,142,109,98
2016,New Kent County,51127,Black or African American ,905,773,132,111,104,84
2016,Northampton County,51131,Black or African American ,1761,882,879,142,142,142
2016,Northumberland County,51133,Black or African American ,1368,1063,305,155,148,192
2016,Nottoway County,51135,Black or African American ,1948,1118,830,195,195,206
2016,Orange County,51137,Black or African American ,1652,925,727,210,159,200
2016,Page County,51139,Black or African American ,157,100,57,44,38,47
2016,Patrick County,51141,Black or African American ,328,225,103,68,49,53
2016,Pittsylvania County,51143,Black or African American ,5368,3816,1552,226,274,240
2016,Powhatan County,51145,Black or African American ,803,719,84,111,102,66
2016,Prince Edward County,51147,Black or African American ,2398,1320,1078,242,177,211
2016,Prince George County,51149,Black or African American ,3162,1884,1278,244,207,254
2016,Prince William County,51153,Black or African American ,29888,17524,12364,660,754,759
2016,Pulaski County,51155,Black or African American ,588,418,170,129,83,97
2016,Rappahannock County,51157,Black or African American ,175,89,86,58,29,61
2016,Richmond County,51159,Black or African American ,719,526,193,141,119,98
2016,Roanoke County,51161,Black or African American ,2036,1036,1000,183,139,200
2016,Rockbridge County,51163,Black or African American ,233,177,56,68,71,48
2016,Rockingham County,51165,Black or African American ,415,235,180,108,73,93
2016,Russell County,51167,Black or African American ,55,18,37,41,12,46
2016,Scott County,51169,Black or African American ,45,0,45,37,22,37
2016,Shenandoah County,51171,Black or African American ,389,239,150,106,89,89
2016,Smyth County,51173,Black or African American ,228,53,175,104,42,100
2016,Southampton County,51175,Black or African American ,2455,1275,1180,167,160,159
2016,Spotsylvania County,51177,Black or African American ,6602,4066,2536,229,257,265
2016,Stafford County,51179,Black or African American ,7284,4752,2532,344,331,306
2016,Surry County,51181,Black or African American ,1205,922,283,87,91,98
2016,Sussex County,51183,Black or African American ,2100,1281,819,456,194,339
2016,Tazewell County,51185,Black or African American ,404,190,214,150,67,144
2016,Warren County,51187,Black or African American ,625,358,267,109,79,90
2016,Washington County,51191,Black or African American ,184,88,96,63,54,45
2016,Westmoreland County,51193,Black or African American ,1783,1248,535,185,189,182
2016,Wise County,51195,Black or African American ,266,71,195,136,40,138
2016,Wythe County,51197,Black or African American ,327,172,155,83,56,66
2016,York County,51199,Black or African American ,3202,1763,1439,206,164,212
2016,Alexandria city,51510,Black or African American ,13910,2533,11377,573,281,534
2016,Bristol city,51520,Black or African American ,324,89,235,86,53,84
2016,Buena Vista city,51530,Black or African American ,50,25,25,76,50,44
2016,Charlottesville city,51540,Black or African American ,3105,696,2409,244,134,296
2016,Chesapeake city,51550,Black or African American ,24256,13048,11208,504,559,669
2016,Colonial Heights city,51570,Black or African American ,817,77,740,92,45,104
2016,Covington city,51580,Black or African American ,336,208,128,96,87,80
2016,Danville city,51590,Black or African American ,8713,3536,5177,297,263,374
2016,Emporia city,51595,Black or African American ,1335,346,989,145,94,172
2016,Fairfax city,51600,Black or African American ,448,167,281,96,62,112
2016,Falls Church city,51610,Black or African American ,484,82,402,132,108,122
2016,Franklin city,51620,Black or African American ,1906,604,1302,164,140,170
2016,Fredericksburg city,51630,Black or African American ,2358,496,1862,226,155,226
2016,Galax city,51640,Black or African American ,167,105,62,74,54,51
2016,Hampton city,51650,Black or African American ,26355,12249,14106,620,535,625
2016,Harrisonburg city,51660,Black or African American ,1187,178,1009,185,90,202
2016,Hopewell city,51670,Black or African American ,3391,1196,2195,233,188,241
2016,Lexington city,51678,Black or African American ,287,199,88,91,56,75
2016,Lynchburg city,51680,Black or African American ,8260,3011,5249,370,258,433
2016,Manassas city,51683,Black or African American ,1933,1122,811,172,181,207
2016,Manassas Park city,51685,Black or African American ,689,459,230,135,107,131
2016,Martinsville city,51690,Black or African American ,2408,927,1481,200,150,238
2016,Newport News city,51700,Black or African American ,28089,9280,18809,713,470,656
2016,Norfolk city,51710,Black or African American ,35792,9989,25803,724,457,778
2016,Norton city,51720,Black or African American ,141,21,120,100,30,92
2016,Petersburg city,51730,Black or African American ,10009,3791,6218,308,281,397
2016,Poquoson city,51735,Black or African American ,54,54,0,27,27,19
2016,Portsmouth city,51740,Black or African American ,18670,8112,10558,423,436,459
2016,Radford city,51750,Black or African American ,428,99,329,144,54,134
2016,Richmond city,51760,Black or African American ,40639,13825,26814,762,684,921
2016,Roanoke city,51770,Black or African American ,10607,4383,6224,374,393,416
2016,Salem city,51775,Black or African American ,794,164,630,138,84,129
2016,Staunton city,51790,Black or African American ,943,490,453,125,86,116
2016,Suffolk city,51800,Black or African American ,13357,7376,5981,355,369,424
2016,Virginia Beach city,51810,Black or African American ,30853,13802,17051,740,615,707
2016,Waynesboro city,51820,Black or African American ,1165,381,784,196,130,209
2016,Williamsburg city,51830,Black or African American ,761,216,545,118,69,119
2016,Winchester city,51840,Black or African American ,802,305,497,123,83,139
2017,Accomack County,51001,Black or African American ,3583,2008,1575,322,294,285
2017,Albemarle County,51003,Black or African American ,3504,1294,2210,245,193,273
2017,Alleghany County,51005,Black or African American ,321,125,196,64,44,71
2017,Amelia County,51007,Black or African American ,1161,974,187,138,142,118
2017,Amherst County,51009,Black or African American ,2286,1336,950,140,169,159
2017,Appomattox County,51011,Black or African American ,1042,806,236,115,101,69
2017,Arlington County,51013,Black or African American ,9234,2050,7184,443,342,421
2017,Augusta County,51015,Black or African American ,561,335,226,117,102,98
2017,Bath County,51017,Black or African American ,43,0,43,54,12,54
2017,Bedford County,51019,Black or African American ,2035,1263,772,209,165,195
2017,Bland County,51021,Black or African American ,3,3,0,20,20,17
2017,Botetourt County,51023,Black or African American ,366,286,80,57,63,42
2017,Brunswick County,51025,Black or African American ,3004,1935,1069,168,152,159
2017,Buchanan County,51027,Black or African American ,106,0,106,99,22,99
2017,Buckingham County,51029,Black or African American ,1688,1253,435,179,172,128
2017,Campbell County,51031,Black or African American ,3125,1977,1148,186,166,207
2017,Caroline County,51033,Black or African American ,3030,2287,743,233,221,172
2017,Carroll County,51035,Black or African American ,0,0,0,22,22,22
2017,Charles City County,51036,Black or African American ,1248,1051,197,66,80,44
2017,Charlotte County,51037,Black or African American ,1377,840,537,153,126,115
2017,Chesterfield County,51041,Black or African American ,26038,15886,10152,638,657,689
2017,Clarke County,51043,Black or African American ,345,144,201,78,82,65
2017,Craig County,51045,Black or African American ,0,0,0,17,17,17
2017,Culpeper County,51047,Black or African American ,2292,1346,946,216,208,187
2017,Cumberland County,51049,Black or African American ,1340,826,514,173,158,159
2017,Dickenson County,51051,Black or African American ,4,3,1,6,5,2
2017,Dinwiddie County,51053,Black or African American ,2994,2326,668,241,232,171
2017,Essex County,51057,Black or African American ,1647,933,714,152,140,136
2017,Fairfax County,51059,Black or African American ,37854,16714,21140,704,726,751
2017,Fauquier County,51061,Black or African American ,1685,1158,527,143,131,120
2017,Floyd County,51063,Black or African American ,217,176,41,88,107,38
2017,Fluvanna County,51065,Black or African American ,1134,890,244,174,187,143
2017,Franklin County,51067,Black or African American ,1596,956,640,198,153,156
2017,Frederick County,51069,Black or African American ,1166,744,422,175,177,166
2017,Giles County,51071,Black or African American ,139,93,46,52,47,57
2017,Gloucester County,51073,Black or African American ,1346,1003,343,133,139,108
2017,Goochland County,51075,Black or African American ,1174,906,268,142,138,121
2017,Grayson County,51077,Black or African American ,127,63,64,65,45,56
2017,Greene County,51079,Black or African American ,501,335,166,146,123,97
2017,Greensville County,51081,Black or African American ,1948,1440,508,190,185,147
2017,Halifax County,51083,Black or African American ,4792,2963,1829,283,253,294
2017,Hanover County,51085,Black or African American ,3564,2344,1220,205,161,220
2017,Henrico County,51087,Black or African American ,36437,18371,18066,643,697,724
2017,Henry County,51089,Black or African American ,4937,2857,2080,225,225,291
2017,Highland County,51091,Black or African American ,0,0,0,12,12,12
2017,Isle of Wight County,51093,Black or African American ,3382,2248,1134,168,181,150
2017,James City County,51095,Black or African American ,3312,1798,1514,279,196,276
2017,King and Queen County,51097,Black or African American ,813,557,256,95,113,97
2017,King George County,51099,Black or African American ,1465,896,569,152,143,134
2017,King William County,51101,Black or African American ,939,734,205,137,125,110
2017,Lancaster County,51103,Black or African American ,1310,776,534,123,139,147
2017,Lee County,51105,Black or African American ,84,47,37,49,32,42
2017,Loudoun County,51107,Black or African American ,9149,5735,3414,416,426,359
2017,Louisa County,51109,Black or African American ,2121,1724,397,185,182,137
2017,Lunenburg County,51111,Black or African American ,1374,841,533,162,122,139
2017,Madison County,51113,Black or African American ,304,162,142,94,94,98
2017,Mathews County,51115,Black or African American ,396,288,108,128,81,113
2017,Mecklenburg County,51117,Black or African American ,3725,2146,1579,213,213,230
2017,Middlesex County,51119,Black or African American ,775,562,213,130,109,107
2017,Montgomery County,51121,Black or African American ,1265,388,877,169,128,155
2017,Nelson County,51125,Black or African American ,880,557,323,123,119,106
2017,New Kent County,51127,Black or African American ,785,634,151,118,140,96
2017,Northampton County,51131,Black or African American ,1823,835,988,182,126,195
2017,Northumberland County,51133,Black or African American ,1373,1059,314,209,209,185
2017,Nottoway County,51135,Black or African American ,2079,1005,1074,201,197,233
2017,Orange County,51137,Black or African American ,1629,1027,602,218,188,224
2017,Page County,51139,Black or African American ,135,86,49,55,37,45
2017,Patrick County,51141,Black or African American ,319,234,85,64,61,53
2017,Pittsylvania County,51143,Black or African American ,5609,3818,1791,233,259,280
2017,Powhatan County,51145,Black or African American ,651,606,45,98,107,36
2017,Prince Edward County,51147,Black or African American ,2357,1461,896,258,194,187
2017,Prince George County,51149,Black or African American ,3262,1962,1300,255,225,246
2017,Prince William County,51153,Black or African American ,30605,18625,11980,646,738,648
2017,Pulaski County,51155,Black or African American ,576,381,195,84,81,85
2017,Rappahannock County,51157,Black or African American ,152,64,88,53,35,53
2017,Richmond County,51159,Black or African American ,805,499,306,154,110,132
2017,Roanoke County,51161,Black or African American ,2172,1104,1068,201,149,204
2017,Rockbridge County,51163,Black or African American ,236,175,61,63,69,36
2017,Rockingham County,51165,Black or African American ,510,292,218,92,89,86
2017,Russell County,51167,Black or African American ,29,9,20,37,13,37
2017,Scott County,51169,Black or African American ,62,0,62,33,22,33
2017,Shenandoah County,51171,Black or African American ,308,178,130,90,75,76
2017,Smyth County,51173,Black or African American ,233,65,168,83,40,81
2017,Southampton County,51175,Black or African American ,2276,1220,1056,162,171,178
2017,Spotsylvania County,51177,Black or African American ,6644,4279,2365,272,277,304
2017,Stafford County,51179,Black or African American ,7698,4960,2738,341,364,380
2017,Surry County,51181,Black or African American ,1252,862,390,110,98,117
2017,Sussex County,51183,Black or African American ,1640,1167,473,397,178,275
2017,Tazewell County,51185,Black or African American ,346,192,154,113,66,97
2017,Warren County,51187,Black or African American ,598,332,266,106,88,104
2017,Washington County,51191,Black or African American ,211,93,118,86,55,62
2017,Westmoreland County,51193,Black or African American ,1761,1260,501,177,185,178
2017,Wise County,51195,Black or African American ,153,90,63,67,43,54
2017,Wythe County,51197,Black or African American ,323,158,165,83,59,73
2017,York County,51199,Black or African American ,3285,1857,1428,182,158,206
2017,Alexandria city,51510,Black or African American ,14008,2693,11315,610,376,555
2017,Bristol city,51520,Black or African American ,370,97,273,100,53,101
2017,Buena Vista city,51530,Black or African American ,72,36,36,63,43,49
2017,Charlottesville city,51540,Black or African American ,3199,754,2445,232,141,232
2017,Chesapeake city,51550,Black or African American ,24412,13376,11036,573,601,766
2017,Colonial Heights city,51570,Black or African American ,721,96,625,110,49,114
2017,Covington city,51580,Black or African American ,205,132,73,67,65,67
2017,Danville city,51590,Black or African American ,8760,3429,5331,313,269,318
2017,Emporia city,51595,Black or African American ,1350,419,931,170,99,180
2017,Fairfax city,51600,Black or African American ,486,149,337,94,72,117
2017,Falls Church city,51610,Black or African American ,304,45,259,89,35,95
2017,Franklin city,51620,Black or African American ,1922,655,1267,136,131,162
2017,Fredericksburg city,51630,Black or African American ,2475,494,1981,244,143,256
2017,Galax city,51640,Black or African American ,157,80,77,83,65,57
2017,Hampton city,51650,Black or African American ,26206,12325,13881,582,474,729
2017,Harrisonburg city,51660,Black or African American ,1279,167,1112,214,79,217
2017,Hopewell city,51670,Black or African American ,3599,1305,2294,228,218,308
2017,Lexington city,51678,Black or African American ,332,221,111,123,68,94
2017,Lynchburg city,51680,Black or African American ,8299,2750,5549,374,258,479
2017,Manassas city,51683,Black or African American ,1951,1097,854,143,174,184
2017,Manassas Park city,51685,Black or African American ,744,503,241,124,116,109
2017,Martinsville city,51690,Black or African American ,2484,1000,1484,184,161,210
2017,Newport News city,51700,Black or African American ,27886,9457,18429,534,524,770
2017,Norfolk city,51710,Black or African American ,35507,10258,25249,619,532,691
2017,Norton city,51720,Black or African American ,109,32,77,91,40,80
2017,Petersburg city,51730,Black or African American ,10052,3909,6143,336,254,394
2017,Poquoson city,51735,Black or African American ,59,59,0,26,26,19
2017,Portsmouth city,51740,Black or African American ,18450,8320,10130,383,391,402
2017,Radford city,51750,Black or African American ,338,77,261,102,38,105
2017,Richmond city,51760,Black or African American ,40199,13501,26698,751,611,899
2017,Roanoke city,51770,Black or African American ,10588,4345,6243,500,357,539
2017,Salem city,51775,Black or African American ,683,123,560,158,53,170
2017,Staunton city,51790,Black or African American ,971,470,501,120,87,115
2017,Suffolk city,51800,Black or African American ,13656,7622,6034,366,420,419
2017,Virginia Beach city,51810,Black or African American ,31274,14049,17225,681,708,847
2017,Waynesboro city,51820,Black or African American ,1194,422,772,230,132,206
2017,Williamsburg city,51830,Black or African American ,796,274,522,103,98,105
2017,Winchester city,51840,Black or African American ,885,328,557,140,96,157
2018,Accomack County,51001,Black or African American ,3479,1783,1696,293,235,261
2018,Albemarle County,51003,Black or African American ,3670,1363,2307,272,189,299
2018,Alleghany County,51005,Black or African American ,307,149,158,50,51,64
2018,Amelia County,51007,Black or African American ,1120,960,160,136,120,95
2018,Amherst County,51009,Black or African American ,2162,1403,759,191,197,138
2018,Appomattox County,51011,Black or African American ,1008,702,306,112,100,95
2018,Arlington County,51013,Black or African American ,9530,1955,7575,468,277,464
2018,Augusta County,51015,Black or African American ,495,278,217,127,101,90
2018,Bath County,51017,Black or African American ,46,0,46,54,12,54
2018,Bedford County,51019,Black or African American ,1968,1427,541,162,151,188
2018,Bland County,51021,Black or African American ,0,0,0,17,17,17
2018,Botetourt County,51023,Black or African American ,383,294,89,68,61,62
2018,Brunswick County,51025,Black or African American ,2978,1863,1115,182,176,178
2018,Buchanan County,51027,Black or African American ,103,0,103,76,22,76
2018,Buckingham County,51029,Black or African American ,1798,1300,498,150,153,140
2018,Campbell County,51031,Black or African American ,3200,2153,1047,221,202,232
2018,Caroline County,51033,Black or African American ,3043,2373,670,214,219,196
2018,Carroll County,51035,Black or African American ,0,0,0,22,22,22
2018,Charles City County,51036,Black or African American ,1285,1065,220,68,87,62
2018,Charlotte County,51037,Black or African American ,1397,835,562,131,119,139
2018,Chesterfield County,51041,Black or African American ,26723,16143,10580,620,605,707
2018,Clarke County,51043,Black or African American ,355,155,200,80,97,85
2018,Craig County,51045,Black or African American ,0,0,0,17,17,17
2018,Culpeper County,51047,Black or African American ,2324,1400,924,254,233,185
2018,Cumberland County,51049,Black or African American ,1334,848,486,160,138,176
2018,Dickenson County,51051,Black or African American ,4,3,1,9,8,3
2018,Dinwiddie County,51053,Black or African American ,3152,2267,885,223,216,222
2018,Essex County,51057,Black or African American ,1642,853,789,178,145,158
2018,Fairfax County,51059,Black or African American ,38450,17339,21111,774,539,704
2018,Fauquier County,51061,Black or African American ,1708,1292,416,166,167,105
2018,Floyd County,51063,Black or African American ,134,114,20,76,75,34
2018,Fluvanna County,51065,Black or African American ,1088,888,200,166,218,142
2018,Franklin County,51067,Black or African American ,1591,999,592,154,130,174
2018,Frederick County,51069,Black or African American ,1199,744,455,146,169,171
2018,Giles County,51071,Black or African American ,88,65,23,34,29,31
2018,Gloucester County,51073,Black or African American ,1332,981,351,121,142,113
2018,Goochland County,51075,Black or African American ,1161,940,221,122,149,81
2018,Grayson County,51077,Black or African American ,151,76,75,98,89,52
2018,Greene County,51079,Black or African American ,466,363,103,129,127,59
2018,Greensville County,51081,Black or African American ,1963,1364,599,194,183,144
2018,Halifax County,51083,Black or African American ,4798,3139,1659,283,239,270
2018,Hanover County,51085,Black or African American ,3524,2427,1097,215,198,210
2018,Henrico County,51087,Black or African American ,36934,18509,18425,701,803,866
2018,Henry County,51089,Black or African American ,4950,2824,2126,306,220,328
2018,Highland County,51091,Black or African American ,0,0,0,12,12,12
2018,Isle of Wight County,51093,Black or African American ,3376,2106,1270,167,193,221
2018,James City County,51095,Black or African American ,3329,1756,1573,281,202,279
2018,King and Queen County,51097,Black or African American ,703,530,173,106,100,71
2018,King George County,51099,Black or African American ,1433,847,586,135,147,143
2018,King William County,51101,Black or African American ,919,704,215,142,142,102
2018,Lancaster County,51103,Black or African American ,1475,893,582,148,181,170
2018,Lee County,51105,Black or African American ,64,27,37,26,23,26
2018,Loudoun County,51107,Black or African American ,9208,5805,3403,391,367,346
2018,Louisa County,51109,Black or African American ,2078,1607,471,201,173,155
2018,Lunenburg County,51111,Black or African American ,1332,857,475,168,122,121
2018,Madison County,51113,Black or African American ,446,309,137,141,139,106
2018,Mathews County,51115,Black or African American ,377,250,127,76,78,70
2018,Mecklenburg County,51117,Black or African American ,3763,2105,1658,283,212,237
2018,Middlesex County,51119,Black or African American ,754,559,195,108,101,98
2018,Montgomery County,51121,Black or African American ,1342,392,950,181,128,165
2018,Nelson County,51125,Black or African American ,909,645,264,137,127,103
2018,New Kent County,51127,Black or African American ,805,669,136,114,141,78
2018,Northampton County,51131,Black or African American ,1742,871,871,155,106,156
2018,Northumberland County,51133,Black or African American ,1299,952,347,177,151,185
2018,Nottoway County,51135,Black or African American ,2062,1048,1014,237,208,268
2018,Orange County,51137,Black or African American ,1550,978,572,197,182,187
2018,Page County,51139,Black or African American ,149,64,85,53,43,48
2018,Patrick County,51141,Black or African American ,320,235,85,50,60,39
2018,Pittsylvania County,51143,Black or African American ,5322,3723,1599,266,219,246
2018,Powhatan County,51145,Black or African American ,661,606,55,110,116,53
2018,Prince Edward County,51147,Black or African American ,2333,1503,830,256,183,192
2018,Prince George County,51149,Black or African American ,3543,2087,1456,256,202,243
2018,Prince William County,51153,Black or African American ,30828,18990,11838,695,773,777
2018,Pulaski County,51155,Black or African American ,546,368,178,86,68,74
2018,Rappahannock County,51157,Black or African American ,159,75,84,61,38,56
2018,Richmond County,51159,Black or African American ,796,466,330,148,133,149
2018,Roanoke County,51161,Black or African American ,2179,1165,1014,244,185,248
2018,Rockbridge County,51163,Black or African American ,241,184,57,82,89,38
2018,Rockingham County,51165,Black or African American ,523,292,231,93,103,105
2018,Russell County,51167,Black or African American ,80,32,48,60,34,67
2018,Scott County,51169,Black or African American ,46,0,46,30,22,30
2018,Shenandoah County,51171,Black or African American ,346,203,143,84,79,77
2018,Smyth County,51173,Black or African American ,206,75,131,87,50,68
2018,Southampton County,51175,Black or African American ,2224,1288,936,194,204,198
2018,Spotsylvania County,51177,Black or African American ,6919,4526,2393,305,297,289
2018,Stafford County,51179,Black or African American ,8103,5284,2819,322,408,367
2018,Surry County,51181,Black or African American ,1240,845,395,123,110,130
2018,Sussex County,51183,Black or African American ,2016,1263,753,318,180,188
2018,Tazewell County,51185,Black or African American ,379,178,201,122,86,118
2018,Warren County,51187,Black or African American ,578,353,225,102,88,94
2018,Washington County,51191,Black or African American ,188,105,83,95,62,64
2018,Westmoreland County,51193,Black or African American ,1851,1215,636,180,178,168
2018,Wise County,51195,Black or African American ,159,61,98,62,42,72
2018,Wythe County,51197,Black or African American ,361,138,223,106,88,101
2018,York County,51199,Black or African American ,3406,1845,1561,231,192,228
2018,Alexandria city,51510,Black or African American ,14307,2619,11688,589,363,538
2018,Bristol city,51520,Black or African American ,331,101,230,107,58,116
2018,Buena Vista city,51530,Black or African American ,149,64,85,97,57,79
2018,Charlottesville city,51540,Black or African American ,3124,745,2379,208,171,233
2018,Chesapeake city,51550,Black or African American ,24523,13697,10826,678,625,700
2018,Colonial Heights city,51570,Black or African American ,740,146,594,107,71,108
2018,Covington city,51580,Black or African American ,213,161,52,69,66,44
2018,Danville city,51590,Black or African American ,8869,3431,5438,342,262,379
2018,Emporia city,51595,Black or African American ,1456,483,973,159,116,181
2018,Fairfax city,51600,Black or African American ,424,135,289,138,64,142
2018,Falls Church city,51610,Black or African American ,254,40,214,70,43,66
2018,Franklin city,51620,Black or African American ,2066,658,1408,143,148,160
2018,Fredericksburg city,51630,Black or African American ,2445,510,1935,238,130,247
2018,Galax city,51640,Black or African American ,232,178,54,104,104,47
2018,Hampton city,51650,Black or African American ,26867,12580,14287,657,610,828
2018,Harrisonburg city,51660,Black or African American ,1456,187,1269,205,87,205
2018,Hopewell city,51670,Black or African American ,3674,1401,2273,237,214,268
2018,Lexington city,51678,Black or African American ,184,50,134,118,48,106
2018,Lynchburg city,51680,Black or African American ,8246,2651,5595,372,268,429
2018,Manassas city,51683,Black or African American ,2013,1142,871,175,154,198
2018,Manassas Park city,51685,Black or African American ,736,484,252,163,144,117
2018,Martinsville city,51690,Black or African American ,2548,1057,1491,181,198,245
2018,Newport News city,51700,Black or African American ,28907,9528,19379,700,543,713
2018,Norfolk city,51710,Black or African American ,35407,10029,25378,704,426,714
2018,Norton city,51720,Black or African American ,123,38,85,106,53,88
2018,Petersburg city,51730,Black or African American ,10336,3892,6444,345,243,388
2018,Poquoson city,51735,Black or African American ,67,67,0,30,30,19
2018,Portsmouth city,51740,Black or African American ,18546,8191,10355,426,403,436
2018,Radford city,51750,Black or African American ,299,77,222,97,34,104
2018,Richmond city,51760,Black or African American ,39865,13176,26689,718,573,785
2018,Roanoke city,51770,Black or African American ,11029,4178,6851,411,312,413
2018,Salem city,51775,Black or African American ,699,147,552,152,70,144
2018,Staunton city,51790,Black or African American ,939,450,489,127,87,139
2018,Suffolk city,51800,Black or African American ,13815,7620,6195,405,444,438
2018,Virginia Beach city,51810,Black or African American ,31763,14267,17496,628,668,784
2018,Waynesboro city,51820,Black or African American ,1292,346,946,214,149,233
2018,Williamsburg city,51830,Black or African American ,596,271,325,143,98,108
2018,Winchester city,51840,Black or African American ,844,298,546,166,94,152
2019,Accomack County,51001,Black or African American ,3443,1616,1827,268,249,306
2019,Albemarle County,51003,Black or African American ,3642,1524,2118,265,219,313
2019,Alleghany County,51005,Black or African American ,363,190,173,69,77,96
2019,Amelia County,51007,Black or African American ,1201,1079,122,158,140,95
2019,Amherst County,51009,Black or African American ,2200,1465,735,215,154,189
2019,Appomattox County,51011,Black or African American ,955,591,364,102,96,107
2019,Arlington County,51013,Black or African American ,9877,1838,8039,404,238,397
2019,Augusta County,51015,Black or African American ,424,256,168,122,126,76
2019,Bath County,51017,Black or African American ,56,0,56,59,12,59
2019,Bedford County,51019,Black or African American ,1934,1424,510,139,179,168
2019,Bland County,51021,Black or African American ,0,0,0,17,17,17
2019,Botetourt County,51023,Black or African American ,441,330,111,72,77,67
2019,Brunswick County,51025,Black or African American ,2947,1843,1104,191,167,179
2019,Buchanan County,51027,Black or African American ,141,0,141,113,23,113
2019,Buckingham County,51029,Black or African American ,1780,1302,478,139,158,129
2019,Campbell County,51031,Black or African American ,3208,2236,972,234,204,218
2019,Caroline County,51033,Black or African American ,3019,2430,589,205,246,162
2019,Carroll County,51035,Black or African American ,0,0,0,23,23,23
2019,Charles City County,51036,Black or African American ,1284,1086,198,65,75,60
2019,Charlotte County,51037,Black or African American ,1336,885,451,122,115,114
2019,Chesterfield County,51041,Black or African American ,27237,16592,10645,542,605,570
2019,Clarke County,51043,Black or African American ,352,184,168,88,114,82
2019,Craig County,51045,Black or African American ,0,0,0,17,17,17
2019,Culpeper County,51047,Black or African American ,2420,1432,988,222,180,211
2019,Cumberland County,51049,Black or African American ,1257,789,468,162,120,176
2019,Dickenson County,51051,Black or African American ,1,1,0,2,2,19
2019,Dinwiddie County,51053,Black or African American ,3333,2335,998,277,234,244
2019,Essex County,51057,Black or African American ,1727,926,801,150,160,168
2019,Fairfax County,51059,Black or African American ,38772,17822,20950,869,755,850
2019,Fauquier County,51061,Black or African American ,1689,1147,542,152,150,144
2019,Floyd County,51063,Black or African American ,66,66,0,57,57,19
2019,Fluvanna County,51065,Black or African American ,1134,916,218,152,171,98
2019,Franklin County,51067,Black or African American ,1479,1047,432,199,158,156
2019,Frederick County,51069,Black or African American ,1076,741,335,139,167,120
2019,Giles County,51071,Black or African American ,103,59,44,34,46,49
2019,Gloucester County,51073,Black or African American ,1424,1072,352,137,145,109
2019,Goochland County,51075,Black or African American ,1143,897,246,148,117,103
2019,Grayson County,51077,Black or African American ,190,86,104,217,118,155
2019,Greene County,51079,Black or African American ,491,375,116,138,137,84
2019,Greensville County,51081,Black or African American ,1844,1336,508,170,182,133
2019,Halifax County,51083,Black or African American ,4813,3077,1736,265,292,262
2019,Hanover County,51085,Black or African American ,3490,2411,1079,221,176,220
2019,Henrico County,51087,Black or African American ,37170,18725,18445,739,685,930
2019,Henry County,51089,Black or African American ,4992,2905,2087,310,249,280
2019,Highland County,51091,Black or African American ,0,0,0,12,12,12
2019,Isle of Wight County,51093,Black or African American ,3488,2125,1363,173,204,227
2019,James City County,51095,Black or African American ,3359,1782,1577,294,252,240
2019,King and Queen County,51097,Black or African American ,638,512,126,120,103,78
2019,King George County,51099,Black or African American ,1476,896,580,146,164,134
2019,King William County,51101,Black or African American ,983,767,216,141,131,102
2019,Lancaster County,51103,Black or African American ,1427,902,525,154,179,168
2019,Lee County,51105,Black or African American ,59,26,33,31,24,32
2019,Loudoun County,51107,Black or African American ,9655,6112,3543,355,399,335
2019,Louisa County,51109,Black or African American ,2225,1688,537,179,200,137
2019,Lunenburg County,51111,Black or African American ,1419,867,552,156,122,143
2019,Madison County,51113,Black or African American ,489,395,94,114,114,70
2019,Mathews County,51115,Black or African American ,404,223,181,108,96,95
2019,Mecklenburg County,51117,Black or African American ,3793,2081,1712,255,206,231
2019,Middlesex County,51119,Black or African American ,699,555,144,120,117,91
2019,Montgomery County,51121,Black or African American ,1313,449,864,161,135,162
2019,Nelson County,51125,Black or African American ,873,721,152,103,131,120
2019,New Kent County,51127,Black or African American ,880,711,169,149,144,76
2019,Northampton County,51131,Black or African American ,1721,800,921,160,145,196
2019,Northumberland County,51133,Black or African American ,1279,1058,221,160,151,149
2019,Nottoway County,51135,Black or African American ,1975,1022,953,195,186,223
2019,Orange County,51137,Black or African American ,1552,1058,494,196,145,193
2019,Page County,51139,Black or African American ,109,61,48,58,38,48
2019,Patrick County,51141,Black or African American ,361,251,110,62,59,55
2019,Pittsylvania County,51143,Black or African American ,5211,3561,1650,261,218,242
2019,Powhatan County,51145,Black or African American ,596,449,147,104,127,86
2019,Prince Edward County,51147,Black or African American ,2463,1304,1159,284,158,266
2019,Prince George County,51149,Black or African American ,3458,2033,1425,252,249,235
2019,Prince William County,51153,Black or African American ,31102,19336,11766,760,593,697
2019,Pulaski County,51155,Black or African American ,534,342,192,85,63,82
2019,Rappahannock County,51157,Black or African American ,174,55,119,51,44,62
2019,Richmond County,51159,Black or African American ,752,417,335,119,137,127
2019,Roanoke County,51161,Black or African American ,2214,1015,1199,247,177,279
2019,Rockbridge County,51163,Black or African American ,189,164,25,51,58,22
2019,Rockingham County,51165,Black or African American ,568,303,265,124,90,109
2019,Russell County,51167,Black or African American ,34,34,0,50,50,23
2019,Scott County,51169,Black or African American ,26,0,26,21,23,21
2019,Shenandoah County,51171,Black or African American ,351,205,146,109,87,72
2019,Smyth County,51173,Black or African American ,183,68,115,80,61,65
2019,Southampton County,51175,Black or African American ,2166,1385,781,201,230,171
2019,Spotsylvania County,51177,Black or African American ,7367,4831,2536,276,301,288
2019,Stafford County,51179,Black or African American ,8461,5715,2746,379,407,388
2019,Surry County,51181,Black or African American ,1218,814,404,115,88,106
2019,Sussex County,51183,Black or African American ,2045,1269,776,184,143,146
2019,Tazewell County,51185,Black or African American ,343,150,193,137,71,136
2019,Warren County,51187,Black or African American ,662,339,323,125,88,114
2019,Washington County,51191,Black or African American ,204,70,134,106,50,89
2019,Westmoreland County,51193,Black or African American ,1970,1306,664,177,152,170
2019,Wise County,51195,Black or African American ,288,120,168,171,77,171
2019,Wythe County,51197,Black or African American ,366,161,205,80,94,102
2019,York County,51199,Black or African American ,3347,1938,1409,239,208,239
2019,Alexandria city,51510,Black or African American ,14306,2698,11608,531,333,536
2019,Bristol city,51520,Black or African American ,244,94,150,116,68,111
2019,Buena Vista city,51530,Black or African American ,204,68,136,77,63,105
2019,Charlottesville city,51540,Black or African American ,2874,766,2108,259,153,275
2019,Chesapeake city,51550,Black or African American ,24872,13870,11002,668,627,632
2019,Colonial Heights city,51570,Black or African American ,904,183,721,143,79,150
2019,Covington city,51580,Black or African American ,191,143,48,53,52,31
2019,Danville city,51590,Black or African American ,8612,3343,5269,334,252,409
2019,Emporia city,51595,Black or African American ,1387,445,942,158,106,183
2019,Fairfax city,51600,Black or African American ,436,188,248,133,89,133
2019,Falls Church city,51610,Black or African American ,253,40,213,61,38,54
2019,Franklin city,51620,Black or African American ,1789,520,1269,203,137,213
2019,Fredericksburg city,51630,Black or African American ,2574,565,2009,227,166,253
2019,Galax city,51640,Black or African American ,189,139,50,80,69,48
2019,Hampton city,51650,Black or African American ,26817,12678,14139,631,530,728
2019,Harrisonburg city,51660,Black or African American ,1544,239,1305,223,82,240
2019,Hopewell city,51670,Black or African American ,3832,1177,2655,262,229,312
2019,Lexington city,51678,Black or African American ,278,165,113,113,68,93
2019,Lynchburg city,51680,Black or African American ,8003,2501,5502,416,305,441
2019,Manassas city,51683,Black or African American ,2094,1263,831,192,184,198
2019,Manassas Park city,51685,Black or African American ,677,400,277,164,122,158
2019,Martinsville city,51690,Black or African American ,2568,976,1592,195,176,226
2019,Newport News city,51700,Black or African American ,29436,9834,19602,696,522,695
2019,Norfolk city,51710,Black or African American ,35143,9816,25327,711,607,830
2019,Norton city,51720,Black or African American ,49,20,29,48,29,43
2019,Petersburg city,51730,Black or African American ,10229,3676,6553,360,286,402
2019,Poquoson city,51735,Black or African American ,47,47,0,29,29,19
2019,Portsmouth city,51740,Black or African American ,18548,8223,10325,421,501,504
2019,Radford city,51750,Black or African American ,336,114,222,119,44,115
2019,Richmond city,51760,Black or African American ,39435,13343,26092,856,597,910
2019,Roanoke city,51770,Black or African American ,11320,4199,7121,454,342,510
2019,Salem city,51775,Black or African American ,645,144,501,187,63,195
2019,Staunton city,51790,Black or African American ,928,468,460,131,99,128
2019,Suffolk city,51800,Black or African American ,13926,7657,6269,380,415,454
2019,Virginia Beach city,51810,Black or African American ,31635,13875,17760,804,710,829
2019,Waynesboro city,51820,Black or African American ,1372,331,1041,216,122,228
2019,Williamsburg city,51830,Black or African American ,593,261,332,144,104,114
2019,Winchester city,51840,Black or African American ,963,300,663,149,109,157
2020,Accomack County,51001,Black or African American ,3503,1263,2240,278,233,290
2020,Albemarle County,51003,Black or African American ,3717,1802,1915,325,263,341
2020,Alleghany County,51005,Black or African American ,350,168,182,80,77,93
2020,Amelia County,51007,Black or African American ,1132,1016,116,133,140,90
2020,Amherst County,51009,Black or African American ,2141,1441,700,184,195,159
2020,Appomattox County,51011,Black or African American ,950,662,288,140,121,121
2020,Arlington County,51013,Black or African American ,9945,2112,7833,509,348,536
2020,Augusta County,51015,Black or African American ,524,252,272,139,101,122
2020,Bath County,51017,Black or African American ,94,60,34,85,75,46
2020,Bedford County,51019,Black or African American ,1794,1334,460,169,217,184
2020,Bland County,51021,Black or African American ,0,0,0,18,18,18
2020,Botetourt County,51023,Black or African American ,452,277,175,104,79,92
2020,Brunswick County,51025,Black or African American ,2862,1924,938,219,219,190
2020,Buchanan County,51027,Black or African American ,135,0,135,96,24,96
2020,Buckingham County,51029,Black or African American ,1902,1351,551,193,167,155
2020,Campbell County,51031,Black or African American ,3247,2236,1011,250,234,229
2020,Caroline County,51033,Black or African American ,2938,2336,602,287,251,219
2020,Carroll County,51035,Black or African American ,0,0,0,24,24,24
2020,Charles City County,51036,Black or African American ,1308,1107,201,65,74,49
2020,Charlotte County,51037,Black or African American ,1331,856,475,148,110,119
2020,Chesterfield County,51041,Black or African American ,27626,17104,10522,783,808,855
2020,Clarke County,51043,Black or African American ,291,172,119,71,73,73
2020,Craig County,51045,Black or African American ,0,0,0,18,18,18
2020,Culpeper County,51047,Black or African American ,2410,1288,1122,213,225,235
2020,Cumberland County,51049,Black or African American ,1346,831,515,169,145,164
2020,Dickenson County,51051,Black or African American ,2,2,0,4,4,20
2020,Dinwiddie County,51053,Black or African American ,3188,2244,944,290,233,209
2020,Essex County,51057,Black or African American ,1675,972,703,188,194,164
2020,Fairfax County,51059,Black or African American ,39493,18442,21051,871,821,1086
2020,Fauquier County,51061,Black or African American ,1569,1062,507,177,138,141
2020,Floyd County,51063,Black or African American ,61,61,0,31,31,20
2020,Fluvanna County,51065,Black or African American ,1175,795,380,183,168,172
2020,Franklin County,51067,Black or African American ,1498,1128,370,184,204,159
2020,Frederick County,51069,Black or African American ,974,691,283,149,130,107
2020,Giles County,51071,Black or African American ,81,51,30,52,42,42
2020,Gloucester County,51073,Black or African American ,1610,1236,374,177,186,148
2020,Goochland County,51075,Black or African American ,1183,834,349,150,153,141
2020,Grayson County,51077,Black or African American ,123,59,64,109,69,78
2020,Greene County,51079,Black or African American ,699,616,83,141,142,59
2020,Greensville County,51081,Black or African American ,1762,1260,502,179,181,140
2020,Halifax County,51083,Black or African American ,4841,3201,1640,318,282,275
2020,Hanover County,51085,Black or African American ,3405,2531,874,272,260,185
2020,Henrico County,51087,Black or African American ,38042,19808,18234,1031,1031,1006
2020,Henry County,51089,Black or African American ,4812,3000,1812,347,263,295
2020,Highland County,51091,Black or African American ,0,0,0,13,13,13
2020,Isle of Wight County,51093,Black or African American ,3331,2091,1240,210,221,215
2020,James City County,51095,Black or African American ,3465,1778,1687,363,272,344
2020,King and Queen County,51097,Black or African American ,724,564,160,136,122,82
2020,King George County,51099,Black or African American ,1524,954,570,130,133,137
2020,King William County,51101,Black or African American ,956,744,212,150,161,110
2020,Lancaster County,51103,Black or African American ,1589,1033,556,206,213,210
2020,Lee County,51105,Black or African American ,46,15,31,34,17,28
2020,Loudoun County,51107,Black or African American ,9891,5963,3928,443,472,440
2020,Louisa County,51109,Black or African American ,2386,1729,657,213,257,224
2020,Lunenburg County,51111,Black or African American ,1616,961,655,167,113,173
2020,Madison County,51113,Black or African American ,663,573,90,93,125,65
2020,Mathews County,51115,Black or African American ,405,237,168,86,111,90
2020,Mecklenburg County,51117,Black or African American ,3641,2065,1576,293,201,269
2020,Middlesex County,51119,Black or African American ,727,546,181,120,130,117
2020,Montgomery County,51121,Black or African American ,1341,426,915,182,165,217
2020,Nelson County,51125,Black or African American ,976,718,258,147,144,147
2020,New Kent County,51127,Black or African American ,926,853,73,178,200,47
2020,Northampton County,51131,Black or African American ,1625,752,873,144,136,171
2020,Northumberland County,51133,Black or African American ,1358,1199,159,222,177,129
2020,Nottoway County,51135,Black or African American ,2049,1069,980,217,207,215
2020,Orange County,51137,Black or African American ,1632,1109,523,153,159,167
2020,Page County,51139,Black or African American ,108,35,73,84,40,78
2020,Patrick County,51141,Black or African American ,318,213,105,49,46,47
2020,Pittsylvania County,51143,Black or African American ,5514,3801,1713,341,361,297
2020,Powhatan County,51145,Black or African American ,655,548,107,129,144,78
2020,Prince Edward County,51147,Black or African American ,2693,1370,1323,239,159,271
2020,Prince George County,51149,Black or African American ,3479,1920,1559,319,232,259
2020,Prince William County,51153,Black or African American ,31836,19396,12440,854,881,815
2020,Pulaski County,51155,Black or African American ,671,314,357,125,69,143
2020,Rappahannock County,51157,Black or African American ,115,56,59,61,39,44
2020,Richmond County,51159,Black or African American ,609,308,301,101,81,111
2020,Roanoke County,51161,Black or African American ,2184,971,1213,255,192,264
2020,Rockbridge County,51163,Black or African American ,140,121,19,54,56,20
2020,Rockingham County,51165,Black or African American ,537,242,295,118,62,99
2020,Russell County,51167,Black or African American ,22,22,0,38,38,24
2020,Scott County,51169,Black or African American ,19,0,19,30,24,30
2020,Shenandoah County,51171,Black or African American ,259,120,139,107,72,82
2020,Smyth County,51173,Black or African American ,145,54,91,89,52,67
2020,Southampton County,51175,Black or African American ,2146,1300,846,194,213,192
2020,Spotsylvania County,51177,Black or African American ,7884,5097,2787,349,380,331
2020,Stafford County,51179,Black or African American ,8924,5890,3034,481,393,460
2020,Surry County,51181,Black or African American ,1163,724,439,128,85,122
2020,Sussex County,51183,Black or African American ,1953,1270,683,177,148,153
2020,Tazewell County,51185,Black or African American ,345,91,254,155,41,158
2020,Warren County,51187,Black or African American ,625,365,260,142,102,105
2020,Washington County,51191,Black or African American ,151,57,94,112,54,87
2020,Westmoreland County,51193,Black or African American ,1723,1073,650,188,172,140
2020,Wise County,51195,Black or African American ,311,137,174,167,113,227
2020,Wythe County,51197,Black or African American ,283,135,148,131,101,114
2020,York County,51199,Black or African American ,3459,1867,1592,240,236,220
2020,Alexandria city,51510,Black or African American ,15114,2870,12244,642,398,712
2020,Bristol city,51520,Black or African American ,489,265,224,206,153,158
2020,Buena Vista city,51530,Black or African American ,185,52,133,97,41,95
2020,Charlottesville city,51540,Black or African American ,2838,779,2059,293,217,294
2020,Chesapeake city,51550,Black or African American ,25689,14595,11094,779,624,736
2020,Colonial Heights city,51570,Black or African American ,927,268,659,167,93,160
2020,Covington city,51580,Black or African American ,206,130,76,69,59,56
2020,Danville city,51590,Black or African American ,8752,3295,5457,352,306,390
2020,Emporia city,51595,Black or African American ,1332,395,937,160,119,165
2020,Fairfax city,51600,Black or African American ,331,153,178,115,68,100
2020,Falls Church city,51610,Black or African American ,217,32,185,77,35,76
2020,Franklin city,51620,Black or African American ,1790,575,1215,248,107,239
2020,Fredericksburg city,51630,Black or African American ,2299,579,1720,283,146,289
2020,Galax city,51640,Black or African American ,291,144,147,119,80,96
2020,Hampton city,51650,Black or African American ,27990,13655,14335,763,631,845
2020,Harrisonburg city,51660,Black or African American ,1448,314,1134,249,103,225
2020,Hopewell city,51670,Black or African American ,3836,1115,2721,253,223,339
2020,Lexington city,51678,Black or African American ,157,103,54,88,57,65
2020,Lynchburg city,51680,Black or African American ,8352,2529,5823,439,282,434
2020,Manassas city,51683,Black or African American ,1982,1148,834,246,213,231
2020,Manassas Park city,51685,Black or African American ,802,306,496,189,130,163
2020,Martinsville city,51690,Black or African American ,2624,990,1634,188,198,219
2020,Newport News city,51700,Black or African American ,29323,9981,19342,685,610,786
2020,Norfolk city,51710,Black or African American ,34780,10131,24649,817,637,825
2020,Norton city,51720,Black or African American ,51,9,42,68,19,64
2020,Petersburg city,51730,Black or African American ,10250,3537,6713,308,335,425
2020,Poquoson city,51735,Black or African American ,62,62,0,55,55,20
2020,Portsmouth city,51740,Black or African American ,18439,8338,10101,454,469,495
2020,Radford city,51750,Black or African American ,335,51,284,112,35,111
2020,Richmond city,51760,Black or African American ,38703,13686,25017,938,843,989
2020,Roanoke city,51770,Black or African American ,11361,4511,6850,524,526,596
2020,Salem city,51775,Black or African American ,668,174,494,179,80,175
2020,Staunton city,51790,Black or African American ,918,489,429,137,103,131
2020,Suffolk city,51800,Black or African American ,14106,8147,5959,441,476,477
2020,Virginia Beach city,51810,Black or African American ,31066,13930,17136,894,783,888
2020,Waynesboro city,51820,Black or African American ,901,263,638,321,154,277
2020,Williamsburg city,51830,Black or African American ,705,208,497,147,78,132
2020,Winchester city,51840,Black or African American ,1036,287,749,197,116,200
2021,Accomack County,51001,Black or African American ,3748,1604,2144,244,280,311
2021,Albemarle County,51003,Black or African American ,3660,1671,1989,330,310,324
2021,Alleghany County,51005,Black or African American ,323,157,166,76,71,92
2021,Amelia County,51007,Black or African American ,1219,1082,137,142,146,116
2021,Amherst County,51009,Black or African American ,2236,1445,791,189,180,191
2021,Appomattox County,51011,Black or African American ,899,556,343,134,101,111
2021,Arlington County,51013,Black or African American ,9919,2001,7918,484,308,505
2021,Augusta County,51015,Black or African American ,588,250,338,159,99,143
2021,Bath County,51017,Black or African American ,46,46,0,71,71,13
2021,Bedford County,51019,Black or African American ,1867,1362,505,167,183,200
2021,Bland County,51021,Black or African American ,11,11,0,20,20,19
2021,Botetourt County,51023,Black or African American ,442,259,183,79,70,77
2021,Brunswick County,51025,Black or African American ,2877,1995,882,266,189,214
2021,Buchanan County,51027,Black or African American ,84,0,84,89,25,89
2021,Buckingham County,51029,Black or African American ,1903,1334,569,131,153,132
2021,Campbell County,51031,Black or African American ,3110,2007,1103,272,261,257
2021,Caroline County,51033,Black or African American ,2907,2294,613,212,194,138
2021,Carroll County,51035,Black or African American ,17,0,17,31,25,31
2021,Charles City County,51036,Black or African American ,1314,1102,212,56,75,54
2021,Charlotte County,51037,Black or African American ,1121,688,433,139,108,100
2021,Chesterfield County,51041,Black or African American ,29606,18373,11233,690,754,873
2021,Clarke County,51043,Black or African American ,248,146,102,72,78,62
2021,Craig County,51045,Black or African American ,0,0,0,13,13,13
2021,Culpeper County,51047,Black or African American ,2601,1297,1304,245,247,333
2021,Cumberland County,51049,Black or African American ,1378,848,530,182,164,177
2021,Dickenson County,51051,Black or African American ,14,14,0,19,19,21
2021,Dinwiddie County,51053,Black or African American ,3175,2220,955,258,307,259
2021,Essex County,51057,Black or African American ,1553,942,611,148,167,159
2021,Fairfax County,51059,Black or African American ,40523,19217,21306,1029,839,1054
2021,Fauquier County,51061,Black or African American ,1597,1005,592,221,161,170
2021,Floyd County,51063,Black or African American ,124,124,0,62,62,21
2021,Fluvanna County,51065,Black or African American ,1239,828,411,182,163,143
2021,Franklin County,51067,Black or African American ,1518,1069,449,183,178,156
2021,Frederick County,51069,Black or African American ,1076,818,258,161,168,113
2021,Giles County,51071,Black or African American ,75,35,40,53,38,52
2021,Gloucester County,51073,Black or African American ,1271,959,312,141,138,91
2021,Goochland County,51075,Black or African American ,1258,934,324,178,146,114
2021,Grayson County,51077,Black or African American ,102,38,64,99,43,87
2021,Greene County,51079,Black or African American ,597,553,44,137,131,41
2021,Greensville County,51081,Black or African American ,1546,1152,394,203,212,126
2021,Halifax County,51083,Black or African American ,4456,2950,1506,354,321,261
2021,Hanover County,51085,Black or African American ,3469,2628,841,277,273,175
2021,Henrico County,51087,Black or African American ,39062,20727,18335,922,1006,919
2021,Henry County,51089,Black or African American ,4593,2937,1656,330,244,330
2021,Highland County,51091,Black or African American ,0,0,0,13,13,13
2021,Isle of Wight County,51093,Black or African American ,3361,2088,1273,238,244,204
2021,James City County,51095,Black or African American ,3502,1867,1635,326,280,381
2021,King and Queen County,51097,Black or African American ,626,470,156,120,129,70
2021,King George County,51099,Black or African American ,1499,943,556,130,148,156
2021,King William County,51101,Black or African American ,1060,756,304,155,131,161
2021,Lancaster County,51103,Black or African American ,1356,989,367,171,222,150
2021,Lee County,51105,Black or African American ,17,4,13,44,10,38
2021,Loudoun County,51107,Black or African American ,10114,6127,3987,396,441,449
2021,Louisa County,51109,Black or African American ,2222,1562,660,186,176,186
2021,Lunenburg County,51111,Black or African American ,1500,910,590,181,133,172
2021,Madison County,51113,Black or African American ,455,426,29,108,105,34
2021,Mathews County,51115,Black or African American ,320,210,110,155,150,115
2021,Mecklenburg County,51117,Black or African American ,3756,2114,1642,266,206,245
2021,Middlesex County,51119,Black or African American ,730,598,132,125,116,94
2021,Montgomery County,51121,Black or African American ,1470,306,1164,226,153,253
2021,Nelson County,51125,Black or African American ,864,660,204,155,110,148
2021,New Kent County,51127,Black or African American ,984,933,51,154,164,39
2021,Northampton County,51131,Black or African American ,1643,810,833,179,142,186
2021,Northumberland County,51133,Black or African American ,957,813,144,232,163,133
2021,Nottoway County,51135,Black or African American ,1910,1005,905,194,159,197
2021,Orange County,51137,Black or African American ,1663,1154,509,195,173,200
2021,Page County,51139,Black or African American ,106,49,57,103,61,83
2021,Patrick County,51141,Black or African American ,353,219,134,63,52,55
2021,Pittsylvania County,51143,Black or African American ,4909,3354,1555,251,299,344
2021,Powhatan County,51145,Black or African American ,590,400,190,151,126,112
2021,Prince Edward County,51147,Black or African American ,2409,1285,1124,217,188,207
2021,Prince George County,51149,Black or African American ,3652,2012,1640,403,251,350
2021,Prince William County,51153,Black or African American ,33046,20832,12214,857,836,837
2021,Pulaski County,51155,Black or African American ,649,334,315,145,89,128
2021,Rappahannock County,51157,Black or African American ,138,27,111,75,27,83
2021,Richmond County,51159,Black or African American ,566,304,262,112,91,108
2021,Roanoke County,51161,Black or African American ,2129,983,1146,235,170,238
2021,Rockbridge County,51163,Black or African American ,159,138,21,52,55,22
2021,Rockingham County,51165,Black or African American ,484,219,265,106,70,107
2021,Russell County,51167,Black or African American ,87,87,0,56,56,25
2021,Scott County,51169,Black or African American ,25,7,18,32,11,30
2021,Shenandoah County,51171,Black or African American ,309,164,145,101,81,84
2021,Smyth County,51173,Black or African American ,165,38,127,92,36,80
2021,Southampton County,51175,Black or African American ,2088,1306,782,218,200,178
2021,Spotsylvania County,51177,Black or African American ,8328,5389,2939,323,390,388
2021,Stafford County,51179,Black or African American ,9573,6648,2925,470,490,457
2021,Surry County,51181,Black or African American ,1082,708,374,93,86,100
2021,Sussex County,51183,Black or African American ,1841,1175,666,165,151,152
2021,Tazewell County,51185,Black or African American ,408,87,321,153,39,157
2021,Warren County,51187,Black or African American ,667,285,382,139,92,142
2021,Washington County,51191,Black or African American ,218,97,121,88,76,68
2021,Westmoreland County,51193,Black or African American ,1773,1247,526,222,228,181
2021,Wise County,51195,Black or African American ,263,36,227,215,98,226
2021,Wythe County,51197,Black or African American ,248,113,135,113,55,109
2021,York County,51199,Black or African American ,3353,1867,1486,270,198,234
2021,Alexandria city,51510,Black or African American ,15564,2853,12711,695,381,752
2021,Bristol city,51520,Black or African American ,507,271,236,143,105,119
2021,Buena Vista city,51530,Black or African American ,202,69,133,76,92,95
2021,Charlottesville city,51540,Black or African American ,2971,792,2179,263,214,316
2021,Chesapeake city,51550,Black or African American ,26988,15337,11651,775,972,820
2021,Colonial Heights city,51570,Black or African American ,1165,290,875,174,113,172
2021,Covington city,51580,Black or African American ,269,163,106,65,55,70
2021,Danville city,51590,Black or African American ,8895,3419,5476,318,318,416
2021,Emporia city,51595,Black or African American ,1585,476,1109,215,132,229
2021,Fairfax city,51600,Black or African American ,307,189,118,93,81,78
2021,Falls Church city,51610,Black or African American ,230,35,195,89,36,90
2021,Franklin city,51620,Black or African American ,1769,513,1256,201,153,199
2021,Fredericksburg city,51630,Black or African American ,2472,609,1863,341,199,345
2021,Galax city,51640,Black or African American ,225,135,90,123,91,89
2021,Hampton city,51650,Black or African American ,28891,13253,15638,754,705,933
2021,Harrisonburg city,51660,Black or African American ,1326,278,1048,210,118,211
2021,Hopewell city,51670,Black or African American ,3973,1209,2764,224,264,318
2021,Lexington city,51678,Black or African American ,120,36,84,95,53,80
2021,Lynchburg city,51680,Black or African American ,8357,2668,5689,432,294,480
2021,Manassas city,51683,Black or African American ,2104,1288,816,255,222,215
2021,Manassas Park city,51685,Black or African American ,848,467,381,177,136,195
2021,Martinsville city,51690,Black or African American ,2621,1014,1607,219,246,251
2021,Newport News city,51700,Black or African American ,31501,10195,21306,682,738,901
2021,Norfolk city,51710,Black or African American ,36734,10889,25845,701,713,986
2021,Norton city,51720,Black or African American ,18,7,11,26,16,19
2021,Petersburg city,51730,Black or African American ,11088,3639,7449,397,398,497
2021,Poquoson city,51735,Black or African American ,39,39,0,48,48,21
2021,Portsmouth city,51740,Black or African American ,19354,8767,10587,577,492,635
2021,Radford city,51750,Black or African American ,301,52,249,123,33,126
2021,Richmond city,51760,Black or African American ,41722,14742,26980,932,849,1197
2021,Roanoke city,51770,Black or African American ,11793,4648,7145,535,462,560
2021,Salem city,51775,Black or African American ,589,184,405,151,60,138
2021,Staunton city,51790,Black or African American ,991,454,537,132,136,136
2021,Suffolk city,51800,Black or African American ,14351,8399,5952,423,500,510
2021,Virginia Beach city,51810,Black or African American ,31940,14243,17697,840,908,838
2021,Waynesboro city,51820,Black or African American ,853,235,618,225,93,222
2021,Williamsburg city,51830,Black or African American ,900,255,645,158,104,156
2021,Winchester city,51840,Black or African American ,1146,241,905,176,126,204
2010,Accomack County,51001,American Indian and Alaska Native ,20,20,0,27,27,127
2010,Albemarle County,51003,American Indian and Alaska Native ,0,0,0,127,127,127
2010,Alleghany County,51005,American Indian and Alaska Native ,2,2,0,3,3,127
2010,Amelia County,51007,American Indian and Alaska Native ,18,18,0,31,31,127
2010,Amherst County,51009,American Indian and Alaska Native ,134,72,62,58,43,55
2010,Appomattox County,51011,American Indian and Alaska Native ,0,0,0,127,127,127
2010,Arlington County,51013,American Indian and Alaska Native ,324,106,218,102,59,88
2010,Augusta County,51015,American Indian and Alaska Native ,23,23,0,34,34,127
2010,Bath County,51017,American Indian and Alaska Native ,0,0,0,127,127,127
2010,Bedford County,51019,American Indian and Alaska Native ,54,41,13,48,42,22
2010,Bland County,51021,American Indian and Alaska Native ,0,0,0,127,127,127
2010,Botetourt County,51023,American Indian and Alaska Native ,0,0,0,127,127,127
2010,Brunswick County,51025,American Indian and Alaska Native ,0,0,0,127,127,127
2010,Buchanan County,51027,American Indian and Alaska Native ,13,0,13,12,127,12
2010,Buckingham County,51029,American Indian and Alaska Native ,0,0,0,127,127,127
2010,Campbell County,51031,American Indian and Alaska Native ,77,77,0,40,40,127
2010,Caroline County,51033,American Indian and Alaska Native ,70,70,0,38,38,127
2010,Carroll County,51035,American Indian and Alaska Native ,0,0,0,127,127,127
2010,Charles City County,51036,American Indian and Alaska Native ,167,156,11,37,35,10
2010,Charlotte County,51037,American Indian and Alaska Native ,19,19,0,29,29,127
2010,Chesterfield County,51041,American Indian and Alaska Native ,283,178,105,112,79,82
2010,Clarke County,51043,American Indian and Alaska Native ,12,12,0,17,17,127
2010,Craig County,51045,American Indian and Alaska Native ,0,0,0,127,127,127
2010,Culpeper County,51047,American Indian and Alaska Native ,47,47,0,61,61,127
2010,Cumberland County,51049,American Indian and Alaska Native ,12,12,0,22,22,127
2010,Dickenson County,51051,American Indian and Alaska Native ,11,11,0,17,17,127
2010,Dinwiddie County,51053,American Indian and Alaska Native ,0,0,0,127,127,127
2010,Essex County,51057,American Indian and Alaska Native ,28,28,0,18,18,127
2010,Fairfax County,51059,American Indian and Alaska Native ,1491,732,759,228,135,214
2010,Fauquier County,51061,American Indian and Alaska Native ,10,10,0,18,18,127
2010,Floyd County,51063,American Indian and Alaska Native ,13,13,0,19,19,127
2010,Fluvanna County,51065,American Indian and Alaska Native ,4,4,0,7,7,127
2010,Franklin County,51067,American Indian and Alaska Native ,0,0,0,127,127,127
2010,Frederick County,51069,American Indian and Alaska Native ,130,25,105,104,38,104
2010,Giles County,51071,American Indian and Alaska Native ,0,0,0,127,127,127
2010,Gloucester County,51073,American Indian and Alaska Native ,94,82,12,44,49,20
2010,Goochland County,51075,American Indian and Alaska Native ,0,0,0,127,127,127
2010,Grayson County,51077,American Indian and Alaska Native ,0,0,0,127,127,127
2010,Greene County,51079,American Indian and Alaska Native ,0,0,0,127,127,127
2010,Greensville County,51081,American Indian and Alaska Native ,14,14,0,18,18,127
2010,Halifax County,51083,American Indian and Alaska Native ,0,0,0,127,127,127
2010,Hanover County,51085,American Indian and Alaska Native ,68,29,39,68,33,62
2010,Henrico County,51087,American Indian and Alaska Native ,422,152,270,96,61,92
2010,Henry County,51089,American Indian and Alaska Native ,0,0,0,127,127,127
2010,Highland County,51091,American Indian and Alaska Native ,0,0,0,127,127,127
2010,Isle of Wight County,51093,American Indian and Alaska Native ,16,16,0,30,30,127
2010,James City County,51095,American Indian and Alaska Native ,35,35,0,41,41,127
2010,King and Queen County,51097,American Indian and Alaska Native ,45,28,17,36,26,27
2010,King George County,51099,American Indian and Alaska Native ,30,15,15,45,24,33
2010,King William County,51101,American Indian and Alaska Native ,67,47,20,39,31,19
2010,Lancaster County,51103,American Indian and Alaska Native ,0,0,0,127,127,127
2010,Lee County,51105,American Indian and Alaska Native ,0,0,0,127,127,127
2010,Loudoun County,51107,American Indian and Alaska Native ,85,64,21,58,52,20
2010,Louisa County,51109,American Indian and Alaska Native ,97,82,15,57,48,23
2010,Lunenburg County,51111,American Indian and Alaska Native ,0,0,0,127,127,127
2010,Madison County,51113,American Indian and Alaska Native ,0,0,0,127,127,127
2010,Mathews County,51115,American Indian and Alaska Native ,11,11,0,16,16,127
2010,Mecklenburg County,51117,American Indian and Alaska Native ,13,0,13,22,127,22
2010,Middlesex County,51119,American Indian and Alaska Native ,0,0,0,127,127,127
2010,Montgomery County,51121,American Indian and Alaska Native ,17,0,17,29,127,29
2010,Nelson County,51125,American Indian and Alaska Native ,0,0,0,127,127,127
2010,New Kent County,51127,American Indian and Alaska Native ,63,63,0,28,28,127
2010,Northampton County,51131,American Indian and Alaska Native ,4,4,0,6,6,127
2010,Northumberland County,51133,American Indian and Alaska Native ,0,0,0,127,127,127
2010,Nottoway County,51135,American Indian and Alaska Native ,0,0,0,127,127,127
2010,Orange County,51137,American Indian and Alaska Native ,0,0,0,127,127,127
2010,Page County,51139,American Indian and Alaska Native ,19,19,0,32,32,127
2010,Patrick County,51141,American Indian and Alaska Native ,19,19,0,13,13,127
2010,Pittsylvania County,51143,American Indian and Alaska Native ,0,0,0,127,127,127
2010,Powhatan County,51145,American Indian and Alaska Native ,0,0,0,127,127,127
2010,Prince Edward County,51147,American Indian and Alaska Native ,17,17,0,27,27,127
2010,Prince George County,51149,American Indian and Alaska Native ,45,38,7,34,29,12
2010,Prince William County,51153,American Indian and Alaska Native ,453,355,98,155,145,77
2010,Pulaski County,51155,American Indian and Alaska Native ,19,19,0,32,32,127
2010,Rappahannock County,51157,American Indian and Alaska Native ,0,0,0,127,127,127
2010,Richmond County,51159,American Indian and Alaska Native ,1,1,0,2,2,127
2010,Roanoke County,51161,American Indian and Alaska Native ,45,0,45,54,127,54
2010,Rockbridge County,51163,American Indian and Alaska Native ,14,14,0,23,23,127
2010,Rockingham County,51165,American Indian and Alaska Native ,42,17,25,28,19,24
2010,Russell County,51167,American Indian and Alaska Native ,23,23,0,30,30,127
2010,Scott County,51169,American Indian and Alaska Native ,0,0,0,127,127,127
2010,Shenandoah County,51171,American Indian and Alaska Native ,60,32,28,44,30,28
2010,Smyth County,51173,American Indian and Alaska Native ,47,35,12,38,27,26
2010,Southampton County,51175,American Indian and Alaska Native ,52,24,28,41,29,32
2010,Spotsylvania County,51177,American Indian and Alaska Native ,104,89,15,61,62,22
2010,Stafford County,51179,American Indian and Alaska Native ,286,190,96,91,77,76
2010,Surry County,51181,American Indian and Alaska Native ,0,0,0,127,127,127
2010,Sussex County,51183,American Indian and Alaska Native ,2,2,0,4,4,127
2010,Tazewell County,51185,American Indian and Alaska Native ,0,0,0,127,127,127
2010,Warren County,51187,American Indian and Alaska Native ,71,32,39,62,35,51
2010,Washington County,51191,American Indian and Alaska Native ,40,10,30,39,18,34
2010,Westmoreland County,51193,American Indian and Alaska Native ,0,0,0,127,127,127
2010,Wise County,51195,American Indian and Alaska Native ,0,0,0,127,127,127
2010,Wythe County,51197,American Indian and Alaska Native ,0,0,0,127,127,127
2010,York County,51199,American Indian and Alaska Native ,76,57,19,73,60,34
2010,Alexandria city,51510,American Indian and Alaska Native ,232,59,173,93,39,90
2010,Bedford County,51019,American Indian and Alaska Native ,0,0,0,127,127,127
2010,Bristol city,51520,American Indian and Alaska Native ,16,16,0,25,25,127
2010,Buena Vista city,51530,American Indian and Alaska Native ,7,7,0,14,14,127
2010,Charlottesville city,51540,American Indian and Alaska Native ,50,14,36,36,26,35
2010,Chesapeake city,51550,American Indian and Alaska Native ,405,241,164,120,105,102
2010,Colonial Heights city,51570,American Indian and Alaska Native ,33,0,33,47,127,47
2010,Covington city,51580,American Indian and Alaska Native ,17,17,0,20,20,127
2010,Danville city,51590,American Indian and Alaska Native ,21,12,9,22,16,18
2010,Emporia city,51595,American Indian and Alaska Native ,0,0,0,127,127,127
2010,Fairfax city,51600,American Indian and Alaska Native ,54,20,34,48,28,49
2010,Falls Church city,51610,American Indian and Alaska Native ,12,12,0,19,19,127
2010,Franklin city,51620,American Indian and Alaska Native ,0,0,0,127,127,127
2010,Fredericksburg city,51630,American Indian and Alaska Native ,20,0,20,31,127,31
2010,Galax city,51640,American Indian and Alaska Native ,73,37,36,78,55,61
2010,Hampton city,51650,American Indian and Alaska Native ,274,166,108,105,106,76
2010,Harrisonburg city,51660,American Indian and Alaska Native ,27,27,0,41,41,127
2010,Hopewell city,51670,American Indian and Alaska Native ,0,0,0,127,127,127
2010,Lexington city,51678,American Indian and Alaska Native ,0,0,0,127,127,127
2010,Lynchburg city,51680,American Indian and Alaska Native ,46,32,14,40,35,16
2010,Manassas city,51683,American Indian and Alaska Native ,37,13,24,48,21,43
2010,Manassas Park city,51685,American Indian and Alaska Native ,35,35,0,48,48,127
2010,Martinsville city,51690,American Indian and Alaska Native ,28,0,28,44,127,44
2010,Newport News city,51700,American Indian and Alaska Native ,205,91,114,103,44,87
2010,Norfolk city,51710,American Indian and Alaska Native ,314,173,141,118,93,77
2010,Norton city,51720,American Indian and Alaska Native ,0,0,0,127,127,127
2010,Petersburg city,51730,American Indian and Alaska Native ,12,12,0,18,18,127
2010,Poquoson city,51735,American Indian and Alaska Native ,0,0,0,127,127,127
2010,Portsmouth city,51740,American Indian and Alaska Native ,110,100,10,66,60,21
2010,Radford city,51750,American Indian and Alaska Native ,0,0,0,127,127,127
2010,Richmond city,51760,American Indian and Alaska Native ,293,168,125,102,65,84
2010,Roanoke city,51770,American Indian and Alaska Native ,124,18,106,74,19,77
2010,Salem city,51775,American Indian and Alaska Native ,12,0,12,19,127,19
2010,Staunton city,51790,American Indian and Alaska Native ,18,0,18,18,127,18
2010,Suffolk city,51800,American Indian and Alaska Native ,92,41,51,69,58,49
2010,Virginia Beach city,51810,American Indian and Alaska Native ,305,144,161,113,88,89
2010,Waynesboro city,51820,American Indian and Alaska Native ,33,0,33,53,127,53
2010,Williamsburg city,51830,American Indian and Alaska Native ,0,0,0,127,127,127
2010,Winchester city,51840,American Indian and Alaska Native ,36,16,20,44,27,33
2011,Accomack County,51001,American Indian and Alaska Native ,23,23,0,30,30,95
2011,Albemarle County,51003,American Indian and Alaska Native ,46,0,46,72,95,72
2011,Alleghany County,51005,American Indian and Alaska Native ,2,2,0,5,5,95
2011,Amelia County,51007,American Indian and Alaska Native ,126,126,0,98,98,95
2011,Amherst County,51009,American Indian and Alaska Native ,127,46,81,67,30,77
2011,Appomattox County,51011,American Indian and Alaska Native ,8,8,0,18,18,95
2011,Arlington County,51013,American Indian and Alaska Native ,340,112,228,100,65,83
2011,Augusta County,51015,American Indian and Alaska Native ,115,37,78,95,36,105
2011,Bath County,51017,American Indian and Alaska Native ,0,0,0,95,95,95
2011,Bedford County,51019,American Indian and Alaska Native ,40,27,13,36,30,20
2011,Bland County,51021,American Indian and Alaska Native ,0,0,0,95,95,95
2011,Botetourt County,51023,American Indian and Alaska Native ,0,0,0,95,95,95
2011,Brunswick County,51025,American Indian and Alaska Native ,0,0,0,95,95,95
2011,Buchanan County,51027,American Indian and Alaska Native ,34,0,34,71,95,71
2011,Buckingham County,51029,American Indian and Alaska Native ,0,0,0,95,95,95
2011,Campbell County,51031,American Indian and Alaska Native ,104,100,4,42,43,11
2011,Caroline County,51033,American Indian and Alaska Native ,107,107,0,49,49,95
2011,Carroll County,51035,American Indian and Alaska Native ,0,0,0,95,95,95
2011,Charles City County,51036,American Indian and Alaska Native ,171,150,21,33,31,15
2011,Charlotte County,51037,American Indian and Alaska Native ,27,27,0,42,42,95
2011,Chesterfield County,51041,American Indian and Alaska Native ,306,194,112,103,91,68
2011,Clarke County,51043,American Indian and Alaska Native ,10,10,0,13,13,95
2011,Craig County,51045,American Indian and Alaska Native ,0,0,0,95,95,95
2011,Culpeper County,51047,American Indian and Alaska Native ,18,18,0,29,29,95
2011,Cumberland County,51049,American Indian and Alaska Native ,7,7,0,13,13,95
2011,Dickenson County,51051,American Indian and Alaska Native ,11,11,0,17,17,95
2011,Dinwiddie County,51053,American Indian and Alaska Native ,0,0,0,95,95,95
2011,Essex County,51057,American Indian and Alaska Native ,27,27,0,13,13,95
2011,Fairfax County,51059,American Indian and Alaska Native ,1436,634,802,312,125,267
2011,Fauquier County,51061,American Indian and Alaska Native ,0,0,0,95,95,95
2011,Floyd County,51063,American Indian and Alaska Native ,9,9,0,19,19,95
2011,Fluvanna County,51065,American Indian and Alaska Native ,5,5,0,7,7,95
2011,Franklin County,51067,American Indian and Alaska Native ,54,12,42,53,20,54
2011,Frederick County,51069,American Indian and Alaska Native ,106,21,85,89,43,94
2011,Giles County,51071,American Indian and Alaska Native ,10,0,10,14,95,14
2011,Gloucester County,51073,American Indian and Alaska Native ,91,80,11,43,44,20
2011,Goochland County,51075,American Indian and Alaska Native ,0,0,0,95,95,95
2011,Grayson County,51077,American Indian and Alaska Native ,0,0,0,95,95,95
2011,Greene County,51079,American Indian and Alaska Native ,0,0,0,95,95,95
2011,Greensville County,51081,American Indian and Alaska Native ,22,22,0,25,25,95
2011,Halifax County,51083,American Indian and Alaska Native ,2,2,0,4,4,95
2011,Hanover County,51085,American Indian and Alaska Native ,41,6,35,53,11,52
2011,Henrico County,51087,American Indian and Alaska Native ,489,264,225,99,77,108
2011,Henry County,51089,American Indian and Alaska Native ,19,19,0,34,34,95
2011,Highland County,51091,American Indian and Alaska Native ,0,0,0,95,95,95
2011,Isle of Wight County,51093,American Indian and Alaska Native ,15,15,0,23,23,95
2011,James City County,51095,American Indian and Alaska Native ,40,40,0,41,41,95
2011,King and Queen County,51097,American Indian and Alaska Native ,31,16,15,32,20,24
2011,King George County,51099,American Indian and Alaska Native ,30,8,22,42,16,38
2011,King William County,51101,American Indian and Alaska Native ,75,47,28,38,27,25
2011,Lancaster County,51103,American Indian and Alaska Native ,0,0,0,95,95,95
2011,Lee County,51105,American Indian and Alaska Native ,7,7,0,16,16,95
2011,Loudoun County,51107,American Indian and Alaska Native ,205,168,37,88,91,41
2011,Louisa County,51109,American Indian and Alaska Native ,76,59,17,42,31,26
2011,Lunenburg County,51111,American Indian and Alaska Native ,0,0,0,95,95,95
2011,Madison County,51113,American Indian and Alaska Native ,0,0,0,95,95,95
2011,Mathews County,51115,American Indian and Alaska Native ,0,0,0,95,95,95
2011,Mecklenburg County,51117,American Indian and Alaska Native ,4,0,4,9,95,9
2011,Middlesex County,51119,American Indian and Alaska Native ,0,0,0,95,95,95
2011,Montgomery County,51121,American Indian and Alaska Native ,84,0,84,75,95,75
2011,Nelson County,51125,American Indian and Alaska Native ,23,0,23,35,95,35
2011,New Kent County,51127,American Indian and Alaska Native ,48,48,0,31,31,95
2011,Northampton County,51131,American Indian and Alaska Native ,4,4,0,7,7,95
2011,Northumberland County,51133,American Indian and Alaska Native ,0,0,0,95,95,95
2011,Nottoway County,51135,American Indian and Alaska Native ,5,0,5,14,95,14
2011,Orange County,51137,American Indian and Alaska Native ,0,0,0,95,95,95
2011,Page County,51139,American Indian and Alaska Native ,12,12,0,20,20,95
2011,Patrick County,51141,American Indian and Alaska Native ,43,43,0,41,41,95
2011,Pittsylvania County,51143,American Indian and Alaska Native ,17,0,17,27,95,27
2011,Powhatan County,51145,American Indian and Alaska Native ,16,16,0,17,17,95
2011,Prince Edward County,51147,American Indian and Alaska Native ,0,0,0,95,95,95
2011,Prince George County,51149,American Indian and Alaska Native ,47,47,0,46,46,95
2011,Prince William County,51153,American Indian and Alaska Native ,498,355,143,148,138,91
2011,Pulaski County,51155,American Indian and Alaska Native ,15,15,0,23,23,95
2011,Rappahannock County,51157,American Indian and Alaska Native ,0,0,0,95,95,95
2011,Richmond County,51159,American Indian and Alaska Native ,17,17,0,30,30,95
2011,Roanoke County,51161,American Indian and Alaska Native ,61,0,61,60,95,60
2011,Rockbridge County,51163,American Indian and Alaska Native ,12,12,0,18,18,95
2011,Rockingham County,51165,American Indian and Alaska Native ,36,15,21,31,17,27
2011,Russell County,51167,American Indian and Alaska Native ,24,24,0,35,35,95
2011,Scott County,51169,American Indian and Alaska Native ,0,0,0,95,95,95
2011,Shenandoah County,51171,American Indian and Alaska Native ,32,16,16,22,16,18
2011,Smyth County,51173,American Indian and Alaska Native ,28,28,0,34,34,95
2011,Southampton County,51175,American Indian and Alaska Native ,32,6,26,30,11,27
2011,Spotsylvania County,51177,American Indian and Alaska Native ,92,85,7,69,68,14
2011,Stafford County,51179,American Indian and Alaska Native ,240,150,90,82,75,48
2011,Surry County,51181,American Indian and Alaska Native ,0,0,0,95,95,95
2011,Sussex County,51183,American Indian and Alaska Native ,2,2,0,4,4,95
2011,Tazewell County,51185,American Indian and Alaska Native ,0,0,0,95,95,95
2011,Warren County,51187,American Indian and Alaska Native ,82,49,33,64,42,55
2011,Washington County,51191,American Indian and Alaska Native ,38,10,28,36,18,31
2011,Westmoreland County,51193,American Indian and Alaska Native ,0,0,0,95,95,95
2011,Wise County,51195,American Indian and Alaska Native ,0,0,0,95,95,95
2011,Wythe County,51197,American Indian and Alaska Native ,0,0,0,95,95,95
2011,York County,51199,American Indian and Alaska Native ,106,79,27,84,78,40
2011,Alexandria city,51510,American Indian and Alaska Native ,236,36,200,99,36,98
2011,Bedford County,51019,American Indian and Alaska Native ,0,0,0,95,95,95
2011,Bristol city,51520,American Indian and Alaska Native ,34,14,20,40,23,32
2011,Buena Vista city,51530,American Indian and Alaska Native ,0,0,0,95,95,95
2011,Charlottesville city,51540,American Indian and Alaska Native ,47,16,31,47,28,35
2011,Chesapeake city,51550,American Indian and Alaska Native ,381,223,158,122,95,98
2011,Colonial Heights city,51570,American Indian and Alaska Native ,0,0,0,95,95,95
2011,Covington city,51580,American Indian and Alaska Native ,28,28,0,31,31,95
2011,Danville city,51590,American Indian and Alaska Native ,0,0,0,95,95,95
2011,Emporia city,51595,American Indian and Alaska Native ,20,20,0,34,34,95
2011,Fairfax city,51600,American Indian and Alaska Native ,36,36,0,36,36,95
2011,Falls Church city,51610,American Indian and Alaska Native ,7,7,0,13,13,95
2011,Franklin city,51620,American Indian and Alaska Native ,0,0,0,95,95,95
2011,Fredericksburg city,51630,American Indian and Alaska Native ,9,0,9,15,95,15
2011,Galax city,51640,American Indian and Alaska Native ,74,38,36,60,53,53
2011,Hampton city,51650,American Indian and Alaska Native ,331,202,129,99,117,80
2011,Harrisonburg city,51660,American Indian and Alaska Native ,19,19,0,31,31,95
2011,Hopewell city,51670,American Indian and Alaska Native ,4,0,4,6,95,6
2011,Lexington city,51678,American Indian and Alaska Native ,0,0,0,95,95,95
2011,Lynchburg city,51680,American Indian and Alaska Native ,62,26,36,49,27,40
2011,Manassas city,51683,American Indian and Alaska Native ,20,0,20,37,95,37
2011,Manassas Park city,51685,American Indian and Alaska Native ,42,30,12,52,47,19
2011,Martinsville city,51690,American Indian and Alaska Native ,35,0,35,55,95,55
2011,Newport News city,51700,American Indian and Alaska Native ,278,92,186,121,53,115
2011,Norfolk city,51710,American Indian and Alaska Native ,350,171,179,118,78,83
2011,Norton city,51720,American Indian and Alaska Native ,0,0,0,95,95,95
2011,Petersburg city,51730,American Indian and Alaska Native ,16,16,0,19,19,95
2011,Poquoson city,51735,American Indian and Alaska Native ,0,0,0,95,95,95
2011,Portsmouth city,51740,American Indian and Alaska Native ,47,36,11,46,39,20
2011,Radford city,51750,American Indian and Alaska Native ,0,0,0,95,95,95
2011,Richmond city,51760,American Indian and Alaska Native ,267,159,108,100,63,85
2011,Roanoke city,51770,American Indian and Alaska Native ,92,35,57,66,39,56
2011,Salem city,51775,American Indian and Alaska Native ,9,0,9,17,95,17
2011,Staunton city,51790,American Indian and Alaska Native ,29,0,29,26,95,26
2011,Suffolk city,51800,American Indian and Alaska Native ,66,10,56,66,18,66
2011,Virginia Beach city,51810,American Indian and Alaska Native ,505,369,136,151,149,72
2011,Waynesboro city,51820,American Indian and Alaska Native ,35,0,35,52,95,52
2011,Williamsburg city,51830,American Indian and Alaska Native ,0,0,0,95,95,95
2011,Winchester city,51840,American Indian and Alaska Native ,32,10,22,37,16,33
2012,Accomack County,51001,American Indian and Alaska Native ,26,26,0,35,35,26
2012,Albemarle County,51003,American Indian and Alaska Native ,91,0,91,77,29,77
2012,Alleghany County,51005,American Indian and Alaska Native ,4,4,0,7,7,19
2012,Amelia County,51007,American Indian and Alaska Native ,93,93,0,84,84,19
2012,Amherst County,51009,American Indian and Alaska Native ,129,68,61,69,42,74
2012,Appomattox County,51011,American Indian and Alaska Native ,12,12,0,19,19,19
2012,Arlington County,51013,American Indian and Alaska Native ,264,97,167,103,60,83
2012,Augusta County,51015,American Indian and Alaska Native ,131,23,108,119,36,130
2012,Bath County,51017,American Indian and Alaska Native ,0,0,0,12,12,12
2012,Bedford County,51019,American Indian and Alaska Native ,40,28,12,30,25,20
2012,Bland County,51021,American Indian and Alaska Native ,0,0,0,17,17,17
2012,Botetourt County,51023,American Indian and Alaska Native ,0,0,0,26,26,26
2012,Brunswick County,51025,American Indian and Alaska Native ,0,0,0,19,19,19
2012,Buchanan County,51027,American Indian and Alaska Native ,43,0,43,87,23,87
2012,Buckingham County,51029,American Indian and Alaska Native ,0,0,0,19,19,19
2012,Campbell County,51031,American Indian and Alaska Native ,117,97,20,57,54,34
2012,Caroline County,51033,American Indian and Alaska Native ,96,96,0,49,49,23
2012,Carroll County,51035,American Indian and Alaska Native ,0,0,0,23,23,23
2012,Charles City County,51036,American Indian and Alaska Native ,168,151,17,29,23,11
2012,Charlotte County,51037,American Indian and Alaska Native ,35,35,0,42,42,19
2012,Chesterfield County,51041,American Indian and Alaska Native ,356,208,148,110,87,89
2012,Clarke County,51043,American Indian and Alaska Native ,20,20,0,23,23,19
2012,Craig County,51045,American Indian and Alaska Native ,0,0,0,17,17,17
2012,Culpeper County,51047,American Indian and Alaska Native ,13,13,0,20,20,26
2012,Cumberland County,51049,American Indian and Alaska Native ,11,11,0,19,19,17
2012,Dickenson County,51051,American Indian and Alaska Native ,0,0,0,19,19,19
2012,Dinwiddie County,51053,American Indian and Alaska Native ,0,0,0,23,23,23
2012,Essex County,51057,American Indian and Alaska Native ,18,18,0,8,8,19
2012,Fairfax County,51059,American Indian and Alaska Native ,1461,602,859,263,141,225
2012,Fauquier County,51061,American Indian and Alaska Native ,0,0,0,29,29,29
2012,Floyd County,51063,American Indian and Alaska Native ,20,20,0,28,28,19
2012,Fluvanna County,51065,American Indian and Alaska Native ,5,5,0,8,8,23
2012,Franklin County,51067,American Indian and Alaska Native ,40,10,30,42,15,43
2012,Frederick County,51069,American Indian and Alaska Native ,47,13,34,52,23,43
2012,Giles County,51071,American Indian and Alaska Native ,17,0,17,26,19,26
2012,Gloucester County,51073,American Indian and Alaska Native ,58,50,8,42,43,13
2012,Goochland County,51075,American Indian and Alaska Native ,0,0,0,23,23,23
2012,Grayson County,51077,American Indian and Alaska Native ,0,0,0,19,19,19
2012,Greene County,51079,American Indian and Alaska Native ,0,0,0,19,19,19
2012,Greensville County,51081,American Indian and Alaska Native ,9,0,9,14,19,14
2012,Halifax County,51083,American Indian and Alaska Native ,3,3,0,5,5,26
2012,Hanover County,51085,American Indian and Alaska Native ,53,16,37,49,23,43
2012,Henrico County,51087,American Indian and Alaska Native ,436,279,157,108,128,96
2012,Henry County,51089,American Indian and Alaska Native ,16,16,0,29,29,29
2012,Highland County,51091,American Indian and Alaska Native ,0,0,0,12,12,12
2012,Isle of Wight County,51093,American Indian and Alaska Native ,7,7,0,12,12,26
2012,James City County,51095,American Indian and Alaska Native ,78,52,26,44,38,19
2012,King and Queen County,51097,American Indian and Alaska Native ,9,9,0,16,16,17
2012,King George County,51099,American Indian and Alaska Native ,19,8,11,24,14,20
2012,King William County,51101,American Indian and Alaska Native ,79,65,14,38,39,12
2012,Lancaster County,51103,American Indian and Alaska Native ,0,0,0,19,19,19
2012,Lee County,51105,American Indian and Alaska Native ,3,3,0,12,12,23
2012,Loudoun County,51107,American Indian and Alaska Native ,203,148,55,71,63,36
2012,Louisa County,51109,American Indian and Alaska Native ,75,50,25,50,41,36
2012,Lunenburg County,51111,American Indian and Alaska Native ,0,0,0,19,19,19
2012,Madison County,51113,American Indian and Alaska Native ,0,0,0,19,19,19
2012,Mathews County,51115,American Indian and Alaska Native ,0,0,0,17,17,17
2012,Mecklenburg County,51117,American Indian and Alaska Native ,8,0,8,13,26,13
2012,Middlesex County,51119,American Indian and Alaska Native ,6,6,0,11,11,19
2012,Montgomery County,51121,American Indian and Alaska Native ,89,0,89,68,29,68
2012,Nelson County,51125,American Indian and Alaska Native ,29,0,29,47,19,47
2012,New Kent County,51127,American Indian and Alaska Native ,55,55,0,31,31,19
2012,Northampton County,51131,American Indian and Alaska Native ,0,0,0,19,19,19
2012,Northumberland County,51133,American Indian and Alaska Native ,0,0,0,19,19,19
2012,Nottoway County,51135,American Indian and Alaska Native ,18,0,18,33,19,33
2012,Orange County,51137,American Indian and Alaska Native ,20,20,0,34,34,26
2012,Page County,51139,American Indian and Alaska Native ,14,14,0,23,23,23
2012,Patrick County,51141,American Indian and Alaska Native ,13,13,0,10,10,19
2012,Pittsylvania County,51143,American Indian and Alaska Native ,21,0,21,26,29,26
2012,Powhatan County,51145,American Indian and Alaska Native ,13,13,0,16,16,23
2012,Prince Edward County,51147,American Indian and Alaska Native ,0,0,0,23,23,23
2012,Prince George County,51149,American Indian and Alaska Native ,51,35,16,51,40,26
2012,Prince William County,51153,American Indian and Alaska Native ,478,309,169,142,132,92
2012,Pulaski County,51155,American Indian and Alaska Native ,20,20,0,34,34,26
2012,Rappahannock County,51157,American Indian and Alaska Native ,3,0,3,5,17,5
2012,Richmond County,51159,American Indian and Alaska Native ,13,13,0,28,28,17
2012,Roanoke County,51161,American Indian and Alaska Native ,71,22,49,46,28,48
2012,Rockbridge County,51163,American Indian and Alaska Native ,15,15,0,25,25,23
2012,Rockingham County,51165,American Indian and Alaska Native ,61,38,23,50,34,32
2012,Russell County,51167,American Indian and Alaska Native ,20,20,0,27,27,23
2012,Scott County,51169,American Indian and Alaska Native ,0,0,0,23,23,23
2012,Shenandoah County,51171,American Indian and Alaska Native ,14,10,4,13,11,6
2012,Smyth County,51173,American Indian and Alaska Native ,40,40,0,37,37,26
2012,Southampton County,51175,American Indian and Alaska Native ,25,9,16,31,13,24
2012,Spotsylvania County,51177,American Indian and Alaska Native ,138,115,23,77,73,29
2012,Stafford County,51179,American Indian and Alaska Native ,226,133,93,94,75,45
2012,Surry County,51181,American Indian and Alaska Native ,0,0,0,17,17,17
2012,Sussex County,51183,American Indian and Alaska Native ,2,2,0,4,4,19
2012,Tazewell County,51185,American Indian and Alaska Native ,0,0,0,26,26,26
2012,Warren County,51187,American Indian and Alaska Native ,65,41,24,50,43,39
2012,Washington County,51191,American Indian and Alaska Native ,41,24,17,34,29,19
2012,Westmoreland County,51193,American Indian and Alaska Native ,3,3,0,5,5,19
2012,Wise County,51195,American Indian and Alaska Native ,0,0,0,26,26,26
2012,Wythe County,51197,American Indian and Alaska Native ,0,0,0,23,23,23
2012,York County,51199,American Indian and Alaska Native ,100,49,51,71,45,52
2012,Alexandria city,51510,American Indian and Alaska Native ,242,48,194,82,40,86
2012,Bedford County,51019,American Indian and Alaska Native ,0,0,0,17,17,17
2012,Bristol city,51520,American Indian and Alaska Native ,27,11,16,25,18,18
2012,Buena Vista city,51530,American Indian and Alaska Native ,0,0,0,17,17,17
2012,Charlottesville city,51540,American Indian and Alaska Native ,84,22,62,37,20,37
2012,Chesapeake city,51550,American Indian and Alaska Native ,360,186,174,112,78,91
2012,Colonial Heights city,51570,American Indian and Alaska Native ,10,10,0,18,18,19
2012,Covington city,51580,American Indian and Alaska Native ,15,15,0,23,23,17
2012,Danville city,51590,American Indian and Alaska Native ,12,0,12,13,26,13
2012,Emporia city,51595,American Indian and Alaska Native ,7,7,0,11,11,17
2012,Fairfax city,51600,American Indian and Alaska Native ,29,17,12,28,21,18
2012,Falls Church city,51610,American Indian and Alaska Native ,8,8,0,16,16,19
2012,Franklin city,51620,American Indian and Alaska Native ,0,0,0,17,17,17
2012,Fredericksburg city,51630,American Indian and Alaska Native ,12,0,12,17,23,17
2012,Galax city,51640,American Indian and Alaska Native ,25,13,12,28,20,23
2012,Hampton city,51650,American Indian and Alaska Native ,258,152,106,85,70,63
2012,Harrisonburg city,51660,American Indian and Alaska Native ,16,16,0,27,27,29
2012,Hopewell city,51670,American Indian and Alaska Native ,31,0,31,39,23,39
2012,Lexington city,51678,American Indian and Alaska Native ,0,0,0,17,17,17
2012,Lynchburg city,51680,American Indian and Alaska Native ,59,0,59,37,29,37
2012,Manassas city,51683,American Indian and Alaska Native ,18,5,13,25,10,26
2012,Manassas Park city,51685,American Indian and Alaska Native ,64,43,21,77,68,31
2012,Martinsville city,51690,American Indian and Alaska Native ,32,0,32,52,19,52
2012,Newport News city,51700,American Indian and Alaska Native ,357,119,238,122,45,123
2012,Norfolk city,51710,American Indian and Alaska Native ,309,144,165,96,72,74
2012,Norton city,51720,American Indian and Alaska Native ,0,0,0,12,12,12
2012,Petersburg city,51730,American Indian and Alaska Native ,24,24,0,24,24,26
2012,Poquoson city,51735,American Indian and Alaska Native ,0,0,0,19,19,19
2012,Portsmouth city,51740,American Indian and Alaska Native ,64,48,16,52,44,25
2012,Radford city,51750,American Indian and Alaska Native ,0,0,0,19,19,19
2012,Richmond city,51760,American Indian and Alaska Native ,252,142,110,90,63,65
2012,Roanoke city,51770,American Indian and Alaska Native ,55,22,33,48,28,35
2012,Salem city,51775,American Indian and Alaska Native ,14,0,14,24,23,24
2012,Staunton city,51790,American Indian and Alaska Native ,0,0,0,23,23,23
2012,Suffolk city,51800,American Indian and Alaska Native ,31,16,15,38,26,24
2012,Virginia Beach city,51810,American Indian and Alaska Native ,561,375,186,142,140,86
2012,Waynesboro city,51820,American Indian and Alaska Native ,63,0,63,104,23,104
2012,Williamsburg city,51830,American Indian and Alaska Native ,0,0,0,19,19,19
2012,Winchester city,51840,American Indian and Alaska Native ,7,7,0,11,11,23
2013,Accomack County,51001,American Indian and Alaska Native ,25,25,0,33,33,26
2013,Albemarle County,51003,American Indian and Alaska Native ,79,0,79,62,29,62
2013,Alleghany County,51005,American Indian and Alaska Native ,8,8,0,9,9,19
2013,Amelia County,51007,American Indian and Alaska Native ,116,116,0,108,108,19
2013,Amherst County,51009,American Indian and Alaska Native ,148,88,60,77,42,76
2013,Appomattox County,51011,American Indian and Alaska Native ,24,24,0,28,28,19
2013,Arlington County,51013,American Indian and Alaska Native ,342,100,242,116,46,118
2013,Augusta County,51015,American Indian and Alaska Native ,146,48,98,111,34,128
2013,Bath County,51017,American Indian and Alaska Native ,0,0,0,12,12,12
2013,Bedford County,51019,American Indian and Alaska Native ,66,54,12,31,35,19
2013,Bland County,51021,American Indian and Alaska Native ,0,0,0,17,17,17
2013,Botetourt County,51023,American Indian and Alaska Native ,21,21,0,31,31,26
2013,Brunswick County,51025,American Indian and Alaska Native ,0,0,0,19,19,19
2013,Buchanan County,51027,American Indian and Alaska Native ,0,0,0,23,23,23
2013,Buckingham County,51029,American Indian and Alaska Native ,0,0,0,19,19,19
2013,Campbell County,51031,American Indian and Alaska Native ,54,21,33,61,35,53
2013,Caroline County,51033,American Indian and Alaska Native ,78,78,0,50,50,23
2013,Carroll County,51035,American Indian and Alaska Native ,0,0,0,23,23,23
2013,Charles City County,51036,American Indian and Alaska Native ,177,161,16,26,23,9
2013,Charlotte County,51037,American Indian and Alaska Native ,32,32,0,44,44,19
2013,Chesterfield County,51041,American Indian and Alaska Native ,350,163,187,135,96,97
2013,Clarke County,51043,American Indian and Alaska Native ,39,32,7,26,24,12
2013,Craig County,51045,American Indian and Alaska Native ,0,0,0,17,17,17
2013,Culpeper County,51047,American Indian and Alaska Native ,0,0,0,26,26,26
2013,Cumberland County,51049,American Indian and Alaska Native ,12,12,0,21,21,17
2013,Dickenson County,51051,American Indian and Alaska Native ,0,0,0,19,19,19
2013,Dinwiddie County,51053,American Indian and Alaska Native ,0,0,0,23,23,23
2013,Essex County,51057,American Indian and Alaska Native ,23,23,0,7,7,19
2013,Fairfax County,51059,American Indian and Alaska Native ,1361,627,734,253,124,233
2013,Fauquier County,51061,American Indian and Alaska Native ,0,0,0,29,29,29
2013,Floyd County,51063,American Indian and Alaska Native ,6,6,0,14,14,19
2013,Fluvanna County,51065,American Indian and Alaska Native ,7,7,0,11,11,23
2013,Franklin County,51067,American Indian and Alaska Native ,40,17,23,31,17,31
2013,Frederick County,51069,American Indian and Alaska Native ,65,20,45,48,22,44
2013,Giles County,51071,American Indian and Alaska Native ,26,0,26,37,19,37
2013,Gloucester County,51073,American Indian and Alaska Native ,55,55,0,43,43,26
2013,Goochland County,51075,American Indian and Alaska Native ,0,0,0,23,23,23
2013,Grayson County,51077,American Indian and Alaska Native ,0,0,0,19,19,19
2013,Greene County,51079,American Indian and Alaska Native ,0,0,0,19,19,19
2013,Greensville County,51081,American Indian and Alaska Native ,6,0,6,10,19,10
2013,Halifax County,51083,American Indian and Alaska Native ,13,3,10,17,5,17
2013,Hanover County,51085,American Indian and Alaska Native ,53,12,41,51,15,47
2013,Henrico County,51087,American Indian and Alaska Native ,345,261,84,99,80,58
2013,Henry County,51089,American Indian and Alaska Native ,17,17,0,30,30,29
2013,Highland County,51091,American Indian and Alaska Native ,0,0,0,12,12,12
2013,Isle of Wight County,51093,American Indian and Alaska Native ,12,12,0,21,21,26
2013,James City County,51095,American Indian and Alaska Native ,84,55,29,40,45,30
2013,King and Queen County,51097,American Indian and Alaska Native ,0,0,0,17,17,17
2013,King George County,51099,American Indian and Alaska Native ,7,7,0,11,11,23
2013,King William County,51101,American Indian and Alaska Native ,81,69,12,33,33,11
2013,Lancaster County,51103,American Indian and Alaska Native ,0,0,0,19,19,19
2013,Lee County,51105,American Indian and Alaska Native ,3,3,0,17,17,23
2013,Loudoun County,51107,American Indian and Alaska Native ,250,187,63,73,66,39
2013,Louisa County,51109,American Indian and Alaska Native ,63,42,21,32,25,27
2013,Lunenburg County,51111,American Indian and Alaska Native ,0,0,0,19,19,19
2013,Madison County,51113,American Indian and Alaska Native ,0,0,0,19,19,19
2013,Mathews County,51115,American Indian and Alaska Native ,0,0,0,17,17,17
2013,Mecklenburg County,51117,American Indian and Alaska Native ,17,0,17,27,26,27
2013,Middlesex County,51119,American Indian and Alaska Native ,6,6,0,11,11,19
2013,Montgomery County,51121,American Indian and Alaska Native ,64,12,52,47,19,43
2013,Nelson County,51125,American Indian and Alaska Native ,14,0,14,26,19,26
2013,New Kent County,51127,American Indian and Alaska Native ,49,49,0,32,32,19
2013,Northampton County,51131,American Indian and Alaska Native ,4,4,0,8,8,19
2013,Northumberland County,51133,American Indian and Alaska Native ,0,0,0,19,19,19
2013,Nottoway County,51135,American Indian and Alaska Native ,25,0,25,34,19,34
2013,Orange County,51137,American Indian and Alaska Native ,19,19,0,33,33,26
2013,Page County,51139,American Indian and Alaska Native ,24,24,0,28,28,23
2013,Patrick County,51141,American Indian and Alaska Native ,13,13,0,20,20,19
2013,Pittsylvania County,51143,American Indian and Alaska Native ,22,0,22,27,29,27
2013,Powhatan County,51145,American Indian and Alaska Native ,17,17,0,22,22,23
2013,Prince Edward County,51147,American Indian and Alaska Native ,0,0,0,23,23,23
2013,Prince George County,51149,American Indian and Alaska Native ,91,47,44,68,48,45
2013,Prince William County,51153,American Indian and Alaska Native ,521,338,183,152,134,107
2013,Pulaski County,51155,American Indian and Alaska Native ,0,0,0,26,26,26
2013,Rappahannock County,51157,American Indian and Alaska Native ,3,0,3,5,17,5
2013,Richmond County,51159,American Indian and Alaska Native ,3,3,0,19,19,17
2013,Roanoke County,51161,American Indian and Alaska Native ,24,12,12,27,19,19
2013,Rockbridge County,51163,American Indian and Alaska Native ,38,38,0,37,37,23
2013,Rockingham County,51165,American Indian and Alaska Native ,28,13,15,32,22,24
2013,Russell County,51167,American Indian and Alaska Native ,23,23,0,30,30,23
2013,Scott County,51169,American Indian and Alaska Native ,0,0,0,23,23,23
2013,Shenandoah County,51171,American Indian and Alaska Native ,16,16,0,14,14,26
2013,Smyth County,51173,American Indian and Alaska Native ,16,16,0,20,20,26
2013,Southampton County,51175,American Indian and Alaska Native ,33,17,16,25,19,19
2013,Spotsylvania County,51177,American Indian and Alaska Native ,143,123,20,69,68,23
2013,Stafford County,51179,American Indian and Alaska Native ,267,157,110,83,68,54
2013,Surry County,51181,American Indian and Alaska Native ,0,0,0,17,17,17
2013,Sussex County,51183,American Indian and Alaska Native ,2,2,0,4,4,19
2013,Tazewell County,51185,American Indian and Alaska Native ,0,0,0,26,26,26
2013,Warren County,51187,American Indian and Alaska Native ,50,29,21,46,26,38
2013,Washington County,51191,American Indian and Alaska Native ,36,29,7,38,34,13
2013,Westmoreland County,51193,American Indian and Alaska Native ,3,3,0,5,5,19
2013,Wise County,51195,American Indian and Alaska Native ,9,9,0,13,13,26
2013,Wythe County,51197,American Indian and Alaska Native ,0,0,0,23,23,23
2013,York County,51199,American Indian and Alaska Native ,79,36,43,58,32,42
2013,Alexandria city,51510,American Indian and Alaska Native ,228,54,174,77,40,71
2013,Bedford County,51019,American Indian and Alaska Native ,0,0,0,17,17,17
2013,Bristol city,51520,American Indian and Alaska Native ,29,0,29,30,19,30
2013,Buena Vista city,51530,American Indian and Alaska Native ,0,0,0,17,17,17
2013,Charlottesville city,51540,American Indian and Alaska Native ,88,27,61,43,29,37
2013,Chesapeake city,51550,American Indian and Alaska Native ,233,113,120,88,61,67
2013,Colonial Heights city,51570,American Indian and Alaska Native ,11,11,0,18,18,19
2013,Covington city,51580,American Indian and Alaska Native ,8,8,0,13,13,17
2013,Danville city,51590,American Indian and Alaska Native ,42,5,37,39,11,37
2013,Emporia city,51595,American Indian and Alaska Native ,6,6,0,9,9,17
2013,Fairfax city,51600,American Indian and Alaska Native ,25,16,9,25,21,15
2013,Falls Church city,51610,American Indian and Alaska Native ,0,0,0,19,19,19
2013,Franklin city,51620,American Indian and Alaska Native ,0,0,0,17,17,17
2013,Fredericksburg city,51630,American Indian and Alaska Native ,12,0,12,19,23,19
2013,Galax city,51640,American Indian and Alaska Native ,19,10,9,22,15,17
2013,Hampton city,51650,American Indian and Alaska Native ,234,184,50,88,79,50
2013,Harrisonburg city,51660,American Indian and Alaska Native ,38,38,0,41,41,29
2013,Hopewell city,51670,American Indian and Alaska Native ,23,0,23,38,23,38
2013,Lexington city,51678,American Indian and Alaska Native ,0,0,0,17,17,17
2013,Lynchburg city,51680,American Indian and Alaska Native ,60,0,60,51,29,51
2013,Manassas city,51683,American Indian and Alaska Native ,28,9,19,35,18,31
2013,Manassas Park city,51685,American Indian and Alaska Native ,29,13,16,30,16,26
2013,Martinsville city,51690,American Indian and Alaska Native ,48,0,48,71,19,71
2013,Newport News city,51700,American Indian and Alaska Native ,302,112,190,97,51,98
2013,Norfolk city,51710,American Indian and Alaska Native ,292,136,156,100,58,81
2013,Norton city,51720,American Indian and Alaska Native ,0,0,0,12,12,12
2013,Petersburg city,51730,American Indian and Alaska Native ,22,22,0,21,21,26
2013,Poquoson city,51735,American Indian and Alaska Native ,0,0,0,19,19,19
2013,Portsmouth city,51740,American Indian and Alaska Native ,71,58,13,42,36,20
2013,Radford city,51750,American Indian and Alaska Native ,0,0,0,19,19,19
2013,Richmond city,51760,American Indian and Alaska Native ,208,90,118,66,46,49
2013,Roanoke city,51770,American Indian and Alaska Native ,71,45,26,58,43,31
2013,Salem city,51775,American Indian and Alaska Native ,0,0,0,23,23,23
2013,Staunton city,51790,American Indian and Alaska Native ,0,0,0,23,23,23
2013,Suffolk city,51800,American Indian and Alaska Native ,34,13,21,30,17,27
2013,Virginia Beach city,51810,American Indian and Alaska Native ,658,443,215,170,153,96
2013,Waynesboro city,51820,American Indian and Alaska Native ,20,0,20,34,23,34
2013,Williamsburg city,51830,American Indian and Alaska Native ,0,0,0,19,19,19
2013,Winchester city,51840,American Indian and Alaska Native ,5,5,0,10,10,23
2014,Accomack County,51001,American Indian and Alaska Native ,34,34,0,32,32,25
2014,Albemarle County,51003,American Indian and Alaska Native ,50,10,40,65,19,66
2014,Alleghany County,51005,American Indian and Alaska Native ,2,2,0,3,3,19
2014,Amelia County,51007,American Indian and Alaska Native ,45,45,0,27,27,19
2014,Amherst County,51009,American Indian and Alaska Native ,149,126,23,67,63,36
2014,Appomattox County,51011,American Indian and Alaska Native ,25,25,0,29,29,19
2014,Arlington County,51013,American Indian and Alaska Native ,353,119,234,123,81,100
2014,Augusta County,51015,American Indian and Alaska Native ,126,61,65,72,42,80
2014,Bath County,51017,American Indian and Alaska Native ,0,0,0,12,12,12
2014,Bedford County,51019,American Indian and Alaska Native ,72,56,16,41,39,26
2014,Bland County,51021,American Indian and Alaska Native ,0,0,0,17,17,17
2014,Botetourt County,51023,American Indian and Alaska Native ,32,32,0,26,26,25
2014,Brunswick County,51025,American Indian and Alaska Native ,31,31,0,42,42,19
2014,Buchanan County,51027,American Indian and Alaska Native ,0,0,0,22,22,22
2014,Buckingham County,51029,American Indian and Alaska Native ,0,0,0,19,19,19
2014,Campbell County,51031,American Indian and Alaska Native ,88,73,15,53,50,25
2014,Caroline County,51033,American Indian and Alaska Native ,56,51,5,40,39,9
2014,Carroll County,51035,American Indian and Alaska Native ,13,13,0,20,20,22
2014,Charles City County,51036,American Indian and Alaska Native ,156,137,19,27,27,12
2014,Charlotte County,51037,American Indian and Alaska Native ,9,9,0,12,12,19
2014,Chesterfield County,51041,American Indian and Alaska Native ,307,195,112,119,98,73
2014,Clarke County,51043,American Indian and Alaska Native ,34,28,6,30,29,9
2014,Craig County,51045,American Indian and Alaska Native ,0,0,0,17,17,17
2014,Culpeper County,51047,American Indian and Alaska Native ,27,9,18,33,12,30
2014,Cumberland County,51049,American Indian and Alaska Native ,13,13,0,24,24,17
2014,Dickenson County,51051,American Indian and Alaska Native ,0,0,0,19,19,19
2014,Dinwiddie County,51053,American Indian and Alaska Native ,0,0,0,22,22,22
2014,Essex County,51057,American Indian and Alaska Native ,17,17,0,9,9,19
2014,Fairfax County,51059,American Indian and Alaska Native ,1137,567,570,182,128,175
2014,Fauquier County,51061,American Indian and Alaska Native ,25,25,0,43,43,28
2014,Floyd County,51063,American Indian and Alaska Native ,0,0,0,19,19,19
2014,Fluvanna County,51065,American Indian and Alaska Native ,11,11,0,20,20,22
2014,Franklin County,51067,American Indian and Alaska Native ,29,12,17,31,14,27
2014,Frederick County,51069,American Indian and Alaska Native ,45,26,19,32,20,26
2014,Giles County,51071,American Indian and Alaska Native ,13,0,13,20,19,20
2014,Gloucester County,51073,American Indian and Alaska Native ,43,30,13,45,34,30
2014,Goochland County,51075,American Indian and Alaska Native ,17,17,0,27,27,22
2014,Grayson County,51077,American Indian and Alaska Native ,0,0,0,19,19,19
2014,Greene County,51079,American Indian and Alaska Native ,0,0,0,19,19,19
2014,Greensville County,51081,American Indian and Alaska Native ,12,0,12,15,19,15
2014,Halifax County,51083,American Indian and Alaska Native ,14,4,10,17,6,16
2014,Hanover County,51085,American Indian and Alaska Native ,35,10,25,35,13,30
2014,Henrico County,51087,American Indian and Alaska Native ,309,258,51,78,75,51
2014,Henry County,51089,American Indian and Alaska Native ,8,8,0,14,14,28
2014,Highland County,51091,American Indian and Alaska Native ,0,0,0,12,12,12
2014,Isle of Wight County,51093,American Indian and Alaska Native ,6,6,0,11,11,25
2014,James City County,51095,American Indian and Alaska Native ,87,60,27,44,38,30
2014,King and Queen County,51097,American Indian and Alaska Native ,6,6,0,10,10,17
2014,King George County,51099,American Indian and Alaska Native ,29,29,0,26,26,22
2014,King William County,51101,American Indian and Alaska Native ,83,69,14,31,30,13
2014,Lancaster County,51103,American Indian and Alaska Native ,0,0,0,19,19,19
2014,Lee County,51105,American Indian and Alaska Native ,4,4,0,20,20,22
2014,Loudoun County,51107,American Indian and Alaska Native ,295,241,54,67,58,30
2014,Louisa County,51109,American Indian and Alaska Native ,47,47,0,36,36,25
2014,Lunenburg County,51111,American Indian and Alaska Native ,0,0,0,19,19,19
2014,Madison County,51113,American Indian and Alaska Native ,0,0,0,19,19,19
2014,Mathews County,51115,American Indian and Alaska Native ,0,0,0,17,17,17
2014,Mecklenburg County,51117,American Indian and Alaska Native ,20,0,20,32,25,32
2014,Middlesex County,51119,American Indian and Alaska Native ,5,5,0,9,9,19
2014,Montgomery County,51121,American Indian and Alaska Native ,101,23,78,60,23,57
2014,Nelson County,51125,American Indian and Alaska Native ,18,10,8,23,17,15
2014,New Kent County,51127,American Indian and Alaska Native ,52,52,0,47,47,19
2014,Northampton County,51131,American Indian and Alaska Native ,12,12,0,23,23,19
2014,Northumberland County,51133,American Indian and Alaska Native ,0,0,0,19,19,19
2014,Nottoway County,51135,American Indian and Alaska Native ,25,0,25,37,19,37
2014,Orange County,51137,American Indian and Alaska Native ,22,22,0,36,36,25
2014,Page County,51139,American Indian and Alaska Native ,16,10,6,20,16,8
2014,Patrick County,51141,American Indian and Alaska Native ,0,0,0,19,19,19
2014,Pittsylvania County,51143,American Indian and Alaska Native ,19,0,19,25,28,25
2014,Powhatan County,51145,American Indian and Alaska Native ,13,13,0,16,16,22
2014,Prince Edward County,51147,American Indian and Alaska Native ,0,0,0,22,22,22
2014,Prince George County,51149,American Indian and Alaska Native ,77,44,33,53,42,33
2014,Prince William County,51153,American Indian and Alaska Native ,512,332,180,150,139,85
2014,Pulaski County,51155,American Indian and Alaska Native ,11,11,0,18,18,25
2014,Rappahannock County,51157,American Indian and Alaska Native ,2,0,2,4,17,4
2014,Richmond County,51159,American Indian and Alaska Native ,28,28,0,38,38,17
2014,Roanoke County,51161,American Indian and Alaska Native ,35,24,11,30,25,18
2014,Rockbridge County,51163,American Indian and Alaska Native ,29,29,0,31,31,22
2014,Rockingham County,51165,American Indian and Alaska Native ,54,26,28,58,33,47
2014,Russell County,51167,American Indian and Alaska Native ,8,8,0,15,15,22
2014,Scott County,51169,American Indian and Alaska Native ,0,0,0,22,22,22
2014,Shenandoah County,51171,American Indian and Alaska Native ,17,14,3,12,11,4
2014,Smyth County,51173,American Indian and Alaska Native ,11,11,0,20,20,25
2014,Southampton County,51175,American Indian and Alaska Native ,28,13,15,25,14,25
2014,Spotsylvania County,51177,American Indian and Alaska Native ,155,133,22,64,64,23
2014,Stafford County,51179,American Indian and Alaska Native ,242,135,107,82,67,54
2014,Surry County,51181,American Indian and Alaska Native ,0,0,0,17,17,17
2014,Sussex County,51183,American Indian and Alaska Native ,0,0,0,19,19,19
2014,Tazewell County,51185,American Indian and Alaska Native ,21,21,0,31,31,25
2014,Warren County,51187,American Indian and Alaska Native ,29,29,0,25,25,25
2014,Washington County,51191,American Indian and Alaska Native ,15,15,0,18,18,28
2014,Westmoreland County,51193,American Indian and Alaska Native ,2,2,0,5,5,19
2014,Wise County,51195,American Indian and Alaska Native ,11,11,0,15,15,25
2014,Wythe County,51197,American Indian and Alaska Native ,4,0,4,8,22,8
2014,York County,51199,American Indian and Alaska Native ,41,6,35,42,12,40
2014,Alexandria city,51510,American Indian and Alaska Native ,196,13,183,75,22,77
2014,Bristol city,51520,American Indian and Alaska Native ,24,0,24,25,19,25
2014,Buena Vista city,51530,American Indian and Alaska Native ,0,0,0,17,17,17
2014,Charlottesville city,51540,American Indian and Alaska Native ,60,18,42,49,21,44
2014,Chesapeake city,51550,American Indian and Alaska Native ,208,89,119,98,54,87
2014,Colonial Heights city,51570,American Indian and Alaska Native ,6,6,0,12,12,19
2014,Covington city,51580,American Indian and Alaska Native ,0,0,0,17,17,17
2014,Danville city,51590,American Indian and Alaska Native ,35,4,31,30,7,29
2014,Emporia city,51595,American Indian and Alaska Native ,6,6,0,12,12,17
2014,Fairfax city,51600,American Indian and Alaska Native ,67,33,34,57,40,36
2014,Falls Church city,51610,American Indian and Alaska Native ,0,0,0,19,19,19
2014,Franklin city,51620,American Indian and Alaska Native ,0,0,0,17,17,17
2014,Fredericksburg city,51630,American Indian and Alaska Native ,35,8,27,36,12,34
2014,Galax city,51640,American Indian and Alaska Native ,10,0,10,19,17,19
2014,Hampton city,51650,American Indian and Alaska Native ,214,174,40,72,67,43
2014,Harrisonburg city,51660,American Indian and Alaska Native ,31,31,0,31,31,28
2014,Hopewell city,51670,American Indian and Alaska Native ,21,0,21,37,22,37
2014,Lexington city,51678,American Indian and Alaska Native ,0,0,0,17,17,17
2014,Lynchburg city,51680,American Indian and Alaska Native ,54,0,54,49,28,49
2014,Manassas city,51683,American Indian and Alaska Native ,43,12,31,51,23,46
2014,Manassas Park city,51685,American Indian and Alaska Native ,45,0,45,50,19,50
2014,Martinsville city,51690,American Indian and Alaska Native ,30,0,30,43,19,43
2014,Newport News city,51700,American Indian and Alaska Native ,317,102,215,105,50,97
2014,Norfolk city,51710,American Indian and Alaska Native ,310,100,210,129,41,116
2014,Norton city,51720,American Indian and Alaska Native ,5,0,5,10,12,10
2014,Petersburg city,51730,American Indian and Alaska Native ,11,11,0,12,12,25
2014,Poquoson city,51735,American Indian and Alaska Native ,0,0,0,19,19,19
2014,Portsmouth city,51740,American Indian and Alaska Native ,93,84,9,43,43,16
2014,Radford city,51750,American Indian and Alaska Native ,0,0,0,19,19,19
2014,Richmond city,51760,American Indian and Alaska Native ,272,133,139,80,62,64
2014,Roanoke city,51770,American Indian and Alaska Native ,64,41,23,60,43,37
2014,Salem city,51775,American Indian and Alaska Native ,0,0,0,22,22,22
2014,Staunton city,51790,American Indian and Alaska Native ,0,0,0,22,22,22
2014,Suffolk city,51800,American Indian and Alaska Native ,9,9,0,13,13,28
2014,Virginia Beach city,51810,American Indian and Alaska Native ,722,529,193,175,180,92
2014,Waynesboro city,51820,American Indian and Alaska Native ,66,0,66,113,22,113
2014,Williamsburg city,51830,American Indian and Alaska Native ,7,0,7,11,19,11
2014,Winchester city,51840,American Indian and Alaska Native ,12,0,12,17,22,17
2015,Accomack County,51001,American Indian and Alaska Native ,29,29,0,32,32,25
2015,Albemarle County,51003,American Indian and Alaska Native ,82,16,66,59,22,60
2015,Alleghany County,51005,American Indian and Alaska Native ,3,3,0,5,5,19
2015,Amelia County,51007,American Indian and Alaska Native ,37,37,0,29,29,19
2015,Amherst County,51009,American Indian and Alaska Native ,75,58,17,57,46,31
2015,Appomattox County,51011,American Indian and Alaska Native ,21,21,0,26,26,19
2015,Arlington County,51013,American Indian and Alaska Native ,368,99,269,110,64,98
2015,Augusta County,51015,American Indian and Alaska Native ,126,72,54,74,46,69
2015,Bath County,51017,American Indian and Alaska Native ,0,0,0,12,12,12
2015,Bedford County,51019,American Indian and Alaska Native ,32,32,0,31,31,28
2015,Bland County,51021,American Indian and Alaska Native ,0,0,0,17,17,17
2015,Botetourt County,51023,American Indian and Alaska Native ,34,34,0,16,16,25
2015,Brunswick County,51025,American Indian and Alaska Native ,26,26,0,38,38,19
2015,Buchanan County,51027,American Indian and Alaska Native ,16,0,16,24,22,24
2015,Buckingham County,51029,American Indian and Alaska Native ,0,0,0,19,19,19
2015,Campbell County,51031,American Indian and Alaska Native ,78,56,22,67,66,33
2015,Caroline County,51033,American Indian and Alaska Native ,46,42,4,57,55,9
2015,Carroll County,51035,American Indian and Alaska Native ,4,4,0,8,8,22
2015,Charles City County,51036,American Indian and Alaska Native ,186,170,16,19,21,9
2015,Charlotte County,51037,American Indian and Alaska Native ,7,7,0,10,10,19
2015,Chesterfield County,51041,American Indian and Alaska Native ,385,247,138,138,117,76
2015,Clarke County,51043,American Indian and Alaska Native ,33,24,9,28,24,15
2015,Craig County,51045,American Indian and Alaska Native ,0,0,0,17,17,17
2015,Culpeper County,51047,American Indian and Alaska Native ,30,13,17,26,16,28
2015,Cumberland County,51049,American Indian and Alaska Native ,0,0,0,17,17,17
2015,Dickenson County,51051,American Indian and Alaska Native ,0,0,0,19,19,19
2015,Dinwiddie County,51053,American Indian and Alaska Native ,0,0,0,22,22,22
2015,Essex County,51057,American Indian and Alaska Native ,19,19,0,11,11,19
2015,Fairfax County,51059,American Indian and Alaska Native ,1022,506,516,267,136,206
2015,Fauquier County,51061,American Indian and Alaska Native ,27,27,0,26,26,28
2015,Floyd County,51063,American Indian and Alaska Native ,0,0,0,19,19,19
2015,Fluvanna County,51065,American Indian and Alaska Native ,0,0,0,22,22,22
2015,Franklin County,51067,American Indian and Alaska Native ,34,15,19,27,19,25
2015,Frederick County,51069,American Indian and Alaska Native ,51,31,20,28,21,24
2015,Giles County,51071,American Indian and Alaska Native ,28,0,28,42,19,42
2015,Gloucester County,51073,American Indian and Alaska Native ,43,33,10,53,50,19
2015,Goochland County,51075,American Indian and Alaska Native ,13,13,0,23,23,22
2015,Grayson County,51077,American Indian and Alaska Native ,0,0,0,19,19,19
2015,Greene County,51079,American Indian and Alaska Native ,0,0,0,19,19,19
2015,Greensville County,51081,American Indian and Alaska Native ,12,0,12,16,19,16
2015,Halifax County,51083,American Indian and Alaska Native ,12,3,9,16,5,15
2015,Hanover County,51085,American Indian and Alaska Native ,19,11,8,19,14,14
2015,Henrico County,51087,American Indian and Alaska Native ,337,303,34,72,71,30
2015,Henry County,51089,American Indian and Alaska Native ,7,7,0,11,11,28
2015,Highland County,51091,American Indian and Alaska Native ,0,0,0,12,12,12
2015,Isle of Wight County,51093,American Indian and Alaska Native ,9,9,0,12,12,25
2015,James City County,51095,American Indian and Alaska Native ,90,56,34,47,47,33
2015,King and Queen County,51097,American Indian and Alaska Native ,6,6,0,13,13,17
2015,King George County,51099,American Indian and Alaska Native ,12,12,0,21,21,22
2015,King William County,51101,American Indian and Alaska Native ,115,101,14,36,37,15
2015,Lancaster County,51103,American Indian and Alaska Native ,0,0,0,19,19,19
2015,Lee County,51105,American Indian and Alaska Native ,4,4,0,23,23,22
2015,Loudoun County,51107,American Indian and Alaska Native ,291,240,51,70,66,28
2015,Louisa County,51109,American Indian and Alaska Native ,57,57,0,34,34,25
2015,Lunenburg County,51111,American Indian and Alaska Native ,0,0,0,19,19,19
2015,Madison County,51113,American Indian and Alaska Native ,0,0,0,19,19,19
2015,Mathews County,51115,American Indian and Alaska Native ,12,12,0,19,19,17
2015,Mecklenburg County,51117,American Indian and Alaska Native ,17,4,13,20,7,19
2015,Middlesex County,51119,American Indian and Alaska Native ,14,14,0,16,16,19
2015,Montgomery County,51121,American Indian and Alaska Native ,99,23,76,60,30,49
2015,Nelson County,51125,American Indian and Alaska Native ,24,13,11,31,22,21
2015,New Kent County,51127,American Indian and Alaska Native ,66,65,1,45,45,2
2015,Northampton County,51131,American Indian and Alaska Native ,7,7,0,16,16,19
2015,Northumberland County,51133,American Indian and Alaska Native ,65,65,0,95,95,19
2015,Nottoway County,51135,American Indian and Alaska Native ,16,0,16,24,19,24
2015,Orange County,51137,American Indian and Alaska Native ,30,30,0,52,52,25
2015,Page County,51139,American Indian and Alaska Native ,20,10,10,24,16,17
2015,Patrick County,51141,American Indian and Alaska Native ,0,0,0,19,19,19
2015,Pittsylvania County,51143,American Indian and Alaska Native ,51,32,19,43,40,21
2015,Powhatan County,51145,American Indian and Alaska Native ,11,11,0,13,13,22
2015,Prince Edward County,51147,American Indian and Alaska Native ,29,29,0,45,45,22
2015,Prince George County,51149,American Indian and Alaska Native ,37,17,20,42,32,20
2015,Prince William County,51153,American Indian and Alaska Native ,483,323,160,118,108,70
2015,Pulaski County,51155,American Indian and Alaska Native ,8,8,0,17,17,25
2015,Rappahannock County,51157,American Indian and Alaska Native ,1,0,1,5,17,5
2015,Richmond County,51159,American Indian and Alaska Native ,12,12,0,20,20,17
2015,Roanoke County,51161,American Indian and Alaska Native ,37,23,14,36,28,23
2015,Rockbridge County,51163,American Indian and Alaska Native ,24,20,4,35,35,6
2015,Rockingham County,51165,American Indian and Alaska Native ,47,47,0,41,41,28
2015,Russell County,51167,American Indian and Alaska Native ,9,9,0,12,12,22
2015,Scott County,51169,American Indian and Alaska Native ,0,0,0,22,22,22
2015,Shenandoah County,51171,American Indian and Alaska Native ,8,5,3,10,9,5
2015,Smyth County,51173,American Indian and Alaska Native ,14,14,0,23,23,25
2015,Southampton County,51175,American Indian and Alaska Native ,13,13,0,16,16,19
2015,Spotsylvania County,51177,American Indian and Alaska Native ,133,113,20,54,50,21
2015,Stafford County,51179,American Indian and Alaska Native ,214,124,90,72,58,52
2015,Surry County,51181,American Indian and Alaska Native ,0,0,0,17,17,17
2015,Sussex County,51183,American Indian and Alaska Native ,0,0,0,19,19,19
2015,Tazewell County,51185,American Indian and Alaska Native ,14,14,0,22,22,25
2015,Warren County,51187,American Indian and Alaska Native ,31,31,0,25,25,25
2015,Washington County,51191,American Indian and Alaska Native ,17,17,0,20,20,28
2015,Westmoreland County,51193,American Indian and Alaska Native ,1,1,0,5,5,19
2015,Wise County,51195,American Indian and Alaska Native ,5,5,0,8,8,25
2015,Wythe County,51197,American Indian and Alaska Native ,5,0,5,8,22,8
2015,York County,51199,American Indian and Alaska Native ,25,10,15,30,17,24
2015,Alexandria city,51510,American Indian and Alaska Native ,165,26,139,80,35,73
2015,Bristol city,51520,American Indian and Alaska Native ,31,0,31,30,19,30
2015,Buena Vista city,51530,American Indian and Alaska Native ,0,0,0,17,17,17
2015,Charlottesville city,51540,American Indian and Alaska Native ,45,18,27,38,21,37
2015,Chesapeake city,51550,American Indian and Alaska Native ,172,129,43,67,66,40
2015,Colonial Heights city,51570,American Indian and Alaska Native ,32,32,0,31,31,19
2015,Covington city,51580,American Indian and Alaska Native ,0,0,0,17,17,17
2015,Danville city,51590,American Indian and Alaska Native ,40,6,34,28,11,28
2015,Emporia city,51595,American Indian and Alaska Native ,7,7,0,11,11,17
2015,Fairfax city,51600,American Indian and Alaska Native ,32,4,28,33,9,32
2015,Falls Church city,51610,American Indian and Alaska Native ,0,0,0,19,19,19
2015,Franklin city,51620,American Indian and Alaska Native ,0,0,0,17,17,17
2015,Fredericksburg city,51630,American Indian and Alaska Native ,28,14,14,26,19,22
2015,Galax city,51640,American Indian and Alaska Native ,0,0,0,17,17,17
2015,Hampton city,51650,American Indian and Alaska Native ,128,100,28,63,61,32
2015,Harrisonburg city,51660,American Indian and Alaska Native ,18,18,0,30,30,28
2015,Hopewell city,51670,American Indian and Alaska Native ,25,0,25,43,22,43
2015,Lexington city,51678,American Indian and Alaska Native ,0,0,0,17,17,17
2015,Lynchburg city,51680,American Indian and Alaska Native ,64,0,64,41,28,41
2015,Manassas city,51683,American Indian and Alaska Native ,49,13,36,62,21,56
2015,Manassas Park city,51685,American Indian and Alaska Native ,36,0,36,37,19,37
2015,Martinsville city,51690,American Indian and Alaska Native ,19,0,19,30,19,30
2015,Newport News city,51700,American Indian and Alaska Native ,265,82,183,103,52,92
2015,Norfolk city,51710,American Indian and Alaska Native ,412,143,269,132,50,119
2015,Norton city,51720,American Indian and Alaska Native ,5,0,5,9,12,9
2015,Petersburg city,51730,American Indian and Alaska Native ,12,12,0,15,15,25
2015,Poquoson city,51735,American Indian and Alaska Native ,0,0,0,19,19,19
2015,Portsmouth city,51740,American Indian and Alaska Native ,111,102,9,44,38,20
2015,Radford city,51750,American Indian and Alaska Native ,0,0,0,19,19,19
2015,Richmond city,51760,American Indian and Alaska Native ,266,97,169,88,44,77
2015,Roanoke city,51770,American Indian and Alaska Native ,57,31,26,52,35,42
2015,Salem city,51775,American Indian and Alaska Native ,18,18,0,30,30,22
2015,Staunton city,51790,American Indian and Alaska Native ,8,0,8,12,22,12
2015,Suffolk city,51800,American Indian and Alaska Native ,44,30,14,33,24,22
2015,Virginia Beach city,51810,American Indian and Alaska Native ,673,472,201,187,174,90
2015,Waynesboro city,51820,American Indian and Alaska Native ,0,0,0,22,22,22
2015,Williamsburg city,51830,American Indian and Alaska Native ,3,0,3,7,19,7
2015,Winchester city,51840,American Indian and Alaska Native ,28,0,28,32,22,32
2016,Accomack County,51001,American Indian and Alaska Native ,48,48,0,42,42,25
2016,Albemarle County,51003,American Indian and Alaska Native ,76,18,58,44,17,41
2016,Alleghany County,51005,American Indian and Alaska Native ,2,2,0,3,3,19
2016,Amelia County,51007,American Indian and Alaska Native ,0,0,0,19,19,19
2016,Amherst County,51009,American Indian and Alaska Native ,54,54,0,47,47,25
2016,Appomattox County,51011,American Indian and Alaska Native ,2,2,0,4,4,19
2016,Arlington County,51013,American Indian and Alaska Native ,421,118,303,168,89,131
2016,Augusta County,51015,American Indian and Alaska Native ,58,58,0,36,36,28
2016,Bath County,51017,American Indian and Alaska Native ,0,0,0,12,12,12
2016,Bedford County,51019,American Indian and Alaska Native ,47,47,0,38,38,28
2016,Bland County,51021,American Indian and Alaska Native ,0,0,0,17,17,17
2016,Botetourt County,51023,American Indian and Alaska Native ,32,32,0,22,22,25
2016,Brunswick County,51025,American Indian and Alaska Native ,23,23,0,32,32,19
2016,Buchanan County,51027,American Indian and Alaska Native ,16,0,16,25,22,25
2016,Buckingham County,51029,American Indian and Alaska Native ,0,0,0,19,19,19
2016,Campbell County,51031,American Indian and Alaska Native ,45,45,0,42,42,28
2016,Caroline County,51033,American Indian and Alaska Native ,20,12,8,23,17,13
2016,Carroll County,51035,American Indian and Alaska Native ,7,7,0,12,12,22
2016,Charles City County,51036,American Indian and Alaska Native ,182,175,7,20,17,8
2016,Charlotte County,51037,American Indian and Alaska Native ,18,18,0,19,19,19
2016,Chesterfield County,51041,American Indian and Alaska Native ,366,242,124,121,103,68
2016,Clarke County,51043,American Indian and Alaska Native ,33,22,11,25,22,16
2016,Craig County,51045,American Indian and Alaska Native ,0,0,0,17,17,17
2016,Culpeper County,51047,American Indian and Alaska Native ,55,32,23,48,36,27
2016,Cumberland County,51049,American Indian and Alaska Native ,0,0,0,17,17,17
2016,Dickenson County,51051,American Indian and Alaska Native ,0,0,0,19,19,19
2016,Dinwiddie County,51053,American Indian and Alaska Native ,0,0,0,22,22,22
2016,Essex County,51057,American Indian and Alaska Native ,19,19,0,13,13,19
2016,Fairfax County,51059,American Indian and Alaska Native ,977,490,487,206,149,163
2016,Fauquier County,51061,American Indian and Alaska Native ,41,41,0,28,28,28
2016,Floyd County,51063,American Indian and Alaska Native ,40,40,0,58,58,19
2016,Fluvanna County,51065,American Indian and Alaska Native ,0,0,0,22,22,22
2016,Franklin County,51067,American Indian and Alaska Native ,27,6,21,23,10,24
2016,Frederick County,51069,American Indian and Alaska Native ,91,46,45,40,26,37
2016,Giles County,51071,American Indian and Alaska Native ,0,0,0,19,19,19
2016,Gloucester County,51073,American Indian and Alaska Native ,42,33,9,44,42,14
2016,Goochland County,51075,American Indian and Alaska Native ,8,8,0,15,15,22
2016,Grayson County,51077,American Indian and Alaska Native ,0,0,0,19,19,19
2016,Greene County,51079,American Indian and Alaska Native ,0,0,0,19,19,19
2016,Greensville County,51081,American Indian and Alaska Native ,10,0,10,12,19,12
2016,Halifax County,51083,American Indian and Alaska Native ,26,0,26,29,25,29
2016,Hanover County,51085,American Indian and Alaska Native ,43,22,21,35,25,25
2016,Henrico County,51087,American Indian and Alaska Native ,317,233,84,88,91,62
2016,Henry County,51089,American Indian and Alaska Native ,6,6,0,10,10,28
2016,Highland County,51091,American Indian and Alaska Native ,0,0,0,12,12,12
2016,Isle of Wight County,51093,American Indian and Alaska Native ,11,11,0,14,14,25
2016,James City County,51095,American Indian and Alaska Native ,87,54,33,40,45,32
2016,King and Queen County,51097,American Indian and Alaska Native ,6,6,0,12,12,17
2016,King George County,51099,American Indian and Alaska Native ,24,24,0,32,32,22
2016,King William County,51101,American Indian and Alaska Native ,107,104,3,36,35,5
2016,Lancaster County,51103,American Indian and Alaska Native ,0,0,0,19,19,19
2016,Lee County,51105,American Indian and Alaska Native ,0,0,0,22,22,22
2016,Loudoun County,51107,American Indian and Alaska Native ,350,256,94,76,60,48
2016,Louisa County,51109,American Indian and Alaska Native ,48,48,0,35,35,25
2016,Lunenburg County,51111,American Indian and Alaska Native ,0,0,0,19,19,19
2016,Madison County,51113,American Indian and Alaska Native ,0,0,0,19,19,19
2016,Mathews County,51115,American Indian and Alaska Native ,10,10,0,17,17,17
2016,Mecklenburg County,51117,American Indian and Alaska Native ,22,10,12,22,11,20
2016,Middlesex County,51119,American Indian and Alaska Native ,16,16,0,19,19,19
2016,Montgomery County,51121,American Indian and Alaska Native ,71,22,49,54,22,48
2016,Nelson County,51125,American Indian and Alaska Native ,17,17,0,27,27,19
2016,New Kent County,51127,American Indian and Alaska Native ,78,76,2,46,46,3
2016,Northampton County,51131,American Indian and Alaska Native ,14,14,0,17,17,19
2016,Northumberland County,51133,American Indian and Alaska Native ,60,60,0,106,106,19
2016,Nottoway County,51135,American Indian and Alaska Native ,7,0,7,13,19,13
2016,Orange County,51137,American Indian and Alaska Native ,27,27,0,30,30,25
2016,Page County,51139,American Indian and Alaska Native ,14,8,6,15,14,9
2016,Patrick County,51141,American Indian and Alaska Native ,0,0,0,19,19,19
2016,Pittsylvania County,51143,American Indian and Alaska Native ,35,29,6,30,31,9
2016,Powhatan County,51145,American Indian and Alaska Native ,0,0,0,22,22,22
2016,Prince Edward County,51147,American Indian and Alaska Native ,39,39,0,57,57,22
2016,Prince George County,51149,American Indian and Alaska Native ,56,16,40,48,23,43
2016,Prince William County,51153,American Indian and Alaska Native ,416,301,115,108,96,76
2016,Pulaski County,51155,American Indian and Alaska Native ,13,13,0,25,25,25
2016,Rappahannock County,51157,American Indian and Alaska Native ,1,0,1,4,17,4
2016,Richmond County,51159,American Indian and Alaska Native ,10,10,0,16,16,17
2016,Roanoke County,51161,American Indian and Alaska Native ,46,35,11,33,29,15
2016,Rockbridge County,51163,American Indian and Alaska Native ,21,18,3,35,34,6
2016,Rockingham County,51165,American Indian and Alaska Native ,39,39,0,35,35,28
2016,Russell County,51167,American Indian and Alaska Native ,10,10,0,12,12,22
2016,Scott County,51169,American Indian and Alaska Native ,0,0,0,22,22,22
2016,Shenandoah County,51171,American Indian and Alaska Native ,12,9,3,12,11,5
2016,Smyth County,51173,American Indian and Alaska Native ,20,20,0,25,25,25
2016,Southampton County,51175,American Indian and Alaska Native ,27,27,0,23,23,19
2016,Spotsylvania County,51177,American Indian and Alaska Native ,149,124,25,52,49,24
2016,Stafford County,51179,American Indian and Alaska Native ,206,120,86,74,51,59
2016,Surry County,51181,American Indian and Alaska Native ,0,0,0,17,17,17
2016,Sussex County,51183,American Indian and Alaska Native ,0,0,0,19,19,19
2016,Tazewell County,51185,American Indian and Alaska Native ,29,14,15,32,22,24
2016,Warren County,51187,American Indian and Alaska Native ,30,30,0,27,27,25
2016,Washington County,51191,American Indian and Alaska Native ,20,20,0,17,17,28
2016,Westmoreland County,51193,American Indian and Alaska Native ,1,1,0,3,3,19
2016,Wise County,51195,American Indian and Alaska Native ,4,4,0,6,6,25
2016,Wythe County,51197,American Indian and Alaska Native ,7,0,7,14,22,14
2016,York County,51199,American Indian and Alaska Native ,20,7,13,24,11,22
2016,Alexandria city,51510,American Indian and Alaska Native ,120,11,109,79,17,81
2016,Bristol city,51520,American Indian and Alaska Native ,22,0,22,28,19,28
2016,Buena Vista city,51530,American Indian and Alaska Native ,0,0,0,17,17,17
2016,Charlottesville city,51540,American Indian and Alaska Native ,55,18,37,45,20,44
2016,Chesapeake city,51550,American Indian and Alaska Native ,155,93,62,81,58,67
2016,Colonial Heights city,51570,American Indian and Alaska Native ,33,33,0,34,34,19
2016,Covington city,51580,American Indian and Alaska Native ,0,0,0,17,17,17
2016,Danville city,51590,American Indian and Alaska Native ,52,14,38,31,16,31
2016,Emporia city,51595,American Indian and Alaska Native ,0,0,0,17,17,17
2016,Fairfax city,51600,American Indian and Alaska Native ,29,4,25,31,7,30
2016,Falls Church city,51610,American Indian and Alaska Native ,0,0,0,19,19,19
2016,Franklin city,51620,American Indian and Alaska Native ,0,0,0,17,17,17
2016,Fredericksburg city,51630,American Indian and Alaska Native ,28,15,13,31,21,22
2016,Galax city,51640,American Indian and Alaska Native ,0,0,0,17,17,17
2016,Hampton city,51650,American Indian and Alaska Native ,149,110,39,54,56,42
2016,Harrisonburg city,51660,American Indian and Alaska Native ,21,21,0,32,32,28
2016,Hopewell city,51670,American Indian and Alaska Native ,25,0,25,39,22,39
2016,Lexington city,51678,American Indian and Alaska Native ,0,0,0,17,17,17
2016,Lynchburg city,51680,American Indian and Alaska Native ,47,0,47,30,28,30
2016,Manassas city,51683,American Indian and Alaska Native ,84,36,48,79,32,71
2016,Manassas Park city,51685,American Indian and Alaska Native ,13,0,13,21,19,21
2016,Martinsville city,51690,American Indian and Alaska Native ,35,0,35,52,19,52
2016,Newport News city,51700,American Indian and Alaska Native ,232,94,138,79,48,59
2016,Norfolk city,51710,American Indian and Alaska Native ,451,176,275,119,71,105
2016,Norton city,51720,American Indian and Alaska Native ,3,0,3,5,12,5
2016,Petersburg city,51730,American Indian and Alaska Native ,31,17,14,25,26,15
2016,Poquoson city,51735,American Indian and Alaska Native ,3,3,0,5,5,19
2016,Portsmouth city,51740,American Indian and Alaska Native ,124,109,15,40,43,19
2016,Radford city,51750,American Indian and Alaska Native ,0,0,0,19,19,19
2016,Richmond city,51760,American Indian and Alaska Native ,307,90,217,101,44,103
2016,Roanoke city,51770,American Indian and Alaska Native ,68,54,14,65,62,17
2016,Salem city,51775,American Indian and Alaska Native ,20,20,0,36,36,22
2016,Staunton city,51790,American Indian and Alaska Native ,20,0,20,30,22,30
2016,Suffolk city,51800,American Indian and Alaska Native ,58,44,14,36,29,23
2016,Virginia Beach city,51810,American Indian and Alaska Native ,515,279,236,134,111,104
2016,Waynesboro city,51820,American Indian and Alaska Native ,0,0,0,22,22,22
2016,Williamsburg city,51830,American Indian and Alaska Native ,15,0,15,19,19,19
2016,Winchester city,51840,American Indian and Alaska Native ,67,0,67,53,22,53
2017,Accomack County,51001,American Indian and Alaska Native ,37,37,0,40,40,25
2017,Albemarle County,51003,American Indian and Alaska Native ,81,26,55,48,25,48
2017,Alleghany County,51005,American Indian and Alaska Native ,1,1,0,3,3,19
2017,Amelia County,51007,American Indian and Alaska Native ,0,0,0,19,19,19
2017,Amherst County,51009,American Indian and Alaska Native ,51,51,0,40,40,25
2017,Appomattox County,51011,American Indian and Alaska Native ,1,1,0,3,3,19
2017,Arlington County,51013,American Indian and Alaska Native ,463,121,342,143,81,112
2017,Augusta County,51015,American Indian and Alaska Native ,54,54,0,41,41,28
2017,Bath County,51017,American Indian and Alaska Native ,0,0,0,12,12,12
2017,Bedford County,51019,American Indian and Alaska Native ,84,84,0,52,52,28
2017,Bland County,51021,American Indian and Alaska Native ,0,0,0,17,17,17
2017,Botetourt County,51023,American Indian and Alaska Native ,43,43,0,24,24,25
2017,Brunswick County,51025,American Indian and Alaska Native ,22,22,0,33,33,19
2017,Buchanan County,51027,American Indian and Alaska Native ,14,0,14,24,22,24
2017,Buckingham County,51029,American Indian and Alaska Native ,26,0,26,39,19,39
2017,Campbell County,51031,American Indian and Alaska Native ,71,62,9,48,51,13
2017,Caroline County,51033,American Indian and Alaska Native ,28,21,7,23,21,8
2017,Carroll County,51035,American Indian and Alaska Native ,30,30,0,37,37,22
2017,Charles City County,51036,American Indian and Alaska Native ,197,182,15,21,18,10
2017,Charlotte County,51037,American Indian and Alaska Native ,15,15,0,20,20,19
2017,Chesterfield County,51041,American Indian and Alaska Native ,408,248,160,119,106,82
2017,Clarke County,51043,American Indian and Alaska Native ,30,17,13,28,21,19
2017,Craig County,51045,American Indian and Alaska Native ,0,0,0,17,17,17
2017,Culpeper County,51047,American Indian and Alaska Native ,51,29,22,45,33,28
2017,Cumberland County,51049,American Indian and Alaska Native ,16,16,0,27,27,17
2017,Dickenson County,51051,American Indian and Alaska Native ,0,0,0,19,19,19
2017,Dinwiddie County,51053,American Indian and Alaska Native ,3,0,3,6,22,6
2017,Essex County,51057,American Indian and Alaska Native ,29,29,0,45,45,19
2017,Fairfax County,51059,American Indian and Alaska Native ,1024,537,487,182,122,173
2017,Fauquier County,51061,American Indian and Alaska Native ,45,45,0,28,28,28
2017,Floyd County,51063,American Indian and Alaska Native ,26,26,0,39,39,19
2017,Fluvanna County,51065,American Indian and Alaska Native ,0,0,0,22,22,22
2017,Franklin County,51067,American Indian and Alaska Native ,32,12,20,18,20,19
2017,Frederick County,51069,American Indian and Alaska Native ,98,61,37,45,38,37
2017,Giles County,51071,American Indian and Alaska Native ,0,0,0,19,19,19
2017,Gloucester County,51073,American Indian and Alaska Native ,87,61,26,67,61,44
2017,Goochland County,51075,American Indian and Alaska Native ,12,12,0,20,20,22
2017,Grayson County,51077,American Indian and Alaska Native ,0,0,0,19,19,19
2017,Greene County,51079,American Indian and Alaska Native ,34,34,0,52,52,19
2017,Greensville County,51081,American Indian and Alaska Native ,5,0,5,8,19,8
2017,Halifax County,51083,American Indian and Alaska Native ,55,36,19,51,50,21
2017,Hanover County,51085,American Indian and Alaska Native ,34,23,11,31,22,20
2017,Henrico County,51087,American Indian and Alaska Native ,295,188,107,106,77,73
2017,Henry County,51089,American Indian and Alaska Native ,22,22,0,29,29,28
2017,Highland County,51091,American Indian and Alaska Native ,0,0,0,12,12,12
2017,Isle of Wight County,51093,American Indian and Alaska Native ,28,28,0,22,22,25
2017,James City County,51095,American Indian and Alaska Native ,33,33,0,41,41,28
2017,King and Queen County,51097,American Indian and Alaska Native ,12,12,0,15,15,17
2017,King George County,51099,American Indian and Alaska Native ,43,43,0,33,33,22
2017,King William County,51101,American Indian and Alaska Native ,77,72,5,31,29,7
2017,Lancaster County,51103,American Indian and Alaska Native ,0,0,0,19,19,19
2017,Lee County,51105,American Indian and Alaska Native ,0,0,0,22,22,22
2017,Loudoun County,51107,American Indian and Alaska Native ,404,332,72,75,60,47
2017,Louisa County,51109,American Indian and Alaska Native ,47,47,0,32,32,25
2017,Lunenburg County,51111,American Indian and Alaska Native ,0,0,0,19,19,19
2017,Madison County,51113,American Indian and Alaska Native ,0,0,0,19,19,19
2017,Mathews County,51115,American Indian and Alaska Native ,12,12,0,20,20,17
2017,Mecklenburg County,51117,American Indian and Alaska Native ,44,31,13,39,32,20
2017,Middlesex County,51119,American Indian and Alaska Native ,19,10,9,20,16,14
2017,Montgomery County,51121,American Indian and Alaska Native ,112,49,63,55,47,51
2017,Nelson County,51125,American Indian and Alaska Native ,11,11,0,20,20,19
2017,New Kent County,51127,American Indian and Alaska Native ,102,100,2,52,52,4
2017,Northampton County,51131,American Indian and Alaska Native ,19,19,0,21,21,19
2017,Northumberland County,51133,American Indian and Alaska Native ,32,32,0,59,59,19
2017,Nottoway County,51135,American Indian and Alaska Native ,5,0,5,10,19,10
2017,Orange County,51137,American Indian and Alaska Native ,16,16,0,21,21,25
2017,Page County,51139,American Indian and Alaska Native ,14,9,5,15,14,7
2017,Patrick County,51141,American Indian and Alaska Native ,14,11,3,19,17,9
2017,Pittsylvania County,51143,American Indian and Alaska Native ,23,23,0,26,26,28
2017,Powhatan County,51145,American Indian and Alaska Native ,17,17,0,29,29,22
2017,Prince Edward County,51147,American Indian and Alaska Native ,47,47,0,58,58,22
2017,Prince George County,51149,American Indian and Alaska Native ,27,20,7,34,26,15
2017,Prince William County,51153,American Indian and Alaska Native ,484,329,155,130,110,79
2017,Pulaski County,51155,American Indian and Alaska Native ,10,10,0,16,16,25
2017,Rappahannock County,51157,American Indian and Alaska Native ,0,0,0,17,17,17
2017,Richmond County,51159,American Indian and Alaska Native ,9,9,0,14,14,17
2017,Roanoke County,51161,American Indian and Alaska Native ,35,27,8,31,31,10
2017,Rockbridge County,51163,American Indian and Alaska Native ,30,11,19,24,18,19
2017,Rockingham County,51165,American Indian and Alaska Native ,50,50,0,50,50,28
2017,Russell County,51167,American Indian and Alaska Native ,6,6,0,12,12,22
2017,Scott County,51169,American Indian and Alaska Native ,0,0,0,22,22,22
2017,Shenandoah County,51171,American Indian and Alaska Native ,48,36,12,45,40,19
2017,Smyth County,51173,American Indian and Alaska Native ,0,0,0,25,25,25
2017,Southampton County,51175,American Indian and Alaska Native ,36,36,0,30,30,19
2017,Spotsylvania County,51177,American Indian and Alaska Native ,137,117,20,55,47,26
2017,Stafford County,51179,American Indian and Alaska Native ,202,175,27,67,69,30
2017,Surry County,51181,American Indian and Alaska Native ,0,0,0,17,17,17
2017,Sussex County,51183,American Indian and Alaska Native ,0,0,0,19,19,19
2017,Tazewell County,51185,American Indian and Alaska Native ,69,54,15,51,53,21
2017,Warren County,51187,American Indian and Alaska Native ,20,20,0,23,23,25
2017,Washington County,51191,American Indian and Alaska Native ,7,7,0,10,10,28
2017,Westmoreland County,51193,American Indian and Alaska Native ,0,0,0,19,19,19
2017,Wise County,51195,American Indian and Alaska Native ,7,7,0,11,11,25
2017,Wythe County,51197,American Indian and Alaska Native ,5,0,5,11,22,11
2017,York County,51199,American Indian and Alaska Native ,0,0,0,28,28,28
2017,Alexandria city,51510,American Indian and Alaska Native ,141,58,83,97,67,72
2017,Bristol city,51520,American Indian and Alaska Native ,0,0,0,19,19,19
2017,Buena Vista city,51530,American Indian and Alaska Native ,0,0,0,17,17,17
2017,Charlottesville city,51540,American Indian and Alaska Native ,45,7,38,60,11,58
2017,Chesapeake city,51550,American Indian and Alaska Native ,190,149,41,86,81,50
2017,Colonial Heights city,51570,American Indian and Alaska Native ,17,17,0,21,21,19
2017,Covington city,51580,American Indian and Alaska Native ,0,0,0,17,17,17
2017,Danville city,51590,American Indian and Alaska Native ,32,13,19,23,13,22
2017,Emporia city,51595,American Indian and Alaska Native ,0,0,0,17,17,17
2017,Fairfax city,51600,American Indian and Alaska Native ,15,0,15,21,22,21
2017,Falls Church city,51610,American Indian and Alaska Native ,0,0,0,19,19,19
2017,Franklin city,51620,American Indian and Alaska Native ,0,0,0,17,17,17
2017,Fredericksburg city,51630,American Indian and Alaska Native ,24,11,13,27,17,22
2017,Galax city,51640,American Indian and Alaska Native ,0,0,0,17,17,17
2017,Hampton city,51650,American Indian and Alaska Native ,179,156,23,105,100,28
2017,Harrisonburg city,51660,American Indian and Alaska Native ,21,21,0,31,31,28
2017,Hopewell city,51670,American Indian and Alaska Native ,0,0,0,22,22,22
2017,Lexington city,51678,American Indian and Alaska Native ,0,0,0,17,17,17
2017,Lynchburg city,51680,American Indian and Alaska Native ,47,23,24,31,31,24
2017,Manassas city,51683,American Indian and Alaska Native ,51,16,35,57,11,55
2017,Manassas Park city,51685,American Indian and Alaska Native ,34,0,34,33,19,33
2017,Martinsville city,51690,American Indian and Alaska Native ,36,0,36,50,19,50
2017,Newport News city,51700,American Indian and Alaska Native ,171,69,102,66,56,43
2017,Norfolk city,51710,American Indian and Alaska Native ,462,198,264,140,90,130
2017,Norton city,51720,American Indian and Alaska Native ,3,0,3,6,12,6
2017,Petersburg city,51730,American Indian and Alaska Native ,27,12,15,23,19,10
2017,Poquoson city,51735,American Indian and Alaska Native ,4,4,0,8,8,19
2017,Portsmouth city,51740,American Indian and Alaska Native ,148,112,36,53,54,31
2017,Radford city,51750,American Indian and Alaska Native ,0,0,0,19,19,19
2017,Richmond city,51760,American Indian and Alaska Native ,300,105,195,97,56,91
2017,Roanoke city,51770,American Indian and Alaska Native ,61,41,20,25,26,25
2017,Salem city,51775,American Indian and Alaska Native ,10,10,0,20,20,22
2017,Staunton city,51790,American Indian and Alaska Native ,10,4,6,12,7,8
2017,Suffolk city,51800,American Indian and Alaska Native ,56,43,13,30,23,19
2017,Virginia Beach city,51810,American Indian and Alaska Native ,433,222,211,128,79,104
2017,Waynesboro city,51820,American Indian and Alaska Native ,69,14,55,62,22,57
2017,Williamsburg city,51830,American Indian and Alaska Native ,27,0,27,40,19,40
2017,Winchester city,51840,American Indian and Alaska Native ,63,0,63,59,22,59
2018,Accomack County,51001,American Indian and Alaska Native ,49,49,0,32,32,25
2018,Albemarle County,51003,American Indian and Alaska Native ,70,21,49,44,21,38
2018,Alleghany County,51005,American Indian and Alaska Native ,0,0,0,19,19,19
2018,Amelia County,51007,American Indian and Alaska Native ,0,0,0,19,19,19
2018,Amherst County,51009,American Indian and Alaska Native ,39,31,8,28,27,13
2018,Appomattox County,51011,American Indian and Alaska Native ,0,0,0,19,19,19
2018,Arlington County,51013,American Indian and Alaska Native ,428,77,351,134,71,138
2018,Augusta County,51015,American Indian and Alaska Native ,41,41,0,37,37,28
2018,Bath County,51017,American Indian and Alaska Native ,0,0,0,12,12,12
2018,Bedford County,51019,American Indian and Alaska Native ,39,39,0,36,36,28
2018,Bland County,51021,American Indian and Alaska Native ,0,0,0,17,17,17
2018,Botetourt County,51023,American Indian and Alaska Native ,33,33,0,23,23,25
2018,Brunswick County,51025,American Indian and Alaska Native ,14,14,0,22,22,19
2018,Buchanan County,51027,American Indian and Alaska Native ,4,0,4,7,22,7
2018,Buckingham County,51029,American Indian and Alaska Native ,42,5,37,43,10,41
2018,Campbell County,51031,American Indian and Alaska Native ,49,37,12,34,33,16
2018,Caroline County,51033,American Indian and Alaska Native ,20,7,13,21,10,19
2018,Carroll County,51035,American Indian and Alaska Native ,47,47,0,50,50,22
2018,Charles City County,51036,American Indian and Alaska Native ,192,178,14,24,21,10
2018,Charlotte County,51037,American Indian and Alaska Native ,10,10,0,12,12,19
2018,Chesterfield County,51041,American Indian and Alaska Native ,449,336,113,125,125,60
2018,Clarke County,51043,American Indian and Alaska Native ,4,4,0,5,5,19
2018,Craig County,51045,American Indian and Alaska Native ,0,0,0,17,17,17
2018,Culpeper County,51047,American Indian and Alaska Native ,57,35,22,53,44,28
2018,Cumberland County,51049,American Indian and Alaska Native ,16,16,0,26,26,17
2018,Dickenson County,51051,American Indian and Alaska Native ,0,0,0,19,19,19
2018,Dinwiddie County,51053,American Indian and Alaska Native ,3,0,3,5,22,5
2018,Essex County,51057,American Indian and Alaska Native ,19,19,0,28,28,19
2018,Fairfax County,51059,American Indian and Alaska Native ,1029,526,503,183,125,147
2018,Fauquier County,51061,American Indian and Alaska Native ,48,48,0,23,23,28
2018,Floyd County,51063,American Indian and Alaska Native ,70,70,0,73,73,19
2018,Fluvanna County,51065,American Indian and Alaska Native ,0,0,0,22,22,22
2018,Franklin County,51067,American Indian and Alaska Native ,35,13,22,17,19,20
2018,Frederick County,51069,American Indian and Alaska Native ,92,66,26,70,68,39
2018,Giles County,51071,American Indian and Alaska Native ,0,0,0,19,19,19
2018,Gloucester County,51073,American Indian and Alaska Native ,81,52,29,67,59,43
2018,Goochland County,51075,American Indian and Alaska Native ,10,10,0,16,16,22
2018,Grayson County,51077,American Indian and Alaska Native ,0,0,0,19,19,19
2018,Greene County,51079,American Indian and Alaska Native ,35,35,0,54,54,19
2018,Greensville County,51081,American Indian and Alaska Native ,5,0,5,8,19,8
2018,Halifax County,51083,American Indian and Alaska Native ,59,48,11,60,61,17
2018,Hanover County,51085,American Indian and Alaska Native ,52,25,27,38,22,31
2018,Henrico County,51087,American Indian and Alaska Native ,346,152,194,137,71,125
2018,Henry County,51089,American Indian and Alaska Native ,15,15,0,26,26,28
2018,Highland County,51091,American Indian and Alaska Native ,0,0,0,12,12,12
2018,Isle of Wight County,51093,American Indian and Alaska Native ,31,31,0,22,22,25
2018,James City County,51095,American Indian and Alaska Native ,37,37,0,40,40,28
2018,King and Queen County,51097,American Indian and Alaska Native ,8,8,0,12,12,17
2018,King George County,51099,American Indian and Alaska Native ,64,64,0,44,44,22
2018,King William County,51101,American Indian and Alaska Native ,79,74,5,22,22,6
2018,Lancaster County,51103,American Indian and Alaska Native ,0,0,0,19,19,19
2018,Lee County,51105,American Indian and Alaska Native ,5,0,5,10,22,10
2018,Loudoun County,51107,American Indian and Alaska Native ,436,326,110,70,65,64
2018,Louisa County,51109,American Indian and Alaska Native ,43,43,0,32,32,25
2018,Lunenburg County,51111,American Indian and Alaska Native ,0,0,0,19,19,19
2018,Madison County,51113,American Indian and Alaska Native ,0,0,0,19,19,19
2018,Mathews County,51115,American Indian and Alaska Native ,10,10,0,19,19,17
2018,Mecklenburg County,51117,American Indian and Alaska Native ,43,43,0,34,34,25
2018,Middlesex County,51119,American Indian and Alaska Native ,28,15,13,32,23,23
2018,Montgomery County,51121,American Indian and Alaska Native ,149,47,102,50,46,58
2018,Nelson County,51125,American Indian and Alaska Native ,22,22,0,38,38,19
2018,New Kent County,51127,American Indian and Alaska Native ,111,109,2,67,67,4
2018,Northampton County,51131,American Indian and Alaska Native ,4,4,0,7,7,19
2018,Northumberland County,51133,American Indian and Alaska Native ,28,28,0,51,51,19
2018,Nottoway County,51135,American Indian and Alaska Native ,0,0,0,19,19,19
2018,Orange County,51137,American Indian and Alaska Native ,21,21,0,21,21,25
2018,Page County,51139,American Indian and Alaska Native ,8,0,8,13,22,13
2018,Patrick County,51141,American Indian and Alaska Native ,12,9,3,15,15,5
2018,Pittsylvania County,51143,American Indian and Alaska Native ,19,19,0,19,19,28
2018,Powhatan County,51145,American Indian and Alaska Native ,29,29,0,38,38,22
2018,Prince Edward County,51147,American Indian and Alaska Native ,21,21,0,26,26,22
2018,Prince George County,51149,American Indian and Alaska Native ,21,19,2,25,24,4
2018,Prince William County,51153,American Indian and Alaska Native ,499,344,155,144,108,92
2018,Pulaski County,51155,American Indian and Alaska Native ,16,16,0,22,22,25
2018,Rappahannock County,51157,American Indian and Alaska Native ,0,0,0,17,17,17
2018,Richmond County,51159,American Indian and Alaska Native ,16,16,0,25,25,17
2018,Roanoke County,51161,American Indian and Alaska Native ,33,23,10,27,24,15
2018,Rockbridge County,51163,American Indian and Alaska Native ,27,0,27,28,22,28
2018,Rockingham County,51165,American Indian and Alaska Native ,50,50,0,56,56,28
2018,Russell County,51167,American Indian and Alaska Native ,0,0,0,22,22,22
2018,Scott County,51169,American Indian and Alaska Native ,0,0,0,22,22,22
2018,Shenandoah County,51171,American Indian and Alaska Native ,25,12,13,27,14,21
2018,Smyth County,51173,American Indian and Alaska Native ,0,0,0,25,25,25
2018,Southampton County,51175,American Indian and Alaska Native ,35,35,0,35,35,19
2018,Spotsylvania County,51177,American Indian and Alaska Native ,139,94,45,57,45,40
2018,Stafford County,51179,American Indian and Alaska Native ,239,187,52,70,58,44
2018,Surry County,51181,American Indian and Alaska Native ,1,1,0,4,4,17
2018,Sussex County,51183,American Indian and Alaska Native ,0,0,0,19,19,19
2018,Tazewell County,51185,American Indian and Alaska Native ,74,48,26,43,46,28
2018,Warren County,51187,American Indian and Alaska Native ,31,31,0,52,52,25
2018,Washington County,51191,American Indian and Alaska Native ,3,3,0,7,7,28
2018,Westmoreland County,51193,American Indian and Alaska Native ,0,0,0,19,19,19
2018,Wise County,51195,American Indian and Alaska Native ,8,0,8,16,25,16
2018,Wythe County,51197,American Indian and Alaska Native ,38,13,25,35,28,30
2018,York County,51199,American Indian and Alaska Native ,11,11,0,18,18,28
2018,Alexandria city,51510,American Indian and Alaska Native ,120,60,60,104,67,65
2018,Bristol city,51520,American Indian and Alaska Native ,0,0,0,19,19,19
2018,Buena Vista city,51530,American Indian and Alaska Native ,0,0,0,17,17,17
2018,Charlottesville city,51540,American Indian and Alaska Native ,38,6,32,51,10,53
2018,Chesapeake city,51550,American Indian and Alaska Native ,220,191,29,125,126,45
2018,Colonial Heights city,51570,American Indian and Alaska Native ,12,12,0,16,16,19
2018,Covington city,51580,American Indian and Alaska Native ,0,0,0,17,17,17
2018,Danville city,51590,American Indian and Alaska Native ,16,9,7,15,10,10
2018,Emporia city,51595,American Indian and Alaska Native ,0,0,0,17,17,17
2018,Fairfax city,51600,American Indian and Alaska Native ,23,0,23,29,22,29
2018,Falls Church city,51610,American Indian and Alaska Native ,0,0,0,19,19,19
2018,Franklin city,51620,American Indian and Alaska Native ,0,0,0,17,17,17
2018,Fredericksburg city,51630,American Indian and Alaska Native ,32,10,22,24,12,21
2018,Galax city,51640,American Indian and Alaska Native ,0,0,0,17,17,17
2018,Hampton city,51650,American Indian and Alaska Native ,184,156,28,96,87,36
2018,Harrisonburg city,51660,American Indian and Alaska Native ,0,0,0,28,28,28
2018,Hopewell city,51670,American Indian and Alaska Native ,0,0,0,22,22,22
2018,Lexington city,51678,American Indian and Alaska Native ,0,0,0,17,17,17
2018,Lynchburg city,51680,American Indian and Alaska Native ,71,32,39,41,38,29
2018,Manassas city,51683,American Indian and Alaska Native ,45,14,31,55,8,54
2018,Manassas Park city,51685,American Indian and Alaska Native ,28,0,28,31,19,31
2018,Martinsville city,51690,American Indian and Alaska Native ,34,10,24,42,17,37
2018,Newport News city,51700,American Indian and Alaska Native ,193,56,137,79,62,70
2018,Norfolk city,51710,American Indian and Alaska Native ,427,147,280,145,70,118
2018,Norton city,51720,American Indian and Alaska Native ,3,0,3,7,12,7
2018,Petersburg city,51730,American Indian and Alaska Native ,25,11,14,18,14,9
2018,Poquoson city,51735,American Indian and Alaska Native ,4,4,0,19,19,19
2018,Portsmouth city,51740,American Indian and Alaska Native ,165,124,41,59,51,38
2018,Radford city,51750,American Indian and Alaska Native ,0,0,0,19,19,19
2018,Richmond city,51760,American Indian and Alaska Native ,294,96,198,103,53,102
2018,Roanoke city,51770,American Indian and Alaska Native ,35,13,22,27,16,24
2018,Salem city,51775,American Indian and Alaska Native ,20,20,0,31,31,22
2018,Staunton city,51790,American Indian and Alaska Native ,15,4,11,17,9,14
2018,Suffolk city,51800,American Indian and Alaska Native ,49,35,14,28,25,20
2018,Virginia Beach city,51810,American Indian and Alaska Native ,320,184,136,102,80,81
2018,Waynesboro city,51820,American Indian and Alaska Native ,54,8,46,40,12,41
2018,Williamsburg city,51830,American Indian and Alaska Native ,39,0,39,49,19,49
2018,Winchester city,51840,American Indian and Alaska Native ,44,4,40,33,6,33
2019,Accomack County,51001,American Indian and Alaska Native ,33,33,0,24,24,26
2019,Albemarle County,51003,American Indian and Alaska Native ,126,29,97,59,27,52
2019,Alleghany County,51005,American Indian and Alaska Native ,0,0,0,19,19,19
2019,Amelia County,51007,American Indian and Alaska Native ,0,0,0,19,19,19
2019,Amherst County,51009,American Indian and Alaska Native ,70,35,35,50,38,41
2019,Appomattox County,51011,American Indian and Alaska Native ,0,0,0,19,19,19
2019,Arlington County,51013,American Indian and Alaska Native ,399,107,292,101,64,108
2019,Augusta County,51015,American Indian and Alaska Native ,14,14,0,16,16,29
2019,Bath County,51017,American Indian and Alaska Native ,0,0,0,12,12,12
2019,Bedford County,51019,American Indian and Alaska Native ,42,42,0,39,39,29
2019,Bland County,51021,American Indian and Alaska Native ,0,0,0,17,17,17
2019,Botetourt County,51023,American Indian and Alaska Native ,24,24,0,27,27,26
2019,Brunswick County,51025,American Indian and Alaska Native ,0,0,0,19,19,19
2019,Buchanan County,51027,American Indian and Alaska Native ,4,0,4,10,23,10
2019,Buckingham County,51029,American Indian and Alaska Native ,51,14,37,43,16,40
2019,Campbell County,51031,American Indian and Alaska Native ,29,15,14,29,20,18
2019,Caroline County,51033,American Indian and Alaska Native ,38,17,21,32,14,30
2019,Carroll County,51035,American Indian and Alaska Native ,50,50,0,60,60,23
2019,Charles City County,51036,American Indian and Alaska Native ,197,184,13,20,19,8
2019,Charlotte County,51037,American Indian and Alaska Native ,6,6,0,11,11,19
2019,Chesterfield County,51041,American Indian and Alaska Native ,370,224,146,114,89,74
2019,Clarke County,51043,American Indian and Alaska Native ,0,0,0,19,19,19
2019,Craig County,51045,American Indian and Alaska Native ,0,0,0,17,17,17
2019,Culpeper County,51047,American Indian and Alaska Native ,67,43,24,68,64,40
2019,Cumberland County,51049,American Indian and Alaska Native ,13,13,0,20,20,17
2019,Dickenson County,51051,American Indian and Alaska Native ,0,0,0,19,19,19
2019,Dinwiddie County,51053,American Indian and Alaska Native ,3,0,3,5,23,5
2019,Essex County,51057,American Indian and Alaska Native ,0,0,0,19,19,19
2019,Fairfax County,51059,American Indian and Alaska Native ,1062,624,438,273,160,182
2019,Fauquier County,51061,American Indian and Alaska Native ,58,58,0,25,25,29
2019,Floyd County,51063,American Indian and Alaska Native ,93,93,0,89,89,19
2019,Fluvanna County,51065,American Indian and Alaska Native ,0,0,0,23,23,23
2019,Franklin County,51067,American Indian and Alaska Native ,36,14,22,20,18,22
2019,Frederick County,51069,American Indian and Alaska Native ,73,50,23,68,62,36
2019,Giles County,51071,American Indian and Alaska Native ,0,0,0,19,19,19
2019,Gloucester County,51073,American Indian and Alaska Native ,11,11,0,17,17,26
2019,Goochland County,51075,American Indian and Alaska Native ,0,0,0,23,23,23
2019,Grayson County,51077,American Indian and Alaska Native ,0,0,0,19,19,19
2019,Greene County,51079,American Indian and Alaska Native ,28,28,0,47,47,19
2019,Greensville County,51081,American Indian and Alaska Native ,0,0,0,19,19,19
2019,Halifax County,51083,American Indian and Alaska Native ,62,51,11,54,59,16
2019,Hanover County,51085,American Indian and Alaska Native ,89,35,54,61,28,61
2019,Henrico County,51087,American Indian and Alaska Native ,321,169,152,108,85,87
2019,Henry County,51089,American Indian and Alaska Native ,12,12,0,19,19,29
2019,Highland County,51091,American Indian and Alaska Native ,0,0,0,12,12,12
2019,Isle of Wight County,51093,American Indian and Alaska Native ,33,33,0,21,21,26
2019,James City County,51095,American Indian and Alaska Native ,41,14,27,47,23,46
2019,King and Queen County,51097,American Indian and Alaska Native ,3,3,0,9,9,17
2019,King George County,51099,American Indian and Alaska Native ,47,47,0,35,35,23
2019,King William County,51101,American Indian and Alaska Native ,65,62,3,25,24,5
2019,Lancaster County,51103,American Indian and Alaska Native ,0,0,0,19,19,19
2019,Lee County,51105,American Indian and Alaska Native ,5,0,5,9,23,9
2019,Loudoun County,51107,American Indian and Alaska Native ,488,357,131,81,58,57
2019,Louisa County,51109,American Indian and Alaska Native ,29,29,0,24,24,26
2019,Lunenburg County,51111,American Indian and Alaska Native ,0,0,0,19,19,19
2019,Madison County,51113,American Indian and Alaska Native ,0,0,0,19,19,19
2019,Mathews County,51115,American Indian and Alaska Native ,17,17,0,40,40,17
2019,Mecklenburg County,51117,American Indian and Alaska Native ,50,50,0,31,31,26
2019,Middlesex County,51119,American Indian and Alaska Native ,23,12,11,26,19,18
2019,Montgomery County,51121,American Indian and Alaska Native ,164,39,125,78,45,85
2019,Nelson County,51125,American Indian and Alaska Native ,0,0,0,19,19,19
2019,New Kent County,51127,American Indian and Alaska Native ,97,94,3,78,77,6
2019,Northampton County,51131,American Indian and Alaska Native ,4,4,0,6,6,19
2019,Northumberland County,51133,American Indian and Alaska Native ,19,19,0,34,34,19
2019,Nottoway County,51135,American Indian and Alaska Native ,0,0,0,19,19,19
2019,Orange County,51137,American Indian and Alaska Native ,22,22,0,22,22,26
2019,Page County,51139,American Indian and Alaska Native ,0,0,0,23,23,23
2019,Patrick County,51141,American Indian and Alaska Native ,11,10,1,15,15,4
2019,Pittsylvania County,51143,American Indian and Alaska Native ,20,20,0,15,15,29
2019,Powhatan County,51145,American Indian and Alaska Native ,14,14,0,27,27,23
2019,Prince Edward County,51147,American Indian and Alaska Native ,26,26,0,25,25,23
2019,Prince George County,51149,American Indian and Alaska Native ,14,11,3,16,15,6
2019,Prince William County,51153,American Indian and Alaska Native ,579,421,158,133,129,74
2019,Pulaski County,51155,American Indian and Alaska Native ,5,5,0,10,10,26
2019,Rappahannock County,51157,American Indian and Alaska Native ,17,17,0,25,25,17
2019,Richmond County,51159,American Indian and Alaska Native ,0,0,0,17,17,17
2019,Roanoke County,51161,American Indian and Alaska Native ,50,40,10,31,31,16
2019,Rockbridge County,51163,American Indian and Alaska Native ,25,0,25,28,23,28
2019,Rockingham County,51165,American Indian and Alaska Native ,41,41,0,48,48,29
2019,Russell County,51167,American Indian and Alaska Native ,23,23,0,40,40,23
2019,Scott County,51169,American Indian and Alaska Native ,35,0,35,51,23,51
2019,Shenandoah County,51171,American Indian and Alaska Native ,12,12,0,14,14,26
2019,Smyth County,51173,American Indian and Alaska Native ,40,30,10,18,19,21
2019,Southampton County,51175,American Indian and Alaska Native ,43,43,0,53,53,19
2019,Spotsylvania County,51177,American Indian and Alaska Native ,148,100,48,54,39,43
2019,Stafford County,51179,American Indian and Alaska Native ,256,222,34,71,62,35
2019,Surry County,51181,American Indian and Alaska Native ,2,2,0,3,3,17
2019,Sussex County,51183,American Indian and Alaska Native ,0,0,0,19,19,19
2019,Tazewell County,51185,American Indian and Alaska Native ,76,44,32,43,53,38
2019,Warren County,51187,American Indian and Alaska Native ,19,19,0,26,26,26
2019,Washington County,51191,American Indian and Alaska Native ,4,4,0,7,7,29
2019,Westmoreland County,51193,American Indian and Alaska Native ,0,0,0,19,19,19
2019,Wise County,51195,American Indian and Alaska Native ,7,0,7,14,26,14
2019,Wythe County,51197,American Indian and Alaska Native ,62,37,25,68,55,41
2019,York County,51199,American Indian and Alaska Native ,20,20,0,36,36,29
2019,Alexandria city,51510,American Indian and Alaska Native ,133,60,73,98,69,78
2019,Bristol city,51520,American Indian and Alaska Native ,0,0,0,19,19,19
2019,Buena Vista city,51530,American Indian and Alaska Native ,0,0,0,17,17,17
2019,Charlottesville city,51540,American Indian and Alaska Native ,65,0,65,46,26,46
2019,Chesapeake city,51550,American Indian and Alaska Native ,211,179,32,105,101,49
2019,Colonial Heights city,51570,American Indian and Alaska Native ,12,12,0,12,12,19
2019,Covington city,51580,American Indian and Alaska Native ,0,0,0,17,17,17
2019,Danville city,51590,American Indian and Alaska Native ,21,10,11,18,12,15
2019,Emporia city,51595,American Indian and Alaska Native ,0,0,0,17,17,17
2019,Fairfax city,51600,American Indian and Alaska Native ,0,0,0,23,23,23
2019,Falls Church city,51610,American Indian and Alaska Native ,0,0,0,19,19,19
2019,Franklin city,51620,American Indian and Alaska Native ,0,0,0,17,17,17
2019,Fredericksburg city,51630,American Indian and Alaska Native ,36,11,25,28,16,25
2019,Galax city,51640,American Indian and Alaska Native ,0,0,0,17,17,17
2019,Hampton city,51650,American Indian and Alaska Native ,150,123,27,112,89,43
2019,Harrisonburg city,51660,American Indian and Alaska Native ,21,21,0,32,32,29
2019,Hopewell city,51670,American Indian and Alaska Native ,0,0,0,23,23,23
2019,Lexington city,51678,American Indian and Alaska Native ,0,0,0,17,17,17
2019,Lynchburg city,51680,American Indian and Alaska Native ,92,41,51,44,40,36
2019,Manassas city,51683,American Indian and Alaska Native ,55,17,38,60,7,62
2019,Manassas Park city,51685,American Indian and Alaska Native ,9,0,9,16,19,16
2019,Martinsville city,51690,American Indian and Alaska Native ,9,9,0,14,14,19
2019,Newport News city,51700,American Indian and Alaska Native ,226,96,130,88,74,81
2019,Norfolk city,51710,American Indian and Alaska Native ,412,170,242,131,77,117
2019,Norton city,51720,American Indian and Alaska Native ,0,0,0,12,12,12
2019,Petersburg city,51730,American Indian and Alaska Native ,24,9,15,17,15,10
2019,Poquoson city,51735,American Indian and Alaska Native ,10,10,0,16,16,19
2019,Portsmouth city,51740,American Indian and Alaska Native ,131,89,42,55,52,33
2019,Radford city,51750,American Indian and Alaska Native ,0,0,0,19,19,19
2019,Richmond city,51760,American Indian and Alaska Native ,299,65,234,135,39,132
2019,Roanoke city,51770,American Indian and Alaska Native ,38,26,12,48,45,20
2019,Salem city,51775,American Indian and Alaska Native ,23,23,0,34,34,23
2019,Staunton city,51790,American Indian and Alaska Native ,30,8,22,20,11,18
2019,Suffolk city,51800,American Indian and Alaska Native ,59,34,25,36,27,25
2019,Virginia Beach city,51810,American Indian and Alaska Native ,394,174,220,128,66,114
2019,Waynesboro city,51820,American Indian and Alaska Native ,76,8,68,48,12,50
2019,Williamsburg city,51830,American Indian and Alaska Native ,20,0,20,33,19,33
2019,Winchester city,51840,American Indian and Alaska Native ,28,4,24,25,6,24
2020,Accomack County,51001,American Indian and Alaska Native ,14,14,0,19,19,27
2020,Albemarle County,51003,American Indian and Alaska Native ,104,42,62,66,41,53
2020,Alleghany County,51005,American Indian and Alaska Native ,0,0,0,20,20,20
2020,Amelia County,51007,American Indian and Alaska Native ,0,0,0,20,20,20
2020,Amherst County,51009,American Indian and Alaska Native ,106,43,63,60,49,60
2020,Appomattox County,51011,American Indian and Alaska Native ,0,0,0,20,20,20
2020,Arlington County,51013,American Indian and Alaska Native ,381,118,263,112,97,101
2020,Augusta County,51015,American Indian and Alaska Native ,3,3,0,7,7,30
2020,Bath County,51017,American Indian and Alaska Native ,0,0,0,13,13,13
2020,Bedford County,51019,American Indian and Alaska Native ,43,43,0,38,38,30
2020,Bland County,51021,American Indian and Alaska Native ,0,0,0,18,18,18
2020,Botetourt County,51023,American Indian and Alaska Native ,30,30,0,36,36,27
2020,Brunswick County,51025,American Indian and Alaska Native ,0,0,0,20,20,20
2020,Buchanan County,51027,American Indian and Alaska Native ,0,0,0,24,24,24
2020,Buckingham County,51029,American Indian and Alaska Native ,58,18,40,44,23,38
2020,Campbell County,51031,American Indian and Alaska Native ,25,15,10,21,17,12
2020,Caroline County,51033,American Indian and Alaska Native ,57,28,29,37,27,31
2020,Carroll County,51035,American Indian and Alaska Native ,71,71,0,76,76,24
2020,Charles City County,51036,American Indian and Alaska Native ,160,152,8,20,18,10
2020,Charlotte County,51037,American Indian and Alaska Native ,10,10,0,16,16,20
2020,Chesterfield County,51041,American Indian and Alaska Native ,276,181,95,104,84,71
2020,Clarke County,51043,American Indian and Alaska Native ,0,0,0,20,20,20
2020,Craig County,51045,American Indian and Alaska Native ,0,0,0,18,18,18
2020,Culpeper County,51047,American Indian and Alaska Native ,112,48,64,73,46,79
2020,Cumberland County,51049,American Indian and Alaska Native ,9,9,0,16,16,18
2020,Dickenson County,51051,American Indian and Alaska Native ,0,0,0,20,20,20
2020,Dinwiddie County,51053,American Indian and Alaska Native ,6,0,6,12,24,12
2020,Essex County,51057,American Indian and Alaska Native ,0,0,0,20,20,20
2020,Fairfax County,51059,American Indian and Alaska Native ,998,669,329,197,146,131
2020,Fauquier County,51061,American Indian and Alaska Native ,48,48,0,31,31,30
2020,Floyd County,51063,American Indian and Alaska Native ,124,124,0,116,116,20
2020,Fluvanna County,51065,American Indian and Alaska Native ,0,0,0,24,24,24
2020,Franklin County,51067,American Indian and Alaska Native ,38,15,23,27,17,30
2020,Frederick County,51069,American Indian and Alaska Native ,64,41,23,53,54,38
2020,Giles County,51071,American Indian and Alaska Native ,0,0,0,20,20,20
2020,Gloucester County,51073,American Indian and Alaska Native ,0,0,0,27,27,27
2020,Goochland County,51075,American Indian and Alaska Native ,0,0,0,24,24,24
2020,Grayson County,51077,American Indian and Alaska Native ,0,0,0,20,20,20
2020,Greene County,51079,American Indian and Alaska Native ,21,21,0,31,31,20
2020,Greensville County,51081,American Indian and Alaska Native ,0,0,0,20,20,20
2020,Halifax County,51083,American Indian and Alaska Native ,57,46,11,50,55,17
2020,Hanover County,51085,American Indian and Alaska Native ,142,49,93,97,45,85
2020,Henrico County,51087,American Indian and Alaska Native ,278,122,156,124,75,104
2020,Henry County,51089,American Indian and Alaska Native ,10,10,0,15,15,30
2020,Highland County,51091,American Indian and Alaska Native ,0,0,0,13,13,13
2020,Isle of Wight County,51093,American Indian and Alaska Native ,11,11,0,15,15,27
2020,James City County,51095,American Indian and Alaska Native ,14,0,14,22,30,22
2020,King and Queen County,51097,American Indian and Alaska Native ,7,7,0,11,11,18
2020,King George County,51099,American Indian and Alaska Native ,36,36,0,25,25,24
2020,King William County,51101,American Indian and Alaska Native ,71,68,3,28,27,4
2020,Lancaster County,51103,American Indian and Alaska Native ,0,0,0,20,20,20
2020,Lee County,51105,American Indian and Alaska Native ,5,0,5,11,24,11
2020,Loudoun County,51107,American Indian and Alaska Native ,512,348,164,94,85,72
2020,Louisa County,51109,American Indian and Alaska Native ,13,13,0,20,20,27
2020,Lunenburg County,51111,American Indian and Alaska Native ,1,0,1,3,20,3
2020,Madison County,51113,American Indian and Alaska Native ,0,0,0,20,20,20
2020,Mathews County,51115,American Indian and Alaska Native ,0,0,0,18,18,18
2020,Mecklenburg County,51117,American Indian and Alaska Native ,54,54,0,30,30,27
2020,Middlesex County,51119,American Indian and Alaska Native ,10,0,10,16,20,16
2020,Montgomery County,51121,American Indian and Alaska Native ,142,40,102,66,41,74
2020,Nelson County,51125,American Indian and Alaska Native ,0,0,0,20,20,20
2020,New Kent County,51127,American Indian and Alaska Native ,146,143,3,86,85,6
2020,Northampton County,51131,American Indian and Alaska Native ,2,2,0,3,3,20
2020,Northumberland County,51133,American Indian and Alaska Native ,0,0,0,20,20,20
2020,Nottoway County,51135,American Indian and Alaska Native ,0,0,0,20,20,20
2020,Orange County,51137,American Indian and Alaska Native ,22,22,0,23,23,27
2020,Page County,51139,American Indian and Alaska Native ,0,0,0,24,24,24
2020,Patrick County,51141,American Indian and Alaska Native ,13,9,4,14,13,7
2020,Pittsylvania County,51143,American Indian and Alaska Native ,7,7,0,9,9,30
2020,Powhatan County,51145,American Indian and Alaska Native ,7,7,0,17,17,24
2020,Prince Edward County,51147,American Indian and Alaska Native ,17,17,0,36,36,24
2020,Prince George County,51149,American Indian and Alaska Native ,15,9,6,18,12,12
2020,Prince William County,51153,American Indian and Alaska Native ,624,405,219,167,147,112
2020,Pulaski County,51155,American Indian and Alaska Native ,5,5,0,10,10,27
2020,Rappahannock County,51157,American Indian and Alaska Native ,12,12,0,22,22,18
2020,Richmond County,51159,American Indian and Alaska Native ,7,0,7,14,18,14
2020,Roanoke County,51161,American Indian and Alaska Native ,60,41,19,35,28,21
2020,Rockbridge County,51163,American Indian and Alaska Native ,29,0,29,45,24,45
2020,Rockingham County,51165,American Indian and Alaska Native ,19,19,0,36,36,30
2020,Russell County,51167,American Indian and Alaska Native ,40,16,24,114,28,116
2020,Scott County,51169,American Indian and Alaska Native ,33,0,33,40,24,40
2020,Shenandoah County,51171,American Indian and Alaska Native ,2,2,0,6,6,27
2020,Smyth County,51173,American Indian and Alaska Native ,37,26,11,17,18,18
2020,Southampton County,51175,American Indian and Alaska Native ,21,21,0,21,21,20
2020,Spotsylvania County,51177,American Indian and Alaska Native ,135,104,31,74,73,27
2020,Stafford County,51179,American Indian and Alaska Native ,232,186,46,85,79,38
2020,Surry County,51181,American Indian and Alaska Native ,2,2,0,5,5,18
2020,Sussex County,51183,American Indian and Alaska Native ,0,0,0,20,20,20
2020,Tazewell County,51185,American Indian and Alaska Native ,49,30,19,46,46,20
2020,Warren County,51187,American Indian and Alaska Native ,40,40,0,56,56,27
2020,Washington County,51191,American Indian and Alaska Native ,5,5,0,6,6,30
2020,Westmoreland County,51193,American Indian and Alaska Native ,1,1,0,3,3,20
2020,Wise County,51195,American Indian and Alaska Native ,11,0,11,21,27,21
2020,Wythe County,51197,American Indian and Alaska Native ,44,29,15,55,60,24
2020,York County,51199,American Indian and Alaska Native ,19,19,0,28,28,30
2020,Alexandria city,51510,American Indian and Alaska Native ,167,108,59,120,108,66
2020,Bristol city,51520,American Indian and Alaska Native ,0,0,0,20,20,20
2020,Buena Vista city,51530,American Indian and Alaska Native ,0,0,0,18,18,18
2020,Charlottesville city,51540,American Indian and Alaska Native ,75,0,75,60,27,60
2020,Chesapeake city,51550,American Indian and Alaska Native ,219,192,27,110,108,45
2020,Colonial Heights city,51570,American Indian and Alaska Native ,0,0,0,20,20,20
2020,Covington city,51580,American Indian and Alaska Native ,0,0,0,18,18,18
2020,Danville city,51590,American Indian and Alaska Native ,12,6,6,11,6,9
2020,Emporia city,51595,American Indian and Alaska Native ,0,0,0,18,18,18
2020,Fairfax city,51600,American Indian and Alaska Native ,6,6,0,12,12,24
2020,Falls Church city,51610,American Indian and Alaska Native ,0,0,0,20,20,20
2020,Franklin city,51620,American Indian and Alaska Native ,0,0,0,18,18,18
2020,Fredericksburg city,51630,American Indian and Alaska Native ,30,5,25,32,8,30
2020,Galax city,51640,American Indian and Alaska Native ,0,0,0,18,18,18
2020,Hampton city,51650,American Indian and Alaska Native ,184,137,47,110,104,50
2020,Harrisonburg city,51660,American Indian and Alaska Native ,12,12,0,21,21,30
2020,Hopewell city,51670,American Indian and Alaska Native ,0,0,0,24,24,24
2020,Lexington city,51678,American Indian and Alaska Native ,0,0,0,18,18,18
2020,Lynchburg city,51680,American Indian and Alaska Native ,78,44,34,45,44,22
2020,Manassas city,51683,American Indian and Alaska Native ,17,17,0,8,8,27
2020,Manassas Park city,51685,American Indian and Alaska Native ,7,0,7,11,20,11
2020,Martinsville city,51690,American Indian and Alaska Native ,9,9,0,15,15,20
2020,Newport News city,51700,American Indian and Alaska Native ,298,130,168,120,91,101
2020,Norfolk city,51710,American Indian and Alaska Native ,296,132,164,113,57,103
2020,Norton city,51720,American Indian and Alaska Native ,0,0,0,13,13,13
2020,Petersburg city,51730,American Indian and Alaska Native ,40,8,32,18,20,14
2020,Poquoson city,51735,American Indian and Alaska Native ,12,12,0,21,21,20
2020,Portsmouth city,51740,American Indian and Alaska Native ,121,77,44,55,45,40
2020,Radford city,51750,American Indian and Alaska Native ,0,0,0,20,20,20
2020,Richmond city,51760,American Indian and Alaska Native ,259,77,182,111,67,90
2020,Roanoke city,51770,American Indian and Alaska Native ,65,55,10,44,45,17
2020,Salem city,51775,American Indian and Alaska Native ,0,0,0,24,24,24
2020,Staunton city,51790,American Indian and Alaska Native ,23,8,15,13,14,14
2020,Suffolk city,51800,American Indian and Alaska Native ,28,19,9,20,17,12
2020,Virginia Beach city,51810,American Indian and Alaska Native ,399,192,207,145,75,122
2020,Waynesboro city,51820,American Indian and Alaska Native ,118,12,106,90,19,88
2020,Williamsburg city,51830,American Indian and Alaska Native ,23,0,23,40,20,40
2020,Winchester city,51840,American Indian and Alaska Native ,14,7,7,15,9,12
2021,Accomack County,51001,American Indian and Alaska Native ,21,21,0,25,25,28
2021,Albemarle County,51003,American Indian and Alaska Native ,62,14,48,64,20,58
2021,Alleghany County,51005,American Indian and Alaska Native ,0,0,0,21,21,21
2021,Amelia County,51007,American Indian and Alaska Native ,0,0,0,21,21,21
2021,Amherst County,51009,American Indian and Alaska Native ,132,52,80,119,59,112
2021,Appomattox County,51011,American Indian and Alaska Native ,0,0,0,21,21,21
2021,Arlington County,51013,American Indian and Alaska Native ,418,142,276,154,90,116
2021,Augusta County,51015,American Indian and Alaska Native ,3,3,0,6,6,31
2021,Bath County,51017,American Indian and Alaska Native ,0,0,0,13,13,13
2021,Bedford County,51019,American Indian and Alaska Native ,49,23,26,39,27,29
2021,Bland County,51021,American Indian and Alaska Native ,0,0,0,19,19,19
2021,Botetourt County,51023,American Indian and Alaska Native ,30,30,0,30,30,28
2021,Brunswick County,51025,American Indian and Alaska Native ,10,0,10,10,21,10
2021,Buchanan County,51027,American Indian and Alaska Native ,0,0,0,25,25,25
2021,Buckingham County,51029,American Indian and Alaska Native ,34,7,27,19,12,18
2021,Campbell County,51031,American Indian and Alaska Native ,29,19,10,30,25,13
2021,Caroline County,51033,American Indian and Alaska Native ,63,24,39,48,23,41
2021,Carroll County,51035,American Indian and Alaska Native ,15,15,0,21,21,25
2021,Charles City County,51036,American Indian and Alaska Native ,165,157,8,25,23,8
2021,Charlotte County,51037,American Indian and Alaska Native ,0,0,0,21,21,21
2021,Chesterfield County,51041,American Indian and Alaska Native ,293,200,93,121,103,55
2021,Clarke County,51043,American Indian and Alaska Native ,0,0,0,21,21,21
2021,Craig County,51045,American Indian and Alaska Native ,0,0,0,13,13,13
2021,Culpeper County,51047,American Indian and Alaska Native ,28,28,0,27,27,31
2021,Cumberland County,51049,American Indian and Alaska Native ,9,9,0,14,14,19
2021,Dickenson County,51051,American Indian and Alaska Native ,19,0,19,28,21,28
2021,Dinwiddie County,51053,American Indian and Alaska Native ,8,0,8,16,25,16
2021,Essex County,51057,American Indian and Alaska Native ,0,0,0,21,21,21
2021,Fairfax County,51059,American Indian and Alaska Native ,1131,760,371,194,177,127
2021,Fauquier County,51061,American Indian and Alaska Native ,42,42,0,22,22,31
2021,Floyd County,51063,American Indian and Alaska Native ,44,44,0,53,53,21
2021,Fluvanna County,51065,American Indian and Alaska Native ,0,0,0,25,25,25
2021,Franklin County,51067,American Indian and Alaska Native ,42,42,0,46,46,31
2021,Frederick County,51069,American Indian and Alaska Native ,95,95,0,85,85,31
2021,Giles County,51071,American Indian and Alaska Native ,0,0,0,21,21,21
2021,Gloucester County,51073,American Indian and Alaska Native ,0,0,0,28,28,28
2021,Goochland County,51075,American Indian and Alaska Native ,0,0,0,25,25,25
2021,Grayson County,51077,American Indian and Alaska Native ,0,0,0,21,21,21
2021,Greene County,51079,American Indian and Alaska Native ,24,24,0,33,33,25
2021,Greensville County,51081,American Indian and Alaska Native ,0,0,0,21,21,21
2021,Halifax County,51083,American Indian and Alaska Native ,20,20,0,34,34,28
2021,Hanover County,51085,American Indian and Alaska Native ,91,65,26,75,56,41
2021,Henrico County,51087,American Indian and Alaska Native ,264,164,100,87,67,65
2021,Henry County,51089,American Indian and Alaska Native ,3,3,0,7,7,31
2021,Highland County,51091,American Indian and Alaska Native ,0,0,0,13,13,13
2021,Isle of Wight County,51093,American Indian and Alaska Native ,11,3,8,15,7,13
2021,James City County,51095,American Indian and Alaska Native ,49,22,27,60,32,49
2021,King and Queen County,51097,American Indian and Alaska Native ,15,15,0,17,17,19
2021,King George County,51099,American Indian and Alaska Native ,34,34,0,31,31,25
2021,King William County,51101,American Indian and Alaska Native ,109,98,11,28,29,10
2021,Lancaster County,51103,American Indian and Alaska Native ,0,0,0,21,21,21
2021,Lee County,51105,American Indian and Alaska Native ,3,0,3,5,25,5
2021,Loudoun County,51107,American Indian and Alaska Native ,514,366,148,91,78,56
2021,Louisa County,51109,American Indian and Alaska Native ,26,26,0,24,24,28
2021,Lunenburg County,51111,American Indian and Alaska Native ,1,0,1,3,21,3
2021,Madison County,51113,American Indian and Alaska Native ,2,2,0,6,6,21
2021,Mathews County,51115,American Indian and Alaska Native ,0,0,0,19,19,19
2021,Mecklenburg County,51117,American Indian and Alaska Native ,46,46,0,27,27,28
2021,Middlesex County,51119,American Indian and Alaska Native ,8,0,8,14,21,14
2021,Montgomery County,51121,American Indian and Alaska Native ,152,54,98,52,45,58
2021,Nelson County,51125,American Indian and Alaska Native ,7,7,0,12,12,21
2021,New Kent County,51127,American Indian and Alaska Native ,50,50,0,39,39,25
2021,Northampton County,51131,American Indian and Alaska Native ,0,0,0,21,21,21
2021,Northumberland County,51133,American Indian and Alaska Native ,0,0,0,21,21,21
2021,Nottoway County,51135,American Indian and Alaska Native ,0,0,0,21,21,21
2021,Orange County,51137,American Indian and Alaska Native ,2,2,0,4,4,28
2021,Page County,51139,American Indian and Alaska Native ,0,0,0,25,25,25
2021,Patrick County,51141,American Indian and Alaska Native ,7,6,1,10,9,4
2021,Pittsylvania County,51143,American Indian and Alaska Native ,18,18,0,25,25,31
2021,Powhatan County,51145,American Indian and Alaska Native ,17,17,0,22,22,25
2021,Prince Edward County,51147,American Indian and Alaska Native ,33,33,0,50,50,25
2021,Prince George County,51149,American Indian and Alaska Native ,12,6,6,17,10,13
2021,Prince William County,51153,American Indian and Alaska Native ,830,545,285,193,169,118
2021,Pulaski County,51155,American Indian and Alaska Native ,7,7,0,11,11,28
2021,Rappahannock County,51157,American Indian and Alaska Native ,6,6,0,12,12,19
2021,Richmond County,51159,American Indian and Alaska Native ,22,10,12,24,18,16
2021,Roanoke County,51161,American Indian and Alaska Native ,33,10,23,33,15,30
2021,Rockbridge County,51163,American Indian and Alaska Native ,27,0,27,33,25,33
2021,Rockingham County,51165,American Indian and Alaska Native ,33,33,0,43,43,31
2021,Russell County,51167,American Indian and Alaska Native ,54,16,38,98,34,94
2021,Scott County,51169,American Indian and Alaska Native ,26,0,26,35,25,35
2021,Shenandoah County,51171,American Indian and Alaska Native ,12,2,10,18,4,17
2021,Smyth County,51173,American Indian and Alaska Native ,22,18,4,14,13,7
2021,Southampton County,51175,American Indian and Alaska Native ,0,0,0,21,21,21
2021,Spotsylvania County,51177,American Indian and Alaska Native ,114,94,20,66,66,15
2021,Stafford County,51179,American Indian and Alaska Native ,233,181,52,80,72,33
2021,Surry County,51181,American Indian and Alaska Native ,1,1,0,5,5,19
2021,Sussex County,51183,American Indian and Alaska Native ,0,0,0,21,21,21
2021,Tazewell County,51185,American Indian and Alaska Native ,27,19,8,29,27,15
2021,Warren County,51187,American Indian and Alaska Native ,13,13,0,22,22,28
2021,Washington County,51191,American Indian and Alaska Native ,9,9,0,10,10,31
2021,Westmoreland County,51193,American Indian and Alaska Native ,14,14,0,26,26,21
2021,Wise County,51195,American Indian and Alaska Native ,8,0,8,14,28,14
2021,Wythe County,51197,American Indian and Alaska Native ,16,9,7,22,21,14
2021,York County,51199,American Indian and Alaska Native ,24,24,0,24,24,31
2021,Alexandria city,51510,American Indian and Alaska Native ,108,64,44,66,62,27
2021,Bristol city,51520,American Indian and Alaska Native ,0,0,0,21,21,21
2021,Buena Vista city,51530,American Indian and Alaska Native ,0,0,0,19,19,19
2021,Charlottesville city,51540,American Indian and Alaska Native ,76,0,76,47,28,47
2021,Chesapeake city,51550,American Indian and Alaska Native ,117,107,10,70,65,18
2021,Colonial Heights city,51570,American Indian and Alaska Native ,0,0,0,21,21,21
2021,Covington city,51580,American Indian and Alaska Native ,0,0,0,19,19,19
2021,Danville city,51590,American Indian and Alaska Native ,12,1,11,12,3,12
2021,Emporia city,51595,American Indian and Alaska Native ,0,0,0,19,19,19
2021,Fairfax city,51600,American Indian and Alaska Native ,1,1,0,2,2,25
2021,Falls Church city,51610,American Indian and Alaska Native ,8,0,8,14,21,14
2021,Franklin city,51620,American Indian and Alaska Native ,0,0,0,19,19,19
2021,Fredericksburg city,51630,American Indian and Alaska Native ,23,4,19,21,8,18
2021,Galax city,51640,American Indian and Alaska Native ,9,9,0,15,15,19
2021,Hampton city,51650,American Indian and Alaska Native ,243,192,51,73,73,45
2021,Harrisonburg city,51660,American Indian and Alaska Native ,28,9,19,32,15,30
2021,Hopewell city,51670,American Indian and Alaska Native ,6,0,6,14,25,14
2021,Lexington city,51678,American Indian and Alaska Native ,0,0,0,19,19,19
2021,Lynchburg city,51680,American Indian and Alaska Native ,123,31,92,93,31,85
2021,Manassas city,51683,American Indian and Alaska Native ,19,0,19,33,28,33
2021,Manassas Park city,51685,American Indian and Alaska Native ,50,41,9,47,43,17
2021,Martinsville city,51690,American Indian and Alaska Native ,8,8,0,14,14,21
2021,Newport News city,51700,American Indian and Alaska Native ,232,89,143,96,57,90
2021,Norfolk city,51710,American Indian and Alaska Native ,248,84,164,103,62,89
2021,Norton city,51720,American Indian and Alaska Native ,0,0,0,13,13,13
2021,Petersburg city,51730,American Indian and Alaska Native ,9,0,9,12,28,12
2021,Poquoson city,51735,American Indian and Alaska Native ,0,0,0,21,21,21
2021,Portsmouth city,51740,American Indian and Alaska Native ,98,68,30,68,71,29
2021,Radford city,51750,American Indian and Alaska Native ,0,0,0,21,21,21
2021,Richmond city,51760,American Indian and Alaska Native ,241,74,167,92,45,81
2021,Roanoke city,51770,American Indian and Alaska Native ,77,77,0,57,57,31
2021,Salem city,51775,American Indian and Alaska Native ,0,0,0,25,25,25
2021,Staunton city,51790,American Indian and Alaska Native ,34,11,23,21,18,20
2021,Suffolk city,51800,American Indian and Alaska Native ,77,62,15,61,59,13
2021,Virginia Beach city,51810,American Indian and Alaska Native ,306,139,167,112,62,91
2021,Waynesboro city,51820,American Indian and Alaska Native ,102,6,96,97,12,93
2021,Williamsburg city,51830,American Indian and Alaska Native ,15,0,15,22,21,22
2021,Winchester city,51840,American Indian and Alaska Native ,7,7,0,9,9,25
2010,Accomack County,51001,Asian ,71,71,0,49,49,127
2010,Albemarle County,51003,Asian ,1455,660,795,138,110,149
2010,Alleghany County,51005,Asian ,16,16,0,23,23,127
2010,Amelia County,51007,Asian ,12,12,0,19,19,127
2010,Amherst County,51009,Asian ,8,8,0,12,12,127
2010,Appomattox County,51011,Asian ,0,0,0,127,127,127
2010,Arlington County,51013,Asian ,8126,2702,5424,376,307,419
2010,Augusta County,51015,Asian ,116,92,24,57,43,40
2010,Bath County,51017,Asian ,0,0,0,127,127,127
2010,Bedford County,51019,Asian ,176,122,54,50,45,43
2010,Bland County,51021,Asian ,29,29,0,37,37,127
2010,Botetourt County,51023,Asian ,62,62,0,38,38,127
2010,Brunswick County,51025,Asian ,13,13,0,20,20,127
2010,Buchanan County,51027,Asian ,15,15,0,11,11,127
2010,Buckingham County,51029,Asian ,31,0,31,46,127,46
2010,Campbell County,51031,Asian ,177,117,60,87,68,63
2010,Caroline County,51033,Asian ,33,33,0,21,21,127
2010,Carroll County,51035,Asian ,0,0,0,127,127,127
2010,Charles City County,51036,Asian ,4,4,0,14,14,127
2010,Charlotte County,51037,Asian ,0,0,0,127,127,127
2010,Chesterfield County,51041,Asian ,2893,2321,572,180,178,157
2010,Clarke County,51043,Asian ,38,38,0,27,27,127
2010,Craig County,51045,Asian ,0,0,0,127,127,127
2010,Culpeper County,51047,Asian ,132,109,23,55,43,34
2010,Cumberland County,51049,Asian ,0,0,0,127,127,127
2010,Dickenson County,51051,Asian ,0,0,0,127,127,127
2010,Dinwiddie County,51053,Asian ,26,13,13,15,9,19
2010,Essex County,51057,Asian ,8,0,8,12,127,12
2010,Fairfax County,51059,Asian ,57008,40199,16809,904,1042,982
2010,Fauquier County,51061,Asian ,289,197,92,135,74,109
2010,Floyd County,51063,Asian ,26,26,0,28,28,127
2010,Fluvanna County,51065,Asian ,76,76,0,55,55,127
2010,Franklin County,51067,Asian ,54,23,31,37,39,33
2010,Frederick County,51069,Asian ,322,194,128,52,60,76
2010,Giles County,51071,Asian ,0,0,0,127,127,127
2010,Gloucester County,51073,Asian ,54,54,0,30,30,127
2010,Goochland County,51075,Asian ,0,0,0,127,127,127
2010,Grayson County,51077,Asian ,3,3,0,5,5,127
2010,Greene County,51079,Asian ,103,103,0,101,101,127
2010,Greensville County,51081,Asian ,10,10,0,17,17,127
2010,Halifax County,51083,Asian ,24,24,0,24,24,127
2010,Hanover County,51085,Asian ,376,254,122,70,81,95
2010,Henrico County,51087,Asian ,6007,3874,2133,296,275,253
2010,Henry County,51089,Asian ,70,48,22,43,36,36
2010,Highland County,51091,Asian ,0,0,0,127,127,127
2010,Isle of Wight County,51093,Asian ,85,67,18,38,34,31
2010,James City County,51095,Asian ,566,449,117,96,78,64
2010,King and Queen County,51097,Asian ,0,0,0,127,127,127
2010,King George County,51099,Asian ,80,53,27,35,34,21
2010,King William County,51101,Asian ,5,5,0,8,8,127
2010,Lancaster County,51103,Asian ,16,13,3,19,17,5
2010,Lee County,51105,Asian ,65,65,0,81,81,127
2010,Loudoun County,51107,Asian ,11469,10016,1453,382,410,270
2010,Louisa County,51109,Asian ,55,48,7,81,76,16
2010,Lunenburg County,51111,Asian ,0,0,0,127,127,127
2010,Madison County,51113,Asian ,21,21,0,34,34,127
2010,Mathews County,51115,Asian ,0,0,0,127,127,127
2010,Mecklenburg County,51117,Asian ,78,63,15,33,33,15
2010,Middlesex County,51119,Asian ,0,0,0,127,127,127
2010,Montgomery County,51121,Asian ,1822,414,1408,186,111,201
2010,Nelson County,51125,Asian ,16,5,11,21,10,18
2010,New Kent County,51127,Asian ,53,30,23,42,39,33
2010,Northampton County,51131,Asian ,24,14,10,13,9,16
2010,Northumberland County,51133,Asian ,20,0,20,35,127,35
2010,Nottoway County,51135,Asian ,0,0,0,127,127,127
2010,Orange County,51137,Asian ,57,57,0,33,33,127
2010,Page County,51139,Asian ,23,14,9,13,12,15
2010,Patrick County,51141,Asian ,5,0,5,7,127,7
2010,Pittsylvania County,51143,Asian ,52,52,0,18,18,127
2010,Powhatan County,51145,Asian ,40,40,0,39,39,127
2010,Prince Edward County,51147,Asian ,27,0,27,33,127,33
2010,Prince George County,51149,Asian ,106,74,32,44,37,33
2010,Prince William County,51153,Asian ,7964,6889,1075,416,414,231
2010,Pulaski County,51155,Asian ,40,0,40,55,127,55
2010,Rappahannock County,51157,Asian ,0,0,0,127,127,127
2010,Richmond County,51159,Asian ,5,5,0,9,9,127
2010,Roanoke County,51161,Asian ,717,492,225,82,94,84
2010,Rockbridge County,51163,Asian ,0,0,0,127,127,127
2010,Rockingham County,51165,Asian ,130,82,48,67,49,64
2010,Russell County,51167,Asian ,76,71,5,57,59,17
2010,Scott County,51169,Asian ,10,0,10,20,127,20
2010,Shenandoah County,51171,Asian ,95,76,19,34,31,23
2010,Smyth County,51173,Asian ,31,23,8,27,25,14
2010,Southampton County,51175,Asian ,10,10,0,16,16,127
2010,Spotsylvania County,51177,Asian ,865,798,67,122,99,61
2010,Stafford County,51179,Asian ,941,752,189,156,144,102
2010,Surry County,51181,Asian ,0,0,0,127,127,127
2010,Sussex County,51183,Asian ,0,0,0,127,127,127
2010,Tazewell County,51185,Asian ,100,93,7,29,28,11
2010,Warren County,51187,Asian ,106,82,24,73,76,35
2010,Washington County,51191,Asian ,58,35,23,28,18,31
2010,Westmoreland County,51193,Asian ,21,21,0,23,23,127
2010,Wise County,51195,Asian ,33,23,10,24,22,17
2010,Wythe County,51197,Asian ,34,34,0,36,36,127
2010,York County,51199,Asian ,967,809,158,123,124,85
2010,Alexandria city,51510,Asian ,3510,1349,2161,266,250,264
2010,Bedford County,51019,Asian ,12,12,0,19,19,127
2010,Bristol city,51520,Asian ,21,10,11,24,18,18
2010,Buena Vista city,51530,Asian ,0,0,0,127,127,127
2010,Charlottesville city,51540,Asian ,801,187,614,185,70,178
2010,Chesapeake city,51550,Asian ,1591,1219,372,166,179,111
2010,Colonial Heights city,51570,Asian ,125,102,23,49,46,23
2010,Covington city,51580,Asian ,34,26,8,36,31,16
2010,Danville city,51590,Asian ,159,30,129,64,30,53
2010,Emporia city,51595,Asian ,21,21,0,37,37,127
2010,Fairfax city,51600,Asian ,1034,787,247,121,133,87
2010,Falls Church city,51610,Asian ,453,233,220,98,71,97
2010,Franklin city,51620,Asian ,36,12,24,41,18,37
2010,Fredericksburg city,51630,Asian ,180,48,132,73,32,71
2010,Galax city,51640,Asian ,0,0,0,127,127,127
2010,Hampton city,51650,Asian ,1021,612,409,144,121,128
2010,Harrisonburg city,51660,Asian ,596,278,318,147,96,133
2010,Hopewell city,51670,Asian ,47,21,26,46,24,38
2010,Lexington city,51678,Asian ,59,21,38,59,26,58
2010,Lynchburg city,51680,Asian ,518,182,336,72,84,82
2010,Manassas city,51683,Asian ,443,347,96,99,81,68
2010,Manassas Park city,51685,Asian ,315,305,10,87,84,16
2010,Martinsville city,51690,Asian ,29,29,0,49,49,127
2010,Newport News city,51700,Asian ,1598,963,635,191,173,177
2010,Norfolk city,51710,Asian ,2353,1184,1169,213,159,194
2010,Norton city,51720,Asian ,7,7,0,14,14,127
2010,Petersburg city,51730,Asian ,86,66,20,63,58,34
2010,Poquoson city,51735,Asian ,90,77,13,32,39,19
2010,Portsmouth city,51740,Asian ,285,236,49,183,140,59
2010,Radford city,51750,Asian ,85,12,73,41,11,38
2010,Richmond city,51760,Asian ,1422,363,1059,238,154,207
2010,Roanoke city,51770,Asian ,497,189,308,111,58,111
2010,Salem city,51775,Asian ,85,45,40,54,43,36
2010,Staunton city,51790,Asian ,58,18,40,28,26,32
2010,Suffolk city,51800,Asian ,417,381,36,114,114,33
2010,Virginia Beach city,51810,Asian ,8273,6614,1659,350,328,316
2010,Waynesboro city,51820,Asian ,39,29,10,22,19,16
2010,Williamsburg city,51830,Asian ,93,22,71,49,16,50
2010,Winchester city,51840,Asian ,237,141,96,60,54,80
2011,Accomack County,51001,Asian ,66,66,0,67,67,95
2011,Albemarle County,51003,Asian ,1461,624,837,146,118,162
2011,Alleghany County,51005,Asian ,16,16,0,13,13,95
2011,Amelia County,51007,Asian ,17,17,0,30,30,95
2011,Amherst County,51009,Asian ,23,23,0,21,21,95
2011,Appomattox County,51011,Asian ,13,13,0,22,22,95
2011,Arlington County,51013,Asian ,8084,2794,5290,449,332,416
2011,Augusta County,51015,Asian ,152,67,85,88,32,89
2011,Bath County,51017,Asian ,0,0,0,95,95,95
2011,Bedford County,51019,Asian ,205,155,50,51,58,51
2011,Bland County,51021,Asian ,0,0,0,95,95,95
2011,Botetourt County,51023,Asian ,70,70,0,38,38,95
2011,Brunswick County,51025,Asian ,5,5,0,12,12,95
2011,Buchanan County,51027,Asian ,17,17,0,21,21,95
2011,Buckingham County,51029,Asian ,27,0,27,45,95,45
2011,Campbell County,51031,Asian ,147,147,0,99,99,95
2011,Caroline County,51033,Asian ,43,43,0,23,23,95
2011,Carroll County,51035,Asian ,0,0,0,95,95,95
2011,Charles City County,51036,Asian ,1,1,0,2,2,95
2011,Charlotte County,51037,Asian ,0,0,0,95,95,95
2011,Chesterfield County,51041,Asian ,2894,2335,559,218,191,167
2011,Clarke County,51043,Asian ,36,36,0,16,16,95
2011,Craig County,51045,Asian ,0,0,0,95,95,95
2011,Culpeper County,51047,Asian ,154,134,20,41,32,32
2011,Cumberland County,51049,Asian ,0,0,0,95,95,95
2011,Dickenson County,51051,Asian ,5,5,0,8,8,95
2011,Dinwiddie County,51053,Asian ,21,8,13,16,14,13
2011,Essex County,51057,Asian ,6,0,6,11,95,11
2011,Fairfax County,51059,Asian ,57992,40770,17222,998,996,712
2011,Fauquier County,51061,Asian ,260,175,85,130,92,93
2011,Floyd County,51063,Asian ,38,38,0,42,42,95
2011,Fluvanna County,51065,Asian ,86,86,0,32,32,95
2011,Franklin County,51067,Asian ,65,25,40,40,43,39
2011,Frederick County,51069,Asian ,290,172,118,84,70,91
2011,Giles County,51071,Asian ,0,0,0,95,95,95
2011,Gloucester County,51073,Asian ,47,47,0,27,27,95
2011,Goochland County,51075,Asian ,0,0,0,95,95,95
2011,Grayson County,51077,Asian ,3,3,0,6,6,95
2011,Greene County,51079,Asian ,50,50,0,44,44,95
2011,Greensville County,51081,Asian ,7,7,0,11,11,95
2011,Halifax County,51083,Asian ,25,25,0,33,33,95
2011,Hanover County,51085,Asian ,354,252,102,78,89,86
2011,Henrico County,51087,Asian ,6230,3673,2557,292,275,299
2011,Henry County,51089,Asian ,73,49,24,23,28,27
2011,Highland County,51091,Asian ,0,0,0,95,95,95
2011,Isle of Wight County,51093,Asian ,89,80,9,41,38,18
2011,James City County,51095,Asian ,635,471,164,87,81,80
2011,King and Queen County,51097,Asian ,0,0,0,95,95,95
2011,King George County,51099,Asian ,72,40,32,38,29,28
2011,King William County,51101,Asian ,5,5,0,8,8,95
2011,Lancaster County,51103,Asian ,18,14,4,18,17,6
2011,Lee County,51105,Asian ,30,30,0,63,63,95
2011,Loudoun County,51107,Asian ,12459,10839,1620,415,448,289
2011,Louisa County,51109,Asian ,54,46,8,65,59,16
2011,Lunenburg County,51111,Asian ,3,3,0,5,5,95
2011,Madison County,51113,Asian ,21,21,0,31,31,95
2011,Mathews County,51115,Asian ,0,0,0,95,95,95
2011,Mecklenburg County,51117,Asian ,81,48,33,32,29,22
2011,Middlesex County,51119,Asian ,0,0,0,95,95,95
2011,Montgomery County,51121,Asian ,1699,405,1294,215,93,235
2011,Nelson County,51125,Asian ,17,0,17,27,95,27
2011,New Kent County,51127,Asian ,41,14,27,47,24,42
2011,Northampton County,51131,Asian ,33,22,11,14,12,17
2011,Northumberland County,51133,Asian ,17,0,17,30,95,30
2011,Nottoway County,51135,Asian ,0,0,0,95,95,95
2011,Orange County,51137,Asian ,52,42,10,30,23,18
2011,Page County,51139,Asian ,15,7,8,11,9,12
2011,Patrick County,51141,Asian ,0,0,0,95,95,95
2011,Pittsylvania County,51143,Asian ,59,59,0,35,35,95
2011,Powhatan County,51145,Asian ,33,33,0,24,24,95
2011,Prince Edward County,51147,Asian ,29,0,29,34,95,34
2011,Prince George County,51149,Asian ,119,80,39,45,38,37
2011,Prince William County,51153,Asian ,8568,7332,1236,353,386,240
2011,Pulaski County,51155,Asian ,37,0,37,27,95,27
2011,Rappahannock County,51157,Asian ,0,0,0,95,95,95
2011,Richmond County,51159,Asian ,5,5,0,8,8,95
2011,Roanoke County,51161,Asian ,758,510,248,95,102,77
2011,Rockbridge County,51163,Asian ,26,26,0,12,12,95
2011,Rockingham County,51165,Asian ,138,86,52,52,51,46
2011,Russell County,51167,Asian ,73,59,14,68,53,27
2011,Scott County,51169,Asian ,20,15,5,25,23,9
2011,Shenandoah County,51171,Asian ,90,86,4,40,40,6
2011,Smyth County,51173,Asian ,33,16,17,33,23,24
2011,Southampton County,51175,Asian ,11,11,0,16,16,95
2011,Spotsylvania County,51177,Asian ,911,796,115,145,134,73
2011,Stafford County,51179,Asian ,964,818,146,124,112,81
2011,Surry County,51181,Asian ,56,56,0,61,61,95
2011,Sussex County,51183,Asian ,0,0,0,95,95,95
2011,Tazewell County,51185,Asian ,123,96,27,52,53,41
2011,Warren County,51187,Asian ,71,24,47,43,24,43
2011,Washington County,51191,Asian ,42,30,12,38,26,21
2011,Westmoreland County,51193,Asian ,10,10,0,20,20,95
2011,Wise County,51195,Asian ,37,23,14,20,18,20
2011,Wythe County,51197,Asian ,21,9,12,24,17,19
2011,York County,51199,Asian ,1059,880,179,112,103,85
2011,Alexandria city,51510,Asian ,3548,1177,2371,283,217,267
2011,Bedford County,51019,Asian ,11,11,0,17,17,95
2011,Bristol city,51520,Asian ,30,23,7,14,10,12
2011,Buena Vista city,51530,Asian ,0,0,0,95,95,95
2011,Charlottesville city,51540,Asian ,768,170,598,168,69,162
2011,Chesapeake city,51550,Asian ,1710,1254,456,198,173,154
2011,Colonial Heights city,51570,Asian ,121,89,32,51,44,37
2011,Covington city,51580,Asian ,34,23,11,32,25,20
2011,Danville city,51590,Asian ,154,23,131,39,19,36
2011,Emporia city,51595,Asian ,18,18,0,24,24,95
2011,Fairfax city,51600,Asian ,1076,698,378,155,143,169
2011,Falls Church city,51610,Asian ,524,219,305,94,66,100
2011,Franklin city,51620,Asian ,54,23,31,48,34,39
2011,Fredericksburg city,51630,Asian ,200,83,117,66,44,56
2011,Galax city,51640,Asian ,0,0,0,95,95,95
2011,Hampton city,51650,Asian ,1011,658,353,133,128,125
2011,Harrisonburg city,51660,Asian ,584,278,306,157,108,128
2011,Hopewell city,51670,Asian ,20,20,0,21,21,95
2011,Lexington city,51678,Asian ,39,12,27,44,19,41
2011,Lynchburg city,51680,Asian ,493,162,331,98,74,91
2011,Manassas city,51683,Asian ,500,338,162,133,89,127
2011,Manassas Park city,51685,Asian ,291,285,6,86,86,11
2011,Martinsville city,51690,Asian ,27,27,0,15,15,95
2011,Newport News city,51700,Asian ,1574,935,639,176,165,164
2011,Norfolk city,51710,Asian ,2605,1211,1394,228,170,209
2011,Norton city,51720,Asian ,8,8,0,15,15,95
2011,Petersburg city,51730,Asian ,66,48,18,73,61,31
2011,Poquoson city,51735,Asian ,95,81,14,38,44,20
2011,Portsmouth city,51740,Asian ,393,309,84,86,87,48
2011,Radford city,51750,Asian ,134,30,104,74,31,78
2011,Richmond city,51760,Asian ,1426,398,1028,237,157,220
2011,Roanoke city,51770,Asian ,467,159,308,103,76,105
2011,Salem city,51775,Asian ,89,32,57,34,31,41
2011,Staunton city,51790,Asian ,20,12,8,24,20,13
2011,Suffolk city,51800,Asian ,353,320,33,107,109,34
2011,Virginia Beach city,51810,Asian ,8262,6408,1854,380,363,288
2011,Waynesboro city,51820,Asian ,42,34,8,24,22,13
2011,Williamsburg city,51830,Asian ,69,6,63,71,9,69
2011,Winchester city,51840,Asian ,285,131,154,69,69,95
2012,Accomack County,51001,Asian ,31,31,0,37,37,26
2012,Albemarle County,51003,Asian ,1279,608,671,154,139,196
2012,Alleghany County,51005,Asian ,31,31,0,33,33,19
2012,Amelia County,51007,Asian ,19,19,0,30,30,19
2012,Amherst County,51009,Asian ,54,47,7,36,35,12
2012,Appomattox County,51011,Asian ,10,10,0,19,19,19
2012,Arlington County,51013,Asian ,8103,2714,5389,491,310,465
2012,Augusta County,51015,Asian ,145,76,69,56,61,61
2012,Bath County,51017,Asian ,0,0,0,12,12,12
2012,Bedford County,51019,Asian ,257,122,135,61,59,80
2012,Bland County,51021,Asian ,0,0,0,17,17,17
2012,Botetourt County,51023,Asian ,37,37,0,40,40,26
2012,Brunswick County,51025,Asian ,15,15,0,23,23,19
2012,Buchanan County,51027,Asian ,22,22,0,22,22,23
2012,Buckingham County,51029,Asian ,40,12,28,46,21,41
2012,Campbell County,51031,Asian ,133,118,15,55,53,24
2012,Caroline County,51033,Asian ,33,33,0,20,20,23
2012,Carroll County,51035,Asian ,0,0,0,23,23,23
2012,Charles City County,51036,Asian ,4,4,0,4,4,17
2012,Charlotte County,51037,Asian ,3,3,0,5,5,19
2012,Chesterfield County,51041,Asian ,2774,2199,575,201,202,168
2012,Clarke County,51043,Asian ,33,32,1,17,17,2
2012,Craig County,51045,Asian ,0,0,0,17,17,17
2012,Culpeper County,51047,Asian ,146,106,40,52,51,38
2012,Cumberland County,51049,Asian ,0,0,0,17,17,17
2012,Dickenson County,51051,Asian ,9,9,0,12,12,19
2012,Dinwiddie County,51053,Asian ,25,9,16,18,15,16
2012,Essex County,51057,Asian ,5,0,5,8,19,8
2012,Fairfax County,51059,Asian ,58884,40620,18264,855,932,994
2012,Fauquier County,51061,Asian ,292,229,63,111,83,82
2012,Floyd County,51063,Asian ,42,42,0,41,41,19
2012,Fluvanna County,51065,Asian ,74,74,0,32,32,23
2012,Franklin County,51067,Asian ,49,23,26,42,39,34
2012,Frederick County,51069,Asian ,310,188,122,72,68,79
2012,Giles County,51071,Asian ,6,6,0,9,9,19
2012,Gloucester County,51073,Asian ,65,65,0,32,32,26
2012,Goochland County,51075,Asian ,4,4,0,6,6,23
2012,Grayson County,51077,Asian ,4,4,0,7,7,19
2012,Greene County,51079,Asian ,47,47,0,59,59,19
2012,Greensville County,51081,Asian ,7,7,0,12,12,19
2012,Halifax County,51083,Asian ,24,24,0,28,28,26
2012,Hanover County,51085,Asian ,353,254,99,69,80,66
2012,Henrico County,51087,Asian ,6338,3721,2617,271,260,240
2012,Henry County,51089,Asian ,70,34,36,22,24,28
2012,Highland County,51091,Asian ,0,0,0,12,12,12
2012,Isle of Wight County,51093,Asian ,96,86,10,31,26,18
2012,James City County,51095,Asian ,642,490,152,95,86,78
2012,King and Queen County,51097,Asian ,0,0,0,17,17,17
2012,King George County,51099,Asian ,89,62,27,45,43,28
2012,King William County,51101,Asian ,6,6,0,8,8,19
2012,Lancaster County,51103,Asian ,20,20,0,20,20,19
2012,Lee County,51105,Asian ,43,43,0,76,76,23
2012,Loudoun County,51107,Asian ,13357,11496,1861,460,456,271
2012,Louisa County,51109,Asian ,62,57,5,49,48,10
2012,Lunenburg County,51111,Asian ,2,2,0,4,4,19
2012,Madison County,51113,Asian ,20,20,0,30,30,19
2012,Mathews County,51115,Asian ,4,4,0,7,7,17
2012,Mecklenburg County,51117,Asian ,70,44,26,30,24,17
2012,Middlesex County,51119,Asian ,0,0,0,19,19,19
2012,Montgomery County,51121,Asian ,1687,381,1306,189,94,187
2012,Nelson County,51125,Asian ,20,0,20,34,19,34
2012,New Kent County,51127,Asian ,31,12,19,33,19,28
2012,Northampton County,51131,Asian ,13,13,0,16,16,19
2012,Northumberland County,51133,Asian ,0,0,0,19,19,19
2012,Nottoway County,51135,Asian ,8,8,0,12,12,19
2012,Orange County,51137,Asian ,49,35,14,32,28,22
2012,Page County,51139,Asian ,25,18,7,19,20,10
2012,Patrick County,51141,Asian ,0,0,0,19,19,19
2012,Pittsylvania County,51143,Asian ,41,41,0,32,32,29
2012,Powhatan County,51145,Asian ,34,34,0,20,20,23
2012,Prince Edward County,51147,Asian ,51,0,51,47,23,47
2012,Prince George County,51149,Asian ,183,131,52,67,63,46
2012,Prince William County,51153,Asian ,8533,7071,1462,336,340,265
2012,Pulaski County,51155,Asian ,39,0,39,28,26,28
2012,Rappahannock County,51157,Asian ,0,0,0,17,17,17
2012,Richmond County,51159,Asian ,5,5,0,8,8,17
2012,Roanoke County,51161,Asian ,697,503,194,113,124,85
2012,Rockbridge County,51163,Asian ,24,24,0,13,13,23
2012,Rockingham County,51165,Asian ,157,111,46,56,56,49
2012,Russell County,51167,Asian ,62,45,17,65,48,40
2012,Scott County,51169,Asian ,20,20,0,27,27,23
2012,Shenandoah County,51171,Asian ,86,82,4,51,50,8
2012,Smyth County,51173,Asian ,23,9,14,10,8,13
2012,Southampton County,51175,Asian ,9,9,0,14,14,19
2012,Spotsylvania County,51177,Asian ,883,761,122,130,119,81
2012,Stafford County,51179,Asian ,983,825,158,128,134,71
2012,Surry County,51181,Asian ,47,47,0,55,55,17
2012,Sussex County,51183,Asian ,0,0,0,19,19,19
2012,Tazewell County,51185,Asian ,64,39,25,74,60,39
2012,Warren County,51187,Asian ,86,26,60,55,25,54
2012,Washington County,51191,Asian ,46,27,19,30,19,20
2012,Westmoreland County,51193,Asian ,6,6,0,12,12,19
2012,Wise County,51195,Asian ,40,40,0,22,22,26
2012,Wythe County,51197,Asian ,58,23,35,37,13,42
2012,York County,51199,Asian ,1069,921,148,102,111,58
2012,Alexandria city,51510,Asian ,3596,1286,2310,301,242,279
2012,Bedford County,51019,Asian ,13,13,0,19,19,17
2012,Bristol city,51520,Asian ,30,24,6,13,10,11
2012,Buena Vista city,51530,Asian ,0,0,0,17,17,17
2012,Charlottesville city,51540,Asian ,841,196,645,121,88,134
2012,Chesapeake city,51550,Asian ,1816,1383,433,165,155,150
2012,Colonial Heights city,51570,Asian ,116,88,28,49,40,26
2012,Covington city,51580,Asian ,12,9,3,12,11,5
2012,Danville city,51590,Asian ,152,39,113,44,25,51
2012,Emporia city,51595,Asian ,10,6,4,14,13,9
2012,Fairfax city,51600,Asian ,1118,680,438,142,123,165
2012,Falls Church city,51610,Asian ,495,194,301,110,75,101
2012,Franklin city,51620,Asian ,38,16,22,35,25,28
2012,Fredericksburg city,51630,Asian ,212,51,161,90,49,94
2012,Galax city,51640,Asian ,3,0,3,14,17,14
2012,Hampton city,51650,Asian ,944,568,376,160,116,127
2012,Harrisonburg city,51660,Asian ,624,265,359,151,129,138
2012,Hopewell city,51670,Asian ,22,22,0,26,26,23
2012,Lexington city,51678,Asian ,19,19,0,21,21,17
2012,Lynchburg city,51680,Asian ,546,171,375,117,75,132
2012,Manassas city,51683,Asian ,463,300,163,90,68,92
2012,Manassas Park city,51685,Asian ,258,248,10,71,70,16
2012,Martinsville city,51690,Asian ,54,54,0,47,47,19
2012,Newport News city,51700,Asian ,1528,973,555,141,145,154
2012,Norfolk city,51710,Asian ,2526,1224,1302,231,139,191
2012,Norton city,51720,Asian ,0,0,0,12,12,12
2012,Petersburg city,51730,Asian ,86,68,18,63,56,28
2012,Poquoson city,51735,Asian ,108,95,13,35,35,21
2012,Portsmouth city,51740,Asian ,364,256,108,97,93,55
2012,Radford city,51750,Asian ,74,30,44,45,22,46
2012,Richmond city,51760,Asian ,1356,309,1047,196,117,170
2012,Roanoke city,51770,Asian ,512,173,339,102,69,115
2012,Salem city,51775,Asian ,103,52,51,38,39,39
2012,Staunton city,51790,Asian ,29,0,29,39,23,39
2012,Suffolk city,51800,Asian ,344,272,72,137,122,51
2012,Virginia Beach city,51810,Asian ,8674,6449,2225,353,334,302
2012,Waynesboro city,51820,Asian ,54,42,12,30,24,19
2012,Williamsburg city,51830,Asian ,33,0,33,49,19,49
2012,Winchester city,51840,Asian ,300,147,153,71,72,93
2013,Accomack County,51001,Asian ,24,20,4,24,24,6
2013,Albemarle County,51003,Asian ,1337,599,738,175,126,177
2013,Alleghany County,51005,Asian ,10,10,0,8,8,19
2013,Amelia County,51007,Asian ,0,0,0,19,19,19
2013,Amherst County,51009,Asian ,52,44,8,25,24,14
2013,Appomattox County,51011,Asian ,10,10,0,16,16,19
2013,Arlington County,51013,Asian ,8107,2461,5646,431,319,422
2013,Augusta County,51015,Asian ,152,75,77,64,50,73
2013,Bath County,51017,Asian ,0,0,0,12,12,12
2013,Bedford County,51019,Asian ,252,112,140,61,61,81
2013,Bland County,51021,Asian ,0,0,0,17,17,17
2013,Botetourt County,51023,Asian ,7,7,0,12,12,26
2013,Brunswick County,51025,Asian ,18,18,0,31,31,19
2013,Buchanan County,51027,Asian ,24,24,0,32,32,23
2013,Buckingham County,51029,Asian ,12,12,0,20,20,19
2013,Campbell County,51031,Asian ,133,87,46,51,51,49
2013,Caroline County,51033,Asian ,38,38,0,27,27,23
2013,Carroll County,51035,Asian ,0,0,0,23,23,23
2013,Charles City County,51036,Asian ,5,5,0,5,5,17
2013,Charlotte County,51037,Asian ,2,2,0,4,4,19
2013,Chesterfield County,51041,Asian ,2915,2194,721,185,202,179
2013,Clarke County,51043,Asian ,17,15,2,14,14,4
2013,Craig County,51045,Asian ,0,0,0,17,17,17
2013,Culpeper County,51047,Asian ,173,131,42,57,66,34
2013,Cumberland County,51049,Asian ,0,0,0,17,17,17
2013,Dickenson County,51051,Asian ,7,7,0,9,9,19
2013,Dinwiddie County,51053,Asian ,29,12,17,19,20,13
2013,Essex County,51057,Asian ,7,0,7,18,19,18
2013,Fairfax County,51059,Asian ,59515,40840,18675,862,814,880
2013,Fauquier County,51061,Asian ,217,213,4,68,68,7
2013,Floyd County,51063,Asian ,35,35,0,36,36,19
2013,Fluvanna County,51065,Asian ,58,58,0,37,37,23
2013,Franklin County,51067,Asian ,26,26,0,43,43,29
2013,Frederick County,51069,Asian ,329,193,136,61,60,58
2013,Giles County,51071,Asian ,8,8,0,13,13,19
2013,Gloucester County,51073,Asian ,39,39,0,32,32,26
2013,Goochland County,51075,Asian ,3,3,0,5,5,23
2013,Grayson County,51077,Asian ,4,4,0,9,9,19
2013,Greene County,51079,Asian ,54,54,0,49,49,19
2013,Greensville County,51081,Asian ,8,8,0,12,12,19
2013,Halifax County,51083,Asian ,61,38,23,37,23,36
2013,Hanover County,51085,Asian ,374,263,111,76,103,70
2013,Henrico County,51087,Asian ,6648,3876,2772,316,251,272
2013,Henry County,51089,Asian ,90,36,54,28,21,33
2013,Highland County,51091,Asian ,0,0,0,12,12,12
2013,Isle of Wight County,51093,Asian ,97,90,7,32,29,15
2013,James City County,51095,Asian ,646,501,145,103,77,96
2013,King and Queen County,51097,Asian ,0,0,0,17,17,17
2013,King George County,51099,Asian ,72,53,19,47,45,21
2013,King William County,51101,Asian ,9,9,0,14,14,19
2013,Lancaster County,51103,Asian ,23,23,0,23,23,19
2013,Lee County,51105,Asian ,25,25,0,29,29,23
2013,Loudoun County,51107,Asian ,14132,12268,1864,412,396,304
2013,Louisa County,51109,Asian ,46,41,5,46,45,8
2013,Lunenburg County,51111,Asian ,3,3,0,5,5,19
2013,Madison County,51113,Asian ,20,20,0,33,33,19
2013,Mathews County,51115,Asian ,4,4,0,7,7,17
2013,Mecklenburg County,51117,Asian ,25,3,22,20,5,19
2013,Middlesex County,51119,Asian ,0,0,0,19,19,19
2013,Montgomery County,51121,Asian ,1685,383,1302,204,85,217
2013,Nelson County,51125,Asian ,12,0,12,20,19,20
2013,New Kent County,51127,Asian ,34,22,12,38,29,20
2013,Northampton County,51131,Asian ,14,14,0,18,18,19
2013,Northumberland County,51133,Asian ,0,0,0,19,19,19
2013,Nottoway County,51135,Asian ,10,10,0,18,18,19
2013,Orange County,51137,Asian ,66,45,21,45,24,33
2013,Page County,51139,Asian ,27,23,4,15,17,9
2013,Patrick County,51141,Asian ,0,0,0,19,19,19
2013,Pittsylvania County,51143,Asian ,25,25,0,29,29,29
2013,Powhatan County,51145,Asian ,44,44,0,24,24,23
2013,Prince Edward County,51147,Asian ,53,0,53,27,23,27
2013,Prince George County,51149,Asian ,157,95,62,64,48,58
2013,Prince William County,51153,Asian ,8845,7228,1617,364,389,278
2013,Pulaski County,51155,Asian ,47,0,47,22,26,22
2013,Rappahannock County,51157,Asian ,0,0,0,17,17,17
2013,Richmond County,51159,Asian ,47,47,0,57,57,17
2013,Roanoke County,51161,Asian ,730,472,258,122,108,89
2013,Rockbridge County,51163,Asian ,25,25,0,17,17,23
2013,Rockingham County,51165,Asian ,126,111,15,54,57,22
2013,Russell County,51167,Asian ,34,24,10,44,37,21
2013,Scott County,51169,Asian ,27,12,15,27,20,20
2013,Shenandoah County,51171,Asian ,112,108,4,77,75,6
2013,Smyth County,51173,Asian ,21,11,10,9,9,11
2013,Southampton County,51175,Asian ,14,11,3,16,17,6
2013,Spotsylvania County,51177,Asian ,919,773,146,124,121,76
2013,Stafford County,51179,Asian ,968,760,208,127,116,94
2013,Surry County,51181,Asian ,55,51,4,57,56,7
2013,Sussex County,51183,Asian ,0,0,0,19,19,19
2013,Tazewell County,51185,Asian ,75,57,18,44,45,24
2013,Warren County,51187,Asian ,83,35,48,36,24,35
2013,Washington County,51191,Asian ,28,22,6,21,19,12
2013,Westmoreland County,51193,Asian ,5,5,0,9,9,19
2013,Wise County,51195,Asian ,36,36,0,20,20,26
2013,Wythe County,51197,Asian ,80,37,43,46,22,45
2013,York County,51199,Asian ,1090,937,153,122,134,66
2013,Alexandria city,51510,Asian ,3580,1285,2295,270,211,240
2013,Bedford County,51019,Asian ,0,0,0,17,17,17
2013,Bristol city,51520,Asian ,31,31,0,9,9,19
2013,Buena Vista city,51530,Asian ,0,0,0,17,17,17
2013,Charlottesville city,51540,Asian ,892,199,693,111,87,116
2013,Chesapeake city,51550,Asian ,2003,1532,471,175,158,144
2013,Colonial Heights city,51570,Asian ,175,114,61,45,47,39
2013,Covington city,51580,Asian ,18,15,3,15,15,6
2013,Danville city,51590,Asian ,175,46,129,45,38,55
2013,Emporia city,51595,Asian ,43,36,7,40,37,13
2013,Fairfax city,51600,Asian ,982,561,421,128,116,133
2013,Falls Church city,51610,Asian ,510,173,337,99,76,102
2013,Franklin city,51620,Asian ,58,20,38,55,34,47
2013,Fredericksburg city,51630,Asian ,179,76,103,78,54,64
2013,Galax city,51640,Asian ,4,0,4,10,17,10
2013,Hampton city,51650,Asian ,859,530,329,125,100,101
2013,Harrisonburg city,51660,Asian ,583,203,380,178,110,163
2013,Hopewell city,51670,Asian ,72,43,29,59,41,45
2013,Lexington city,51678,Asian ,44,44,0,34,34,17
2013,Lynchburg city,51680,Asian ,592,165,427,104,57,118
2013,Manassas city,51683,Asian ,535,347,188,108,82,82
2013,Manassas Park city,51685,Asian ,263,234,29,90,89,34
2013,Martinsville city,51690,Asian ,8,8,0,12,12,19
2013,Newport News city,51700,Asian ,1452,930,522,190,149,189
2013,Norfolk city,51710,Asian ,2599,1266,1333,208,153,205
2013,Norton city,51720,Asian ,0,0,0,12,12,12
2013,Petersburg city,51730,Asian ,112,94,18,55,49,29
2013,Poquoson city,51735,Asian ,97,84,13,39,44,20
2013,Portsmouth city,51740,Asian ,396,227,169,121,82,98
2013,Radford city,51750,Asian ,65,32,33,51,24,44
2013,Richmond city,51760,Asian ,1525,355,1170,211,106,179
2013,Roanoke city,51770,Asian ,533,103,430,91,63,118
2013,Salem city,51775,Asian ,134,45,89,44,36,41
2013,Staunton city,51790,Asian ,36,9,27,40,15,37
2013,Suffolk city,51800,Asian ,386,342,44,161,161,43
2013,Virginia Beach city,51810,Asian ,8530,6213,2317,345,382,319
2013,Waynesboro city,51820,Asian ,61,52,9,29,28,17
2013,Williamsburg city,51830,Asian ,34,0,34,43,19,43
2013,Winchester city,51840,Asian ,305,130,175,67,61,92
2014,Accomack County,51001,Asian ,31,19,12,32,24,17
2014,Albemarle County,51003,Asian ,1358,605,753,163,125,173
2014,Alleghany County,51005,Asian ,8,8,0,13,13,19
2014,Amelia County,51007,Asian ,0,0,0,19,19,19
2014,Amherst County,51009,Asian ,43,33,10,34,28,17
2014,Appomattox County,51011,Asian ,11,11,0,17,17,19
2014,Arlington County,51013,Asian ,8587,2683,5904,460,291,506
2014,Augusta County,51015,Asian ,157,82,75,63,61,67
2014,Bath County,51017,Asian ,0,0,0,12,12,12
2014,Bedford County,51019,Asian ,351,172,179,93,82,94
2014,Bland County,51021,Asian ,0,0,0,17,17,17
2014,Botetourt County,51023,Asian ,11,7,4,14,11,8
2014,Brunswick County,51025,Asian ,0,0,0,19,19,19
2014,Buchanan County,51027,Asian ,48,38,10,38,35,20
2014,Buckingham County,51029,Asian ,7,7,0,12,12,19
2014,Campbell County,51031,Asian ,120,58,62,56,40,58
2014,Caroline County,51033,Asian ,54,54,0,26,26,22
2014,Carroll County,51035,Asian ,0,0,0,22,22,22
2014,Charles City County,51036,Asian ,6,6,0,7,7,17
2014,Charlotte County,51037,Asian ,3,3,0,5,5,19
2014,Chesterfield County,51041,Asian ,2868,2262,606,209,231,156
2014,Clarke County,51043,Asian ,22,21,1,12,12,3
2014,Craig County,51045,Asian ,0,0,0,17,17,17
2014,Culpeper County,51047,Asian ,100,69,31,44,38,30
2014,Cumberland County,51049,Asian ,0,0,0,17,17,17
2014,Dickenson County,51051,Asian ,3,3,0,5,5,19
2014,Dinwiddie County,51053,Asian ,20,11,9,22,19,13
2014,Essex County,51057,Asian ,0,0,0,19,19,19
2014,Fairfax County,51059,Asian ,60641,41089,19552,871,871,916
2014,Fauquier County,51061,Asian ,188,184,4,57,58,6
2014,Floyd County,51063,Asian ,49,49,0,55,55,19
2014,Fluvanna County,51065,Asian ,54,54,0,48,48,22
2014,Franklin County,51067,Asian ,29,29,0,43,43,28
2014,Frederick County,51069,Asian ,332,206,126,76,71,68
2014,Giles County,51071,Asian ,24,24,0,26,26,19
2014,Gloucester County,51073,Asian ,36,36,0,43,43,25
2014,Goochland County,51075,Asian ,30,30,0,33,33,22
2014,Grayson County,51077,Asian ,0,0,0,19,19,19
2014,Greene County,51079,Asian ,39,39,0,21,21,19
2014,Greensville County,51081,Asian ,8,8,0,12,12,19
2014,Halifax County,51083,Asian ,44,30,14,36,30,23
2014,Hanover County,51085,Asian ,423,330,93,72,58,57
2014,Henrico County,51087,Asian ,6810,3720,3090,306,313,282
2014,Henry County,51089,Asian ,72,37,35,30,20,27
2014,Highland County,51091,Asian ,0,0,0,12,12,12
2014,Isle of Wight County,51093,Asian ,88,79,9,38,31,18
2014,James City County,51095,Asian ,653,410,243,129,86,114
2014,King and Queen County,51097,Asian ,0,0,0,17,17,17
2014,King George County,51099,Asian ,65,45,20,41,40,20
2014,King William County,51101,Asian ,41,41,0,15,15,19
2014,Lancaster County,51103,Asian ,21,21,0,13,13,19
2014,Lee County,51105,Asian ,30,30,0,56,56,22
2014,Loudoun County,51107,Asian ,14623,12548,2075,464,477,334
2014,Louisa County,51109,Asian ,72,67,5,32,32,10
2014,Lunenburg County,51111,Asian ,4,4,0,5,5,19
2014,Madison County,51113,Asian ,18,18,0,30,30,19
2014,Mathews County,51115,Asian ,4,4,0,7,7,17
2014,Mecklenburg County,51117,Asian ,60,16,44,45,20,39
2014,Middlesex County,51119,Asian ,0,0,0,19,19,19
2014,Montgomery County,51121,Asian ,1681,355,1326,248,75,270
2014,Nelson County,51125,Asian ,18,0,18,30,19,30
2014,New Kent County,51127,Asian ,37,37,0,34,34,19
2014,Northampton County,51131,Asian ,24,24,0,12,12,19
2014,Northumberland County,51133,Asian ,8,8,0,13,13,19
2014,Nottoway County,51135,Asian ,12,12,0,25,25,19
2014,Orange County,51137,Asian ,94,54,40,32,29,34
2014,Page County,51139,Asian ,34,18,16,17,14,17
2014,Patrick County,51141,Asian ,0,0,0,19,19,19
2014,Pittsylvania County,51143,Asian ,58,58,0,42,42,28
2014,Powhatan County,51145,Asian ,35,35,0,19,19,22
2014,Prince Edward County,51147,Asian ,72,0,72,28,22,28
2014,Prince George County,51149,Asian ,175,97,78,60,49,47
2014,Prince William County,51153,Asian ,8840,7285,1555,375,428,314
2014,Pulaski County,51155,Asian ,0,0,0,25,25,25
2014,Rappahannock County,51157,Asian ,11,0,11,17,17,17
2014,Richmond County,51159,Asian ,43,43,0,54,54,17
2014,Roanoke County,51161,Asian ,705,408,297,127,94,100
2014,Rockbridge County,51163,Asian ,28,28,0,22,22,22
2014,Rockingham County,51165,Asian ,109,98,11,37,33,16
2014,Russell County,51167,Asian ,10,0,10,23,22,23
2014,Scott County,51169,Asian ,16,9,7,18,13,12
2014,Shenandoah County,51171,Asian ,71,69,2,41,41,4
2014,Smyth County,51173,Asian ,30,19,11,13,13,13
2014,Southampton County,51175,Asian ,4,0,4,6,19,6
2014,Spotsylvania County,51177,Asian ,1014,767,247,164,136,108
2014,Stafford County,51179,Asian ,1092,806,286,159,142,110
2014,Surry County,51181,Asian ,46,43,3,53,52,5
2014,Sussex County,51183,Asian ,0,0,0,19,19,19
2014,Tazewell County,51185,Asian ,68,35,33,54,54,37
2014,Warren County,51187,Asian ,87,54,33,36,33,31
2014,Washington County,51191,Asian ,62,40,22,29,24,22
2014,Westmoreland County,51193,Asian ,8,8,0,14,14,19
2014,Wise County,51195,Asian ,53,53,0,25,25,25
2014,Wythe County,51197,Asian ,86,46,40,43,27,47
2014,York County,51199,Asian ,1152,956,196,123,125,77
2014,Alexandria city,51510,Asian ,3826,1322,2504,237,211,286
2014,Bristol city,51520,Asian ,20,20,0,15,15,19
2014,Buena Vista city,51530,Asian ,70,0,70,59,17,59
2014,Charlottesville city,51540,Asian ,836,207,629,127,71,105
2014,Chesapeake city,51550,Asian ,2098,1726,372,194,178,136
2014,Colonial Heights city,51570,Asian ,148,116,32,36,36,26
2014,Covington city,51580,Asian ,11,0,11,18,17,18
2014,Danville city,51590,Asian ,174,46,128,35,32,43
2014,Emporia city,51595,Asian ,34,28,6,29,27,10
2014,Fairfax city,51600,Asian ,946,559,387,122,110,128
2014,Falls Church city,51610,Asian ,518,179,339,104,70,109
2014,Franklin city,51620,Asian ,37,0,37,41,17,41
2014,Fredericksburg city,51630,Asian ,147,98,49,60,52,47
2014,Galax city,51640,Asian ,4,0,4,13,17,13
2014,Hampton city,51650,Asian ,808,518,290,143,96,130
2014,Harrisonburg city,51660,Asian ,495,119,376,155,86,145
2014,Hopewell city,51670,Asian ,105,41,64,64,39,64
2014,Lexington city,51678,Asian ,31,27,4,31,26,13
2014,Lynchburg city,51680,Asian ,606,115,491,164,50,166
2014,Manassas city,51683,Asian ,616,418,198,107,94,96
2014,Manassas Park city,51685,Asian ,297,255,42,71,67,39
2014,Martinsville city,51690,Asian ,9,9,0,15,15,19
2014,Newport News city,51700,Asian ,1642,1061,581,186,143,153
2014,Norfolk city,51710,Asian ,2448,1284,1164,186,142,154
2014,Norton city,51720,Asian ,0,0,0,12,12,12
2014,Petersburg city,51730,Asian ,164,85,79,82,65,53
2014,Poquoson city,51735,Asian ,106,106,0,62,62,19
2014,Portsmouth city,51740,Asian ,375,203,172,100,75,78
2014,Radford city,51750,Asian ,40,40,0,31,31,19
2014,Richmond city,51760,Asian ,1568,361,1207,183,106,165
2014,Roanoke city,51770,Asian ,575,151,424,111,71,122
2014,Salem city,51775,Asian ,168,93,75,53,47,46
2014,Staunton city,51790,Asian ,50,10,40,40,16,41
2014,Suffolk city,51800,Asian ,302,247,55,100,99,41
2014,Virginia Beach city,51810,Asian ,8696,6244,2452,367,341,314
2014,Waynesboro city,51820,Asian ,62,40,22,41,32,37
2014,Williamsburg city,51830,Asian ,101,29,72,36,31,41
2014,Winchester city,51840,Asian ,242,129,113,52,50,56
2015,Accomack County,51001,Asian ,31,9,22,22,13,18
2015,Albemarle County,51003,Asian ,1272,595,677,180,135,172
2015,Alleghany County,51005,Asian ,7,7,0,12,12,19
2015,Amelia County,51007,Asian ,0,0,0,19,19,19
2015,Amherst County,51009,Asian ,53,40,13,31,26,18
2015,Appomattox County,51011,Asian ,8,8,0,12,12,19
2015,Arlington County,51013,Asian ,8904,2816,6088,483,371,463
2015,Augusta County,51015,Asian ,153,94,59,72,60,69
2015,Bath County,51017,Asian ,0,0,0,12,12,12
2015,Bedford County,51019,Asian ,340,154,186,95,81,110
2015,Bland County,51021,Asian ,0,0,0,17,17,17
2015,Botetourt County,51023,Asian ,32,24,8,28,25,12
2015,Brunswick County,51025,Asian ,0,0,0,19,19,19
2015,Buchanan County,51027,Asian ,28,25,3,9,10,7
2015,Buckingham County,51029,Asian ,14,14,0,16,16,19
2015,Campbell County,51031,Asian ,134,53,81,64,46,67
2015,Caroline County,51033,Asian ,43,43,0,31,31,22
2015,Carroll County,51035,Asian ,15,15,0,28,28,22
2015,Charles City County,51036,Asian ,8,8,0,7,7,17
2015,Charlotte County,51037,Asian ,1,1,0,4,4,19
2015,Chesterfield County,51041,Asian ,3123,2456,667,249,206,154
2015,Clarke County,51043,Asian ,32,13,19,31,17,24
2015,Craig County,51045,Asian ,0,0,0,17,17,17
2015,Culpeper County,51047,Asian ,110,84,26,44,39,30
2015,Cumberland County,51049,Asian ,0,0,0,17,17,17
2015,Dickenson County,51051,Asian ,4,4,0,8,8,19
2015,Dinwiddie County,51053,Asian ,21,15,6,21,19,8
2015,Essex County,51057,Asian ,0,0,0,19,19,19
2015,Fairfax County,51059,Asian ,62336,41641,20695,733,969,824
2015,Fauquier County,51061,Asian ,190,173,17,50,49,23
2015,Floyd County,51063,Asian ,0,0,0,19,19,19
2015,Fluvanna County,51065,Asian ,45,45,0,30,30,22
2015,Franklin County,51067,Asian ,40,40,0,47,47,28
2015,Frederick County,51069,Asian ,241,157,84,52,56,42
2015,Giles County,51071,Asian ,35,35,0,31,31,19
2015,Gloucester County,51073,Asian ,28,28,0,36,36,25
2015,Goochland County,51075,Asian ,92,92,0,27,27,22
2015,Grayson County,51077,Asian ,0,0,0,19,19,19
2015,Greene County,51079,Asian ,68,68,0,37,37,19
2015,Greensville County,51081,Asian ,0,0,0,19,19,19
2015,Halifax County,51083,Asian ,58,49,9,21,20,16
2015,Hanover County,51085,Asian ,418,329,89,72,62,57
2015,Henrico County,51087,Asian ,7234,3994,3240,314,282,304
2015,Henry County,51089,Asian ,68,41,27,24,25,24
2015,Highland County,51091,Asian ,0,0,0,12,12,12
2015,Isle of Wight County,51093,Asian ,70,70,0,50,50,25
2015,James City County,51095,Asian ,556,378,178,96,78,85
2015,King and Queen County,51097,Asian ,0,0,0,17,17,17
2015,King George County,51099,Asian ,65,58,7,41,39,12
2015,King William County,51101,Asian ,46,32,14,12,20,22
2015,Lancaster County,51103,Asian ,20,19,1,11,9,4
2015,Lee County,51105,Asian ,49,49,0,62,62,22
2015,Loudoun County,51107,Asian ,15769,13698,2071,577,540,288
2015,Louisa County,51109,Asian ,43,43,0,23,23,25
2015,Lunenburg County,51111,Asian ,2,2,0,4,4,19
2015,Madison County,51113,Asian ,0,0,0,19,19,19
2015,Mathews County,51115,Asian ,9,9,0,16,16,17
2015,Mecklenburg County,51117,Asian ,41,16,25,34,14,30
2015,Middlesex County,51119,Asian ,0,0,0,19,19,19
2015,Montgomery County,51121,Asian ,1678,303,1375,237,85,255
2015,Nelson County,51125,Asian ,0,0,0,19,19,19
2015,New Kent County,51127,Asian ,63,63,0,45,45,22
2015,Northampton County,51131,Asian ,25,25,0,12,12,19
2015,Northumberland County,51133,Asian ,7,7,0,13,13,19
2015,Nottoway County,51135,Asian ,28,28,0,45,45,19
2015,Orange County,51137,Asian ,67,41,26,30,22,28
2015,Page County,51139,Asian ,32,20,12,22,14,21
2015,Patrick County,51141,Asian ,0,0,0,19,19,19
2015,Pittsylvania County,51143,Asian ,55,55,0,51,51,28
2015,Powhatan County,51145,Asian ,55,55,0,20,20,22
2015,Prince Edward County,51147,Asian ,68,0,68,81,22,81
2015,Prince George County,51149,Asian ,182,101,81,73,71,50
2015,Prince William County,51153,Asian ,9193,7494,1699,317,382,309
2015,Pulaski County,51155,Asian ,7,0,7,17,25,17
2015,Rappahannock County,51157,Asian ,16,0,16,23,17,23
2015,Richmond County,51159,Asian ,36,36,0,41,41,17
2015,Roanoke County,51161,Asian ,797,481,316,167,121,122
2015,Rockbridge County,51163,Asian ,27,27,0,15,15,22
2015,Rockingham County,51165,Asian ,108,91,17,31,34,17
2015,Russell County,51167,Asian ,0,0,0,22,22,22
2015,Scott County,51169,Asian ,11,2,9,6,4,6
2015,Shenandoah County,51171,Asian ,23,23,0,26,26,25
2015,Smyth County,51173,Asian ,31,21,10,12,13,13
2015,Southampton County,51175,Asian ,6,0,6,10,19,10
2015,Spotsylvania County,51177,Asian ,900,706,194,134,108,87
2015,Stafford County,51179,Asian ,1138,817,321,132,111,109
2015,Surry County,51181,Asian ,39,35,4,43,42,8
2015,Sussex County,51183,Asian ,0,0,0,19,19,19
2015,Tazewell County,51185,Asian ,65,21,44,66,43,52
2015,Warren County,51187,Asian ,111,71,40,58,50,40
2015,Washington County,51191,Asian ,78,40,38,36,30,31
2015,Westmoreland County,51193,Asian ,11,11,0,18,18,19
2015,Wise County,51195,Asian ,46,46,0,16,16,25
2015,Wythe County,51197,Asian ,76,38,38,40,23,42
2015,York County,51199,Asian ,1126,902,224,119,109,91
2015,Alexandria city,51510,Asian ,4108,1751,2357,292,244,293
2015,Bristol city,51520,Asian ,31,31,0,19,19,19
2015,Buena Vista city,51530,Asian ,134,0,134,83,17,83
2015,Charlottesville city,51540,Asian ,819,202,617,126,97,102
2015,Chesapeake city,51550,Asian ,2156,1809,347,227,181,136
2015,Colonial Heights city,51570,Asian ,146,92,54,29,34,33
2015,Covington city,51580,Asian ,13,13,0,22,22,17
2015,Danville city,51590,Asian ,181,58,123,39,40,41
2015,Emporia city,51595,Asian ,20,5,15,23,10,21
2015,Fairfax city,51600,Asian ,1024,618,406,95,111,128
2015,Falls Church city,51610,Asian ,724,197,527,160,75,154
2015,Franklin city,51620,Asian ,6,0,6,9,17,9
2015,Fredericksburg city,51630,Asian ,178,90,88,68,44,60
2015,Galax city,51640,Asian ,10,0,10,17,17,17
2015,Hampton city,51650,Asian ,777,499,278,133,132,120
2015,Harrisonburg city,51660,Asian ,430,159,271,96,62,100
2015,Hopewell city,51670,Asian ,138,58,80,79,47,81
2015,Lexington city,51678,Asian ,41,16,25,47,22,40
2015,Lynchburg city,51680,Asian ,596,155,441,141,58,138
2015,Manassas city,51683,Asian ,668,447,221,113,87,89
2015,Manassas Park city,51685,Asian ,351,316,35,85,85,41
2015,Martinsville city,51690,Asian ,9,9,0,13,13,19
2015,Newport News city,51700,Asian ,1822,1089,733,181,179,161
2015,Norfolk city,51710,Asian ,2527,1362,1165,230,137,209
2015,Norton city,51720,Asian ,54,23,31,63,32,54
2015,Petersburg city,51730,Asian ,219,104,115,60,86,74
2015,Poquoson city,51735,Asian ,51,51,0,38,38,19
2015,Portsmouth city,51740,Asian ,345,165,180,105,54,94
2015,Radford city,51750,Asian ,51,37,14,40,31,27
2015,Richmond city,51760,Asian ,1689,514,1175,173,110,148
2015,Roanoke city,51770,Asian ,620,202,418,108,94,106
2015,Salem city,51775,Asian ,198,102,96,45,55,60
2015,Staunton city,51790,Asian ,61,9,52,41,16,40
2015,Suffolk city,51800,Asian ,443,316,127,83,88,71
2015,Virginia Beach city,51810,Asian ,8819,6281,2538,385,340,308
2015,Waynesboro city,51820,Asian ,76,31,45,50,27,54
2015,Williamsburg city,51830,Asian ,42,6,36,47,11,43
2015,Winchester city,51840,Asian ,251,108,143,71,47,66
2016,Accomack County,51001,Asian ,28,8,20,24,11,22
2016,Albemarle County,51003,Asian ,1229,619,610,157,116,159
2016,Alleghany County,51005,Asian ,0,0,0,19,19,19
2016,Amelia County,51007,Asian ,0,0,0,19,19,19
2016,Amherst County,51009,Asian ,40,28,12,26,24,15
2016,Appomattox County,51011,Asian ,0,0,0,19,19,19
2016,Arlington County,51013,Asian ,9272,2971,6301,416,302,412
2016,Augusta County,51015,Asian ,109,80,29,79,55,44
2016,Bath County,51017,Asian ,0,0,0,12,12,12
2016,Bedford County,51019,Asian ,361,155,206,88,68,95
2016,Bland County,51021,Asian ,0,0,0,17,17,17
2016,Botetourt County,51023,Asian ,104,82,22,59,56,31
2016,Brunswick County,51025,Asian ,0,0,0,19,19,19
2016,Buchanan County,51027,Asian ,28,22,6,10,10,10
2016,Buckingham County,51029,Asian ,13,13,0,16,16,19
2016,Campbell County,51031,Asian ,121,50,71,47,31,57
2016,Caroline County,51033,Asian ,42,42,0,46,46,22
2016,Carroll County,51035,Asian ,23,23,0,37,37,22
2016,Charles City County,51036,Asian ,23,16,7,11,8,11
2016,Charlotte County,51037,Asian ,1,1,0,4,4,19
2016,Chesterfield County,51041,Asian ,3416,2556,860,244,235,184
2016,Clarke County,51043,Asian ,39,20,19,29,21,23
2016,Craig County,51045,Asian ,0,0,0,17,17,17
2016,Culpeper County,51047,Asian ,120,90,30,40,39,30
2016,Cumberland County,51049,Asian ,0,0,0,17,17,17
2016,Dickenson County,51051,Asian ,1,1,0,3,3,19
2016,Dinwiddie County,51053,Asian ,25,0,25,29,22,29
2016,Essex County,51057,Asian ,16,16,0,84,84,19
2016,Fairfax County,51059,Asian ,63887,42693,21194,901,1061,879
2016,Fauquier County,51061,Asian ,257,212,45,42,54,35
2016,Floyd County,51063,Asian ,0,0,0,19,19,19
2016,Fluvanna County,51065,Asian ,50,50,0,34,34,22
2016,Franklin County,51067,Asian ,34,27,7,38,35,13
2016,Frederick County,51069,Asian ,257,162,95,67,65,51
2016,Giles County,51071,Asian ,18,18,0,21,21,19
2016,Gloucester County,51073,Asian ,51,51,0,47,47,25
2016,Goochland County,51075,Asian ,104,104,0,35,35,22
2016,Grayson County,51077,Asian ,10,10,0,15,15,19
2016,Greene County,51079,Asian ,72,72,0,29,29,19
2016,Greensville County,51081,Asian ,0,0,0,19,19,19
2016,Halifax County,51083,Asian ,70,59,11,21,21,18
2016,Hanover County,51085,Asian ,388,316,72,72,62,57
2016,Henrico County,51087,Asian ,7606,4218,3388,381,292,351
2016,Henry County,51089,Asian ,73,35,38,31,22,35
2016,Highland County,51091,Asian ,0,0,0,12,12,12
2016,Isle of Wight County,51093,Asian ,48,48,0,53,53,25
2016,James City County,51095,Asian ,533,358,175,120,88,113
2016,King and Queen County,51097,Asian ,0,0,0,17,17,17
2016,King George County,51099,Asian ,91,89,2,44,45,4
2016,King William County,51101,Asian ,50,33,17,13,24,26
2016,Lancaster County,51103,Asian ,26,25,1,18,15,4
2016,Lee County,51105,Asian ,29,29,0,34,34,22
2016,Loudoun County,51107,Asian ,16581,14539,2042,442,495,322
2016,Louisa County,51109,Asian ,48,48,0,28,28,25
2016,Lunenburg County,51111,Asian ,49,39,10,50,50,16
2016,Madison County,51113,Asian ,11,0,11,16,19,16
2016,Mathews County,51115,Asian ,14,14,0,21,21,17
2016,Mecklenburg County,51117,Asian ,13,4,9,13,6,12
2016,Middlesex County,51119,Asian ,0,0,0,19,19,19
2016,Montgomery County,51121,Asian ,1665,336,1329,203,96,201
2016,Nelson County,51125,Asian ,0,0,0,19,19,19
2016,New Kent County,51127,Asian ,107,107,0,57,57,22
2016,Northampton County,51131,Asian ,22,22,0,10,10,19
2016,Northumberland County,51133,Asian ,6,6,0,11,11,19
2016,Nottoway County,51135,Asian ,29,29,0,48,48,19
2016,Orange County,51137,Asian ,68,45,23,22,20,23
2016,Page County,51139,Asian ,38,26,12,24,16,21
2016,Patrick County,51141,Asian ,0,0,0,19,19,19
2016,Pittsylvania County,51143,Asian ,79,64,15,36,38,23
2016,Powhatan County,51145,Asian ,43,43,0,46,46,22
2016,Prince Edward County,51147,Asian ,36,0,36,26,22,26
2016,Prince George County,51149,Asian ,173,96,77,65,51,43
2016,Prince William County,51153,Asian ,9251,7451,1800,395,321,277
2016,Pulaski County,51155,Asian ,44,33,11,52,48,23
2016,Rappahannock County,51157,Asian ,18,0,18,28,17,28
2016,Richmond County,51159,Asian ,64,64,0,65,65,17
2016,Roanoke County,51161,Asian ,660,349,311,136,88,123
2016,Rockbridge County,51163,Asian ,23,23,0,26,26,22
2016,Rockingham County,51165,Asian ,115,86,29,28,21,23
2016,Russell County,51167,Asian ,0,0,0,22,22,22
2016,Scott County,51169,Asian ,8,0,8,7,22,7
2016,Shenandoah County,51171,Asian ,48,11,37,57,16,57
2016,Smyth County,51173,Asian ,41,17,24,37,15,37
2016,Southampton County,51175,Asian ,3,0,3,4,19,4
2016,Spotsylvania County,51177,Asian ,842,664,178,118,107,59
2016,Stafford County,51179,Asian ,1299,949,350,133,133,103
2016,Surry County,51181,Asian ,9,0,9,15,17,15
2016,Sussex County,51183,Asian ,34,0,34,51,19,51
2016,Tazewell County,51185,Asian ,48,21,27,52,37,38
2016,Warren County,51187,Asian ,80,68,12,43,40,18
2016,Washington County,51191,Asian ,95,60,35,44,47,26
2016,Westmoreland County,51193,Asian ,6,6,0,13,13,19
2016,Wise County,51195,Asian ,41,41,0,21,21,25
2016,Wythe County,51197,Asian ,74,43,31,40,29,32
2016,York County,51199,Asian ,1168,852,316,118,124,92
2016,Alexandria city,51510,Asian ,3995,1826,2169,297,201,250
2016,Bristol city,51520,Asian ,0,0,0,19,19,19
2016,Buena Vista city,51530,Asian ,112,0,112,74,17,74
2016,Charlottesville city,51540,Asian ,933,240,693,119,80,123
2016,Chesapeake city,51550,Asian ,2175,1755,420,206,197,159
2016,Colonial Heights city,51570,Asian ,157,108,49,29,25,28
2016,Covington city,51580,Asian ,11,11,0,17,17,17
2016,Danville city,51590,Asian ,177,65,112,50,35,49
2016,Emporia city,51595,Asian ,5,0,5,7,17,7
2016,Fairfax city,51600,Asian ,1064,691,373,100,109,113
2016,Falls Church city,51610,Asian ,559,265,294,87,82,100
2016,Franklin city,51620,Asian ,0,0,0,17,17,17
2016,Fredericksburg city,51630,Asian ,146,66,80,71,35,67
2016,Galax city,51640,Asian ,2,0,2,5,17,5
2016,Hampton city,51650,Asian ,892,553,339,144,121,121
2016,Harrisonburg city,51660,Asian ,433,239,194,88,75,76
2016,Hopewell city,51670,Asian ,115,45,70,44,36,62
2016,Lexington city,51678,Asian ,22,10,12,23,13,16
2016,Lynchburg city,51680,Asian ,522,144,378,125,72,136
2016,Manassas city,51683,Asian ,713,510,203,105,101,86
2016,Manassas Park city,51685,Asian ,354,302,52,94,93,48
2016,Martinsville city,51690,Asian ,8,0,8,12,19,12
2016,Newport News city,51700,Asian ,1737,1092,645,170,145,172
2016,Norfolk city,51710,Asian ,2452,1382,1070,211,152,177
2016,Norton city,51720,Asian ,24,13,11,23,13,20
2016,Petersburg city,51730,Asian ,227,118,109,89,66,68
2016,Poquoson city,51735,Asian ,51,40,11,34,34,17
2016,Portsmouth city,51740,Asian ,387,160,227,129,75,112
2016,Radford city,51750,Asian ,83,32,51,71,26,72
2016,Richmond city,51760,Asian ,1467,460,1007,167,110,125
2016,Roanoke city,51770,Asian ,744,255,489,161,142,119
2016,Salem city,51775,Asian ,195,88,107,54,45,61
2016,Staunton city,51790,Asian ,72,11,61,44,17,47
2016,Suffolk city,51800,Asian ,382,288,94,71,70,55
2016,Virginia Beach city,51810,Asian ,9070,6365,2705,404,343,307
2016,Waynesboro city,51820,Asian ,84,21,63,39,23,47
2016,Williamsburg city,51830,Asian ,62,21,41,24,19,19
2016,Winchester city,51840,Asian ,211,118,93,63,45,57
2017,Accomack County,51001,Asian ,109,15,94,46,18,48
2017,Albemarle County,51003,Asian ,1399,650,749,197,134,191
2017,Alleghany County,51005,Asian ,0,0,0,19,19,19
2017,Amelia County,51007,Asian ,0,0,0,19,19,19
2017,Amherst County,51009,Asian ,21,16,5,18,16,9
2017,Appomattox County,51011,Asian ,0,0,0,19,19,19
2017,Arlington County,51013,Asian ,9787,3416,6371,380,372,435
2017,Augusta County,51015,Asian ,117,117,0,46,46,28
2017,Bath County,51017,Asian ,12,0,12,25,12,25
2017,Bedford County,51019,Asian ,343,194,149,75,79,86
2017,Bland County,51021,Asian ,0,0,0,17,17,17
2017,Botetourt County,51023,Asian ,78,64,14,24,22,22
2017,Brunswick County,51025,Asian ,0,0,0,19,19,19
2017,Buchanan County,51027,Asian ,27,24,3,8,9,7
2017,Buckingham County,51029,Asian ,6,6,0,10,10,19
2017,Campbell County,51031,Asian ,105,34,71,54,28,59
2017,Caroline County,51033,Asian ,43,43,0,44,44,22
2017,Carroll County,51035,Asian ,16,16,0,30,30,22
2017,Charles City County,51036,Asian ,31,21,10,16,10,13
2017,Charlotte County,51037,Asian ,6,6,0,9,9,19
2017,Chesterfield County,51041,Asian ,3645,2619,1026,249,249,238
2017,Clarke County,51043,Asian ,64,19,45,21,23,31
2017,Craig County,51045,Asian ,0,0,0,17,17,17
2017,Culpeper County,51047,Asian ,103,92,11,51,45,22
2017,Cumberland County,51049,Asian ,0,0,0,17,17,17
2017,Dickenson County,51051,Asian ,0,0,0,19,19,19
2017,Dinwiddie County,51053,Asian ,18,0,18,29,22,29
2017,Essex County,51057,Asian ,10,10,0,35,35,19
2017,Fairfax County,51059,Asian ,65450,43933,21517,938,977,887
2017,Fauquier County,51061,Asian ,232,183,49,45,48,44
2017,Floyd County,51063,Asian ,0,0,0,19,19,19
2017,Fluvanna County,51065,Asian ,32,32,0,39,39,22
2017,Franklin County,51067,Asian ,66,50,16,55,47,29
2017,Frederick County,51069,Asian ,286,176,110,93,67,67
2017,Giles County,51071,Asian ,11,11,0,12,12,19
2017,Gloucester County,51073,Asian ,41,41,0,44,44,25
2017,Goochland County,51075,Asian ,120,120,0,44,44,22
2017,Grayson County,51077,Asian ,10,10,0,15,15,19
2017,Greene County,51079,Asian ,82,75,7,27,30,11
2017,Greensville County,51081,Asian ,0,0,0,19,19,19
2017,Halifax County,51083,Asian ,66,52,14,26,17,20
2017,Hanover County,51085,Asian ,454,391,63,67,59,49
2017,Henrico County,51087,Asian ,8179,4691,3488,356,315,303
2017,Henry County,51089,Asian ,82,82,0,34,34,28
2017,Highland County,51091,Asian ,0,0,0,12,12,12
2017,Isle of Wight County,51093,Asian ,52,40,12,37,34,20
2017,James City County,51095,Asian ,559,381,178,120,108,103
2017,King and Queen County,51097,Asian ,0,0,0,17,17,17
2017,King George County,51099,Asian ,88,86,2,41,41,3
2017,King William County,51101,Asian ,55,45,10,22,26,17
2017,Lancaster County,51103,Asian ,60,56,4,56,55,8
2017,Lee County,51105,Asian ,14,14,0,25,25,22
2017,Loudoun County,51107,Asian ,17965,15926,2039,499,472,271
2017,Louisa County,51109,Asian ,48,48,0,34,34,25
2017,Lunenburg County,51111,Asian ,79,62,17,73,71,28
2017,Madison County,51113,Asian ,16,0,16,27,19,27
2017,Mathews County,51115,Asian ,11,11,0,16,16,17
2017,Mecklenburg County,51117,Asian ,7,2,5,9,4,8
2017,Middlesex County,51119,Asian ,0,0,0,19,19,19
2017,Montgomery County,51121,Asian ,1874,452,1422,215,115,218
2017,Nelson County,51125,Asian ,0,0,0,19,19,19
2017,New Kent County,51127,Asian ,99,99,0,53,53,22
2017,Northampton County,51131,Asian ,24,14,10,10,11,13
2017,Northumberland County,51133,Asian ,9,9,0,13,13,19
2017,Nottoway County,51135,Asian ,0,0,0,19,19,19
2017,Orange County,51137,Asian ,60,32,28,39,36,43
2017,Page County,51139,Asian ,36,23,13,21,15,19
2017,Patrick County,51141,Asian ,2,2,0,4,4,19
2017,Pittsylvania County,51143,Asian ,95,80,15,32,31,21
2017,Powhatan County,51145,Asian ,35,35,0,35,35,22
2017,Prince Edward County,51147,Asian ,31,0,31,49,22,49
2017,Prince George County,51149,Asian ,204,77,127,75,53,66
2017,Prince William County,51153,Asian ,9504,7675,1829,418,355,333
2017,Pulaski County,51155,Asian ,94,84,10,41,44,17
2017,Rappahannock County,51157,Asian ,16,0,16,25,17,25
2017,Richmond County,51159,Asian ,60,60,0,72,72,17
2017,Roanoke County,51161,Asian ,795,447,348,112,113,128
2017,Rockbridge County,51163,Asian ,18,18,0,24,24,22
2017,Rockingham County,51165,Asian ,129,92,37,35,33,27
2017,Russell County,51167,Asian ,0,0,0,22,22,22
2017,Scott County,51169,Asian ,9,0,9,7,22,7
2017,Shenandoah County,51171,Asian ,124,13,111,64,15,68
2017,Smyth County,51173,Asian ,39,13,26,50,23,45
2017,Southampton County,51175,Asian ,2,0,2,5,19,5
2017,Spotsylvania County,51177,Asian ,909,670,239,117,107,77
2017,Stafford County,51179,Asian ,1331,1013,318,155,172,123
2017,Surry County,51181,Asian ,7,0,7,14,17,14
2017,Sussex County,51183,Asian ,27,0,27,36,19,36
2017,Tazewell County,51185,Asian ,41,22,19,36,38,26
2017,Warren County,51187,Asian ,84,84,0,39,39,25
2017,Washington County,51191,Asian ,91,68,23,33,37,24
2017,Westmoreland County,51193,Asian ,13,13,0,19,19,19
2017,Wise County,51195,Asian ,34,34,0,22,22,25
2017,Wythe County,51197,Asian ,79,45,34,32,46,19
2017,York County,51199,Asian ,1113,834,279,135,129,85
2017,Alexandria city,51510,Asian ,3825,1849,1976,288,209,266
2017,Bristol city,51520,Asian ,0,0,0,19,19,19
2017,Buena Vista city,51530,Asian ,87,0,87,54,17,54
2017,Charlottesville city,51540,Asian ,1022,308,714,127,100,124
2017,Chesapeake city,51550,Asian ,2391,2001,390,241,260,139
2017,Colonial Heights city,51570,Asian ,164,126,38,30,36,30
2017,Covington city,51580,Asian ,36,36,0,40,40,17
2017,Danville city,51590,Asian ,156,62,94,55,34,52
2017,Emporia city,51595,Asian ,5,0,5,11,17,11
2017,Fairfax city,51600,Asian ,1187,830,357,114,101,113
2017,Falls Church city,51610,Asian ,561,245,316,102,85,100
2017,Franklin city,51620,Asian ,0,0,0,17,17,17
2017,Fredericksburg city,51630,Asian ,147,92,55,62,51,45
2017,Galax city,51640,Asian ,0,0,0,17,17,17
2017,Hampton city,51650,Asian ,909,547,362,163,130,130
2017,Harrisonburg city,51660,Asian ,486,256,230,80,76,91
2017,Hopewell city,51670,Asian ,116,27,89,51,29,55
2017,Lexington city,51678,Asian ,71,43,28,73,56,36
2017,Lynchburg city,51680,Asian ,561,156,405,106,59,116
2017,Manassas city,51683,Asian ,744,547,197,114,113,87
2017,Manassas Park city,51685,Asian ,421,347,74,106,109,67
2017,Martinsville city,51690,Asian ,7,0,7,12,19,12
2017,Newport News city,51700,Asian ,1805,1127,678,175,142,179
2017,Norfolk city,51710,Asian ,2515,1381,1134,221,161,179
2017,Norton city,51720,Asian ,24,17,7,21,15,17
2017,Petersburg city,51730,Asian ,241,137,104,84,78,65
2017,Poquoson city,51735,Asian ,46,30,16,42,36,24
2017,Portsmouth city,51740,Asian ,427,167,260,119,44,131
2017,Radford city,51750,Asian ,75,19,56,72,24,74
2017,Richmond city,51760,Asian ,1467,512,955,185,113,157
2017,Roanoke city,51770,Asian ,897,273,624,161,116,131
2017,Salem city,51775,Asian ,160,59,101,55,53,46
2017,Staunton city,51790,Asian ,97,38,59,68,36,68
2017,Suffolk city,51800,Asian ,379,301,78,82,72,51
2017,Virginia Beach city,51810,Asian ,9432,6729,2703,386,400,346
2017,Waynesboro city,51820,Asian ,77,0,77,85,22,85
2017,Williamsburg city,51830,Asian ,45,12,33,42,17,31
2017,Winchester city,51840,Asian ,202,118,84,69,46,62
2018,Accomack County,51001,Asian ,22,3,19,24,5,23
2018,Albemarle County,51003,Asian ,1459,759,700,199,95,185
2018,Alleghany County,51005,Asian ,0,0,0,19,19,19
2018,Amelia County,51007,Asian ,0,0,0,19,19,19
2018,Amherst County,51009,Asian ,22,18,4,16,16,7
2018,Appomattox County,51011,Asian ,3,0,3,5,19,5
2018,Arlington County,51013,Asian ,10094,3549,6545,401,329,364
2018,Augusta County,51015,Asian ,136,121,15,53,51,26
2018,Bath County,51017,Asian ,16,0,16,28,12,28
2018,Bedford County,51019,Asian ,370,209,161,72,79,81
2018,Bland County,51021,Asian ,0,0,0,17,17,17
2018,Botetourt County,51023,Asian ,79,66,13,37,35,16
2018,Brunswick County,51025,Asian ,0,0,0,19,19,19
2018,Buchanan County,51027,Asian ,53,48,5,41,39,13
2018,Buckingham County,51029,Asian ,8,8,0,12,12,19
2018,Campbell County,51031,Asian ,147,104,43,66,56,43
2018,Caroline County,51033,Asian ,29,29,0,31,31,25
2018,Carroll County,51035,Asian ,26,26,0,44,44,22
2018,Charles City County,51036,Asian ,13,9,4,10,7,7
2018,Charlotte County,51037,Asian ,26,26,0,28,28,19
2018,Chesterfield County,51041,Asian ,3974,2950,1024,310,298,201
2018,Clarke County,51043,Asian ,57,19,38,46,29,37
2018,Craig County,51045,Asian ,0,0,0,17,17,17
2018,Culpeper County,51047,Asian ,113,96,17,52,49,21
2018,Cumberland County,51049,Asian ,38,31,7,44,37,16
2018,Dickenson County,51051,Asian ,0,0,0,19,19,19
2018,Dinwiddie County,51053,Asian ,30,12,18,29,19,24
2018,Essex County,51057,Asian ,25,25,0,31,31,19
2018,Fairfax County,51059,Asian ,66317,45117,21200,868,901,883
2018,Fauquier County,51061,Asian ,196,149,47,48,49,37
2018,Floyd County,51063,Asian ,0,0,0,19,19,19
2018,Fluvanna County,51065,Asian ,41,41,0,45,45,22
2018,Franklin County,51067,Asian ,71,56,15,51,48,25
2018,Frederick County,51069,Asian ,263,231,32,96,91,28
2018,Giles County,51071,Asian ,16,16,0,18,18,19
2018,Gloucester County,51073,Asian ,55,46,9,47,47,16
2018,Goochland County,51075,Asian ,111,111,0,39,39,22
2018,Grayson County,51077,Asian ,16,16,0,21,21,19
2018,Greene County,51079,Asian ,88,86,2,38,39,7
2018,Greensville County,51081,Asian ,0,0,0,19,19,19
2018,Halifax County,51083,Asian ,83,83,0,20,20,25
2018,Hanover County,51085,Asian ,473,399,74,85,69,51
2018,Henrico County,51087,Asian ,8504,4832,3672,367,339,383
2018,Henry County,51089,Asian ,70,70,0,21,21,28
2018,Highland County,51091,Asian ,0,0,0,12,12,12
2018,Isle of Wight County,51093,Asian ,42,33,9,40,36,15
2018,James City County,51095,Asian ,528,341,187,116,103,81
2018,King and Queen County,51097,Asian ,0,0,0,17,17,17
2018,King George County,51099,Asian ,131,130,1,42,42,3
2018,King William County,51101,Asian ,75,63,12,27,31,15
2018,Lancaster County,51103,Asian ,36,31,5,13,13,7
2018,Lee County,51105,Asian ,27,27,0,46,46,22
2018,Loudoun County,51107,Asian ,19403,17010,2393,548,551,386
2018,Louisa County,51109,Asian ,50,50,0,31,31,25
2018,Lunenburg County,51111,Asian ,74,59,15,73,72,25
2018,Madison County,51113,Asian ,9,0,9,9,19,9
2018,Mathews County,51115,Asian ,13,13,0,21,21,17
2018,Mecklenburg County,51117,Asian ,10,4,6,9,5,8
2018,Middlesex County,51119,Asian ,0,0,0,19,19,19
2018,Montgomery County,51121,Asian ,1885,496,1389,216,117,181
2018,Nelson County,51125,Asian ,0,0,0,19,19,19
2018,New Kent County,51127,Asian ,100,100,0,60,60,22
2018,Northampton County,51131,Asian ,39,29,10,14,16,11
2018,Northumberland County,51133,Asian ,11,11,0,16,16,19
2018,Nottoway County,51135,Asian ,0,0,0,19,19,19
2018,Orange County,51137,Asian ,61,35,26,34,36,35
2018,Page County,51139,Asian ,47,13,34,42,20,41
2018,Patrick County,51141,Asian ,10,10,0,8,8,19
2018,Pittsylvania County,51143,Asian ,98,75,23,29,25,26
2018,Powhatan County,51145,Asian ,38,38,0,20,20,22
2018,Prince Edward County,51147,Asian ,8,8,0,15,15,22
2018,Prince George County,51149,Asian ,198,75,123,85,59,69
2018,Prince William County,51153,Asian ,9526,7916,1610,404,393,280
2018,Pulaski County,51155,Asian ,90,74,16,38,42,21
2018,Rappahannock County,51157,Asian ,11,0,11,18,17,18
2018,Richmond County,51159,Asian ,0,0,0,17,17,17
2018,Roanoke County,51161,Asian ,776,385,391,124,109,121
2018,Rockbridge County,51163,Asian ,28,16,12,31,22,22
2018,Rockingham County,51165,Asian ,159,116,43,32,29,26
2018,Russell County,51167,Asian ,0,0,0,22,22,22
2018,Scott County,51169,Asian ,14,0,14,21,22,21
2018,Shenandoah County,51171,Asian ,121,12,109,72,16,75
2018,Smyth County,51173,Asian ,49,14,35,53,23,50
2018,Southampton County,51175,Asian ,0,0,0,19,19,19
2018,Spotsylvania County,51177,Asian ,956,696,260,124,129,88
2018,Stafford County,51179,Asian ,1565,1206,359,180,171,128
2018,Surry County,51181,Asian ,0,0,0,17,17,17
2018,Sussex County,51183,Asian ,36,0,36,45,19,45
2018,Tazewell County,51185,Asian ,72,0,72,46,25,46
2018,Warren County,51187,Asian ,150,150,0,73,73,25
2018,Washington County,51191,Asian ,86,53,33,29,32,23
2018,Westmoreland County,51193,Asian ,24,24,0,19,19,19
2018,Wise County,51195,Asian ,37,37,0,25,25,25
2018,Wythe County,51197,Asian ,29,0,29,39,22,39
2018,York County,51199,Asian ,1103,857,246,109,137,102
2018,Alexandria city,51510,Asian ,3894,1856,2038,268,223,223
2018,Bristol city,51520,Asian ,0,0,0,19,19,19
2018,Buena Vista city,51530,Asian ,70,0,70,55,17,55
2018,Charlottesville city,51540,Asian ,1005,263,742,131,114,146
2018,Chesapeake city,51550,Asian ,2452,1870,582,214,216,143
2018,Colonial Heights city,51570,Asian ,157,142,15,24,32,18
2018,Covington city,51580,Asian ,26,26,0,28,28,17
2018,Danville city,51590,Asian ,168,90,78,46,42,38
2018,Emporia city,51595,Asian ,7,0,7,13,17,13
2018,Fairfax city,51600,Asian ,1367,909,458,117,115,113
2018,Falls Church city,51610,Asian ,576,252,324,110,83,84
2018,Franklin city,51620,Asian ,0,0,0,17,17,17
2018,Fredericksburg city,51630,Asian ,208,99,109,73,59,60
2018,Galax city,51640,Asian ,0,0,0,17,17,17
2018,Hampton city,51650,Asian ,994,555,439,169,107,146
2018,Harrisonburg city,51660,Asian ,452,231,221,98,85,104
2018,Hopewell city,51670,Asian ,140,26,114,79,47,72
2018,Lexington city,51678,Asian ,81,39,42,72,55,46
2018,Lynchburg city,51680,Asian ,601,198,403,129,69,158
2018,Manassas city,51683,Asian ,731,564,167,96,88,72
2018,Manassas Park city,51685,Asian ,399,355,44,126,119,51
2018,Martinsville city,51690,Asian ,10,0,10,16,19,16
2018,Newport News city,51700,Asian ,1673,995,678,191,173,174
2018,Norfolk city,51710,Asian ,2606,1383,1223,197,157,166
2018,Norton city,51720,Asian ,35,12,23,38,14,42
2018,Petersburg city,51730,Asian ,200,101,99,63,61,55
2018,Poquoson city,51735,Asian ,87,81,6,46,46,16
2018,Portsmouth city,51740,Asian ,412,180,232,110,55,112
2018,Radford city,51750,Asian ,93,23,70,80,23,77
2018,Richmond city,51760,Asian ,1425,484,941,175,116,166
2018,Roanoke city,51770,Asian ,1255,438,817,190,178,178
2018,Salem city,51775,Asian ,152,64,88,65,55,46
2018,Staunton city,51790,Asian ,125,10,115,88,16,89
2018,Suffolk city,51800,Asian ,555,343,212,126,85,110
2018,Virginia Beach city,51810,Asian ,9566,6912,2654,382,399,334
2018,Waynesboro city,51820,Asian ,96,23,73,91,36,83
2018,Williamsburg city,51830,Asian ,58,21,37,39,17,32
2018,Winchester city,51840,Asian ,163,111,52,85,61,50
2019,Accomack County,51001,Asian ,84,47,37,35,46,58
2019,Albemarle County,51003,Asian ,1429,740,689,194,122,187
2019,Alleghany County,51005,Asian ,0,0,0,19,19,19
2019,Amelia County,51007,Asian ,0,0,0,19,19,19
2019,Amherst County,51009,Asian ,29,15,14,17,15,18
2019,Appomattox County,51011,Asian ,2,0,2,3,19,3
2019,Arlington County,51013,Asian ,10362,3635,6727,430,317,464
2019,Augusta County,51015,Asian ,149,131,18,49,45,28
2019,Bath County,51017,Asian ,15,0,15,28,12,28
2019,Bedford County,51019,Asian ,294,140,154,76,69,72
2019,Bland County,51021,Asian ,0,0,0,17,17,17
2019,Botetourt County,51023,Asian ,78,73,5,26,27,7
2019,Brunswick County,51025,Asian ,0,0,0,19,19,19
2019,Buchanan County,51027,Asian ,46,46,0,49,49,23
2019,Buckingham County,51029,Asian ,6,6,0,9,9,19
2019,Campbell County,51031,Asian ,161,122,39,65,63,38
2019,Caroline County,51033,Asian ,17,17,0,23,23,26
2019,Carroll County,51035,Asian ,13,13,0,25,25,23
2019,Charles City County,51036,Asian ,19,11,8,15,9,14
2019,Charlotte County,51037,Asian ,26,26,0,23,23,19
2019,Chesterfield County,51041,Asian ,4229,3249,980,220,263,201
2019,Clarke County,51043,Asian ,52,11,41,41,20,38
2019,Craig County,51045,Asian ,0,0,0,17,17,17
2019,Culpeper County,51047,Asian ,210,132,78,88,75,103
2019,Cumberland County,51049,Asian ,63,53,10,66,66,18
2019,Dickenson County,51051,Asian ,0,0,0,19,19,19
2019,Dinwiddie County,51053,Asian ,75,59,16,42,43,27
2019,Essex County,51057,Asian ,28,28,0,33,33,19
2019,Fairfax County,51059,Asian ,67793,46548,21245,936,915,904
2019,Fauquier County,51061,Asian ,216,152,64,69,78,44
2019,Floyd County,51063,Asian ,0,0,0,19,19,19
2019,Fluvanna County,51065,Asian ,15,15,0,26,26,23
2019,Franklin County,51067,Asian ,70,64,6,46,45,10
2019,Frederick County,51069,Asian ,266,201,65,107,102,62
2019,Giles County,51071,Asian ,9,9,0,13,13,19
2019,Gloucester County,51073,Asian ,56,45,11,41,42,17
2019,Goochland County,51075,Asian ,89,70,19,44,34,37
2019,Grayson County,51077,Asian ,19,19,0,25,25,19
2019,Greene County,51079,Asian ,99,73,26,37,37,23
2019,Greensville County,51081,Asian ,0,0,0,19,19,19
2019,Halifax County,51083,Asian ,107,96,11,20,16,20
2019,Hanover County,51085,Asian ,463,405,58,73,77,51
2019,Henrico County,51087,Asian ,9054,5264,3790,441,318,411
2019,Henry County,51089,Asian ,72,72,0,25,25,29
2019,Highland County,51091,Asian ,0,0,0,12,12,12
2019,Isle of Wight County,51093,Asian ,54,40,14,57,48,26
2019,James City County,51095,Asian ,575,398,177,109,96,94
2019,King and Queen County,51097,Asian ,0,0,0,17,17,17
2019,King George County,51099,Asian ,162,153,9,44,43,12
2019,King William County,51101,Asian ,68,56,12,35,33,15
2019,Lancaster County,51103,Asian ,43,36,7,14,21,11
2019,Lee County,51105,Asian ,24,24,0,32,32,23
2019,Loudoun County,51107,Asian ,21063,18596,2467,385,407,347
2019,Louisa County,51109,Asian ,38,28,10,31,28,17
2019,Lunenburg County,51111,Asian ,66,50,16,48,46,26
2019,Madison County,51113,Asian ,7,0,7,7,19,7
2019,Mathews County,51115,Asian ,27,27,0,41,41,17
2019,Mecklenburg County,51117,Asian ,9,0,9,8,26,8
2019,Middlesex County,51119,Asian ,0,0,0,19,19,19
2019,Montgomery County,51121,Asian ,1961,479,1482,229,175,179
2019,Nelson County,51125,Asian ,0,0,0,19,19,19
2019,New Kent County,51127,Asian ,137,137,0,53,53,23
2019,Northampton County,51131,Asian ,50,32,18,14,24,20
2019,Northumberland County,51133,Asian ,2,2,0,3,3,19
2019,Nottoway County,51135,Asian ,0,0,0,19,19,19
2019,Orange County,51137,Asian ,29,29,0,35,35,26
2019,Page County,51139,Asian ,39,28,11,34,31,17
2019,Patrick County,51141,Asian ,11,11,0,8,8,19
2019,Pittsylvania County,51143,Asian ,109,88,21,34,37,22
2019,Powhatan County,51145,Asian ,34,34,0,27,27,23
2019,Prince Edward County,51147,Asian ,16,16,0,22,22,23
2019,Prince George County,51149,Asian ,213,133,80,69,83,48
2019,Prince William County,51153,Asian ,10133,8460,1673,403,372,271
2019,Pulaski County,51155,Asian ,106,83,23,42,48,29
2019,Rappahannock County,51157,Asian ,0,0,0,17,17,17
2019,Richmond County,51159,Asian ,0,0,0,17,17,17
2019,Roanoke County,51161,Asian ,809,489,320,127,99,123
2019,Rockbridge County,51163,Asian ,27,9,18,41,19,35
2019,Rockingham County,51165,Asian ,193,124,69,53,42,56
2019,Russell County,51167,Asian ,0,0,0,23,23,23
2019,Scott County,51169,Asian ,14,0,14,22,23,22
2019,Shenandoah County,51171,Asian ,148,16,132,64,18,67
2019,Smyth County,51173,Asian ,71,39,32,66,49,48
2019,Southampton County,51175,Asian ,17,17,0,26,26,19
2019,Spotsylvania County,51177,Asian ,935,697,238,156,132,92
2019,Stafford County,51179,Asian ,1541,1259,282,155,142,94
2019,Surry County,51181,Asian ,0,0,0,17,17,17
2019,Sussex County,51183,Asian ,48,3,45,49,5,50
2019,Tazewell County,51185,Asian ,55,0,55,43,26,43
2019,Warren County,51187,Asian ,153,153,0,90,90,26
2019,Washington County,51191,Asian ,76,56,20,29,32,19
2019,Westmoreland County,51193,Asian ,27,25,2,25,24,5
2019,Wise County,51195,Asian ,37,37,0,24,24,26
2019,Wythe County,51197,Asian ,39,0,39,42,23,42
2019,York County,51199,Asian ,1003,745,258,132,120,106
2019,Alexandria city,51510,Asian ,3678,1794,1884,296,230,258
2019,Bristol city,51520,Asian ,27,27,0,48,48,19
2019,Buena Vista city,51530,Asian ,45,0,45,67,17,67
2019,Charlottesville city,51540,Asian ,1010,222,788,139,88,138
2019,Chesapeake city,51550,Asian ,2272,1719,553,247,226,156
2019,Colonial Heights city,51570,Asian ,171,154,17,35,38,19
2019,Covington city,51580,Asian ,22,22,0,28,28,17
2019,Danville city,51590,Asian ,145,70,75,50,43,40
2019,Emporia city,51595,Asian ,7,0,7,13,17,13
2019,Fairfax city,51600,Asian ,1445,986,459,126,123,124
2019,Falls Church city,51610,Asian ,595,242,353,105,91,85
2019,Franklin city,51620,Asian ,48,48,0,54,54,17
2019,Fredericksburg city,51630,Asian ,221,99,122,89,67,74
2019,Galax city,51640,Asian ,0,0,0,17,17,17
2019,Hampton city,51650,Asian ,1231,636,595,223,150,231
2019,Harrisonburg city,51660,Asian ,469,248,221,91,74,99
2019,Hopewell city,51670,Asian ,138,34,104,75,59,78
2019,Lexington city,51678,Asian ,65,37,28,61,54,38
2019,Lynchburg city,51680,Asian ,600,246,354,132,93,135
2019,Manassas city,51683,Asian ,630,501,129,87,83,47
2019,Manassas Park city,51685,Asian ,472,402,70,135,133,82
2019,Martinsville city,51690,Asian ,68,26,42,39,42,25
2019,Newport News city,51700,Asian ,1655,862,793,209,193,154
2019,Norfolk city,51710,Asian ,2753,1463,1290,234,163,170
2019,Norton city,51720,Asian ,47,10,37,59,11,61
2019,Petersburg city,51730,Asian ,177,103,74,75,62,60
2019,Poquoson city,51735,Asian ,89,74,15,36,38,23
2019,Portsmouth city,51740,Asian ,479,289,190,132,89,118
2019,Radford city,51750,Asian ,86,18,68,77,20,78
2019,Richmond city,51760,Asian ,1594,642,952,234,132,203
2019,Roanoke city,51770,Asian ,1502,634,868,311,193,281
2019,Salem city,51775,Asian ,158,53,105,45,47,59
2019,Staunton city,51790,Asian ,112,11,101,54,18,51
2019,Suffolk city,51800,Asian ,603,399,204,104,100,100
2019,Virginia Beach city,51810,Asian ,9775,6922,2853,463,380,400
2019,Waynesboro city,51820,Asian ,136,17,119,110,27,108
2019,Williamsburg city,51830,Asian ,51,14,37,59,22,43
2019,Winchester city,51840,Asian ,240,147,93,95,85,72
2020,Accomack County,51001,Asian ,98,94,4,42,44,8
2020,Albemarle County,51003,Asian ,1473,797,676,190,164,215
2020,Alleghany County,51005,Asian ,5,0,5,10,20,10
2020,Amelia County,51007,Asian ,1,1,0,3,3,20
2020,Amherst County,51009,Asian ,34,22,12,16,17,16
2020,Appomattox County,51011,Asian ,6,0,6,12,20,12
2020,Arlington County,51013,Asian ,11000,3810,7190,560,427,479
2020,Augusta County,51015,Asian ,143,127,16,61,63,25
2020,Bath County,51017,Asian ,16,0,16,31,13,31
2020,Bedford County,51019,Asian ,346,214,132,73,84,89
2020,Bland County,51021,Asian ,0,0,0,18,18,18
2020,Botetourt County,51023,Asian ,78,73,5,33,31,6
2020,Brunswick County,51025,Asian ,0,0,0,20,20,20
2020,Buchanan County,51027,Asian ,0,0,0,24,24,24
2020,Buckingham County,51029,Asian ,7,7,0,14,14,20
2020,Campbell County,51031,Asian ,233,166,67,87,74,57
2020,Caroline County,51033,Asian ,0,0,0,27,27,27
2020,Carroll County,51035,Asian ,0,0,0,24,24,24
2020,Charles City County,51036,Asian ,26,19,7,17,13,11
2020,Charlotte County,51037,Asian ,22,19,3,14,16,4
2020,Chesterfield County,51041,Asian ,4177,3246,931,331,331,213
2020,Clarke County,51043,Asian ,122,84,38,29,50,46
2020,Craig County,51045,Asian ,0,0,0,18,18,18
2020,Culpeper County,51047,Asian ,275,144,131,125,120,107
2020,Cumberland County,51049,Asian ,52,43,9,63,62,16
2020,Dickenson County,51051,Asian ,0,0,0,20,20,20
2020,Dinwiddie County,51053,Asian ,64,50,14,55,48,27
2020,Essex County,51057,Asian ,22,22,0,26,26,20
2020,Fairfax County,51059,Asian ,69859,49270,20589,1136,1066,930
2020,Fauquier County,51061,Asian ,253,179,74,65,66,48
2020,Floyd County,51063,Asian ,0,0,0,20,20,20
2020,Fluvanna County,51065,Asian ,17,17,0,19,19,24
2020,Franklin County,51067,Asian ,46,40,6,31,31,8
2020,Frederick County,51069,Asian ,303,255,48,114,115,40
2020,Giles County,51071,Asian ,79,3,76,100,5,98
2020,Gloucester County,51073,Asian ,96,79,17,44,52,26
2020,Goochland County,51075,Asian ,96,61,35,64,50,42
2020,Grayson County,51077,Asian ,126,126,0,130,130,20
2020,Greene County,51079,Asian ,123,83,40,41,44,28
2020,Greensville County,51081,Asian ,0,0,0,20,20,20
2020,Halifax County,51083,Asian ,82,52,30,42,18,52
2020,Hanover County,51085,Asian ,493,412,81,119,118,58
2020,Henrico County,51087,Asian ,9646,5738,3908,407,405,364
2020,Henry County,51089,Asian ,46,46,0,23,23,30
2020,Highland County,51091,Asian ,3,3,0,4,4,13
2020,Isle of Wight County,51093,Asian ,85,73,12,43,36,20
2020,James City County,51095,Asian ,596,345,251,115,90,123
2020,King and Queen County,51097,Asian ,0,0,0,18,18,18
2020,King George County,51099,Asian ,122,112,10,45,45,14
2020,King William County,51101,Asian ,78,69,9,47,48,15
2020,Lancaster County,51103,Asian ,57,51,6,45,43,11
2020,Lee County,51105,Asian ,2,2,0,17,17,24
2020,Loudoun County,51107,Asian ,23029,20316,2713,640,686,412
2020,Louisa County,51109,Asian ,78,71,7,50,50,13
2020,Lunenburg County,51111,Asian ,10,7,3,6,7,5
2020,Madison County,51113,Asian ,6,0,6,8,20,8
2020,Mathews County,51115,Asian ,22,22,0,40,40,18
2020,Mecklenburg County,51117,Asian ,137,1,136,65,2,64
2020,Middlesex County,51119,Asian ,11,0,11,8,20,8
2020,Montgomery County,51121,Asian ,2182,614,1568,211,199,234
2020,Nelson County,51125,Asian ,0,0,0,20,20,20
2020,New Kent County,51127,Asian ,90,90,0,63,63,24
2020,Northampton County,51131,Asian ,55,39,16,14,22,17
2020,Northumberland County,51133,Asian ,3,3,0,5,5,20
2020,Nottoway County,51135,Asian ,0,0,0,20,20,20
2020,Orange County,51137,Asian ,87,87,0,32,32,27
2020,Page County,51139,Asian ,48,32,16,38,42,21
2020,Patrick County,51141,Asian ,15,15,0,11,11,20
2020,Pittsylvania County,51143,Asian ,107,87,20,36,37,24
2020,Powhatan County,51145,Asian ,11,11,0,20,20,24
2020,Prince Edward County,51147,Asian ,27,27,0,39,39,24
2020,Prince George County,51149,Asian ,191,117,74,90,82,60
2020,Prince William County,51153,Asian ,11449,9239,2210,394,357,309
2020,Pulaski County,51155,Asian ,88,79,9,46,44,16
2020,Rappahannock County,51157,Asian ,0,0,0,18,18,18
2020,Richmond County,51159,Asian ,0,0,0,18,18,18
2020,Roanoke County,51161,Asian ,814,491,323,119,121,132
2020,Rockbridge County,51163,Asian ,126,11,115,89,17,87
2020,Rockingham County,51165,Asian ,281,159,122,93,70,72
2020,Russell County,51167,Asian ,0,0,0,24,24,24
2020,Scott County,51169,Asian ,0,0,0,24,24,24
2020,Shenandoah County,51171,Asian ,160,43,117,63,30,65
2020,Smyth County,51173,Asian ,68,35,33,68,49,47
2020,Southampton County,51175,Asian ,17,17,0,26,26,20
2020,Spotsylvania County,51177,Asian ,982,756,226,158,142,85
2020,Stafford County,51179,Asian ,1602,1307,295,191,181,129
2020,Surry County,51181,Asian ,0,0,0,18,18,18
2020,Sussex County,51183,Asian ,18,1,17,12,4,10
2020,Tazewell County,51185,Asian ,100,47,53,61,52,54
2020,Warren County,51187,Asian ,92,92,0,67,67,27
2020,Washington County,51191,Asian ,81,72,9,32,32,10
2020,Westmoreland County,51193,Asian ,48,40,8,42,40,11
2020,Wise County,51195,Asian ,42,42,0,25,25,27
2020,Wythe County,51197,Asian ,188,0,188,105,24,105
2020,York County,51199,Asian ,1028,768,260,135,109,109
2020,Alexandria city,51510,Asian ,4110,1964,2146,330,292,257
2020,Bristol city,51520,Asian ,32,32,0,59,59,20
2020,Buena Vista city,51530,Asian ,0,0,0,18,18,18
2020,Charlottesville city,51540,Asian ,1013,225,788,147,106,148
2020,Chesapeake city,51550,Asian ,2350,1804,546,295,239,167
2020,Colonial Heights city,51570,Asian ,169,169,0,37,37,20
2020,Covington city,51580,Asian ,18,15,3,17,19,5
2020,Danville city,51590,Asian ,160,86,74,74,42,70
2020,Emporia city,51595,Asian ,0,0,0,18,18,18
2020,Fairfax city,51600,Asian ,1527,1166,361,154,144,120
2020,Falls Church city,51610,Asian ,556,313,243,100,120,85
2020,Franklin city,51620,Asian ,104,104,0,110,110,18
2020,Fredericksburg city,51630,Asian ,402,241,161,133,146,100
2020,Galax city,51640,Asian ,0,0,0,18,18,18
2020,Hampton city,51650,Asian ,1329,643,686,225,176,224
2020,Harrisonburg city,51660,Asian ,397,221,176,95,85,69
2020,Hopewell city,51670,Asian ,153,79,74,92,102,75
2020,Lexington city,51678,Asian ,207,120,87,129,145,97
2020,Lynchburg city,51680,Asian ,725,233,492,125,76,139
2020,Manassas city,51683,Asian ,573,442,131,104,108,61
2020,Manassas Park city,51685,Asian ,489,443,46,128,167,61
2020,Martinsville city,51690,Asian ,67,14,53,21,23,14
2020,Newport News city,51700,Asian ,1524,771,753,195,152,191
2020,Norfolk city,51710,Asian ,2895,1503,1392,229,211,217
2020,Norton city,51720,Asian ,0,0,0,13,13,13
2020,Petersburg city,51730,Asian ,191,125,66,61,48,51
2020,Poquoson city,51735,Asian ,93,77,16,41,41,23
2020,Portsmouth city,51740,Asian ,612,431,181,137,109,108
2020,Radford city,51750,Asian ,68,23,45,61,23,56
2020,Richmond city,51760,Asian ,1613,539,1074,222,144,213
2020,Roanoke city,51770,Asian ,1713,633,1080,262,171,231
2020,Salem city,51775,Asian ,180,37,143,61,32,60
2020,Staunton city,51790,Asian ,166,70,96,62,53,58
2020,Suffolk city,51800,Asian ,577,364,213,135,111,134
2020,Virginia Beach city,51810,Asian ,10728,7653,3075,519,545,437
2020,Waynesboro city,51820,Asian ,171,57,114,101,120,111
2020,Williamsburg city,51830,Asian ,73,19,54,58,20,45
2020,Winchester city,51840,Asian ,171,161,10,84,81,19
2021,Accomack County,51001,Asian ,70,54,16,39,41,19
2021,Albemarle County,51003,Asian ,1562,831,731,219,194,221
2021,Alleghany County,51005,Asian ,4,0,4,10,21,10
2021,Amelia County,51007,Asian ,1,1,0,3,3,21
2021,Amherst County,51009,Asian ,43,30,13,26,25,20
2021,Appomattox County,51011,Asian ,5,0,5,9,21,9
2021,Arlington County,51013,Asian ,11230,4300,6930,523,347,507
2021,Augusta County,51015,Asian ,154,136,18,59,55,35
2021,Bath County,51017,Asian ,12,0,12,21,13,21
2021,Bedford County,51019,Asian ,280,168,112,88,80,68
2021,Bland County,51021,Asian ,0,0,0,19,19,19
2021,Botetourt County,51023,Asian ,46,46,0,37,37,28
2021,Brunswick County,51025,Asian ,0,0,0,21,21,21
2021,Buchanan County,51027,Asian ,0,0,0,25,25,25
2021,Buckingham County,51029,Asian ,1,1,0,2,2,21
2021,Campbell County,51031,Asian ,193,137,56,84,68,63
2021,Caroline County,51033,Asian ,71,28,43,75,21,75
2021,Carroll County,51035,Asian ,0,0,0,25,25,25
2021,Charles City County,51036,Asian ,7,7,0,7,7,19
2021,Charlotte County,51037,Asian ,23,21,2,14,16,3
2021,Chesterfield County,51041,Asian ,4196,3428,768,336,334,187
2021,Clarke County,51043,Asian ,120,72,48,37,57,50
2021,Craig County,51045,Asian ,0,0,0,13,13,13
2021,Culpeper County,51047,Asian ,153,49,104,160,43,156
2021,Cumberland County,51049,Asian ,38,24,14,47,36,24
2021,Dickenson County,51051,Asian ,0,0,0,21,21,21
2021,Dinwiddie County,51053,Asian ,57,57,0,39,39,25
2021,Essex County,51057,Asian ,32,32,0,32,32,21
2021,Fairfax County,51059,Asian ,73691,52150,21541,1117,1139,1062
2021,Fauquier County,51061,Asian ,243,201,42,80,69,48
2021,Floyd County,51063,Asian ,12,12,0,15,15,21
2021,Fluvanna County,51065,Asian ,15,15,0,14,14,25
2021,Franklin County,51067,Asian ,50,50,0,28,28,31
2021,Frederick County,51069,Asian ,431,382,49,100,102,40
2021,Giles County,51071,Asian ,3,3,0,6,6,21
2021,Gloucester County,51073,Asian ,48,34,14,34,30,19
2021,Goochland County,51075,Asian ,110,82,28,56,54,35
2021,Grayson County,51077,Asian ,84,55,29,55,47,32
2021,Greene County,51079,Asian ,146,87,59,51,58,36
2021,Greensville County,51081,Asian ,0,0,0,21,21,21
2021,Halifax County,51083,Asian ,34,27,7,31,30,11
2021,Hanover County,51085,Asian ,480,393,87,81,79,67
2021,Henrico County,51087,Asian ,9885,6212,3673,472,361,419
2021,Henry County,51089,Asian ,46,42,4,22,22,7
2021,Highland County,51091,Asian ,3,3,0,4,4,13
2021,Isle of Wight County,51093,Asian ,104,92,12,53,49,18
2021,James City County,51095,Asian ,640,342,298,103,99,114
2021,King and Queen County,51097,Asian ,0,0,0,19,19,19
2021,King George County,51099,Asian ,126,108,18,46,50,13
2021,King William County,51101,Asian ,54,48,6,20,21,11
2021,Lancaster County,51103,Asian ,34,25,9,17,22,14
2021,Lee County,51105,Asian ,7,7,0,12,12,25
2021,Loudoun County,51107,Asian ,24977,21774,3203,654,620,455
2021,Louisa County,51109,Asian ,69,60,9,42,44,13
2021,Lunenburg County,51111,Asian ,5,5,0,10,10,21
2021,Madison County,51113,Asian ,10,10,0,18,18,21
2021,Mathews County,51115,Asian ,0,0,0,19,19,19
2021,Mecklenburg County,51117,Asian ,117,1,116,65,3,65
2021,Middlesex County,51119,Asian ,39,15,24,44,21,34
2021,Montgomery County,51121,Asian ,2090,618,1472,254,188,235
2021,Nelson County,51125,Asian ,0,0,0,21,21,21
2021,New Kent County,51127,Asian ,47,47,0,44,44,25
2021,Northampton County,51131,Asian ,57,47,10,18,19,11
2021,Northumberland County,51133,Asian ,2,2,0,4,4,21
2021,Nottoway County,51135,Asian ,0,0,0,21,21,21
2021,Orange County,51137,Asian ,136,136,0,46,46,28
2021,Page County,51139,Asian ,48,37,11,26,27,16
2021,Patrick County,51141,Asian ,19,19,0,9,9,21
2021,Pittsylvania County,51143,Asian ,105,89,16,59,48,25
2021,Powhatan County,51145,Asian ,20,20,0,33,33,25
2021,Prince Edward County,51147,Asian ,37,37,0,48,48,25
2021,Prince George County,51149,Asian ,266,164,102,125,113,73
2021,Prince William County,51153,Asian ,11780,9713,2067,449,443,328
2021,Pulaski County,51155,Asian ,70,53,17,33,29,21
2021,Rappahannock County,51157,Asian ,0,0,0,19,19,19
2021,Richmond County,51159,Asian ,0,0,0,19,19,19
2021,Roanoke County,51161,Asian ,928,595,333,145,119,130
2021,Rockbridge County,51163,Asian ,58,8,50,41,14,43
2021,Rockingham County,51165,Asian ,210,77,133,68,54,71
2021,Russell County,51167,Asian ,11,11,0,28,28,25
2021,Scott County,51169,Asian ,0,0,0,25,25,25
2021,Shenandoah County,51171,Asian ,137,37,100,56,34,55
2021,Smyth County,51173,Asian ,21,21,0,33,33,25
2021,Southampton County,51175,Asian ,18,18,0,32,32,21
2021,Spotsylvania County,51177,Asian ,1145,856,289,170,152,103
2021,Stafford County,51179,Asian ,1400,1219,181,187,187,100
2021,Surry County,51181,Asian ,1,1,0,2,2,19
2021,Sussex County,51183,Asian ,17,13,4,18,17,8
2021,Tazewell County,51185,Asian ,84,33,51,52,44,54
2021,Warren County,51187,Asian ,123,98,25,59,59,26
2021,Washington County,51191,Asian ,77,63,14,35,34,14
2021,Westmoreland County,51193,Asian ,57,35,22,22,32,26
2021,Wise County,51195,Asian ,40,40,0,14,14,28
2021,Wythe County,51197,Asian ,107,19,88,34,21,43
2021,York County,51199,Asian ,1123,874,249,175,153,102
2021,Alexandria city,51510,Asian ,4271,2045,2226,264,303,264
2021,Bristol city,51520,Asian ,26,26,0,38,38,21
2021,Buena Vista city,51530,Asian ,0,0,0,19,19,19
2021,Charlottesville city,51540,Asian ,1030,272,758,157,90,139
2021,Chesapeake city,51550,Asian ,2484,1903,581,260,286,145
2021,Colonial Heights city,51570,Asian ,134,119,15,45,41,25
2021,Covington city,51580,Asian ,25,19,6,16,21,8
2021,Danville city,51590,Asian ,143,97,46,53,53,32
2021,Emporia city,51595,Asian ,0,0,0,19,19,19
2021,Fairfax city,51600,Asian ,1581,1200,381,134,132,112
2021,Falls Church city,51610,Asian ,471,261,210,97,108,80
2021,Franklin city,51620,Asian ,116,116,0,116,116,19
2021,Fredericksburg city,51630,Asian ,341,169,172,78,132,72
2021,Galax city,51640,Asian ,0,0,0,19,19,19
2021,Hampton city,51650,Asian ,1076,683,393,182,152,158
2021,Harrisonburg city,51660,Asian ,485,275,210,131,96,100
2021,Hopewell city,51670,Asian ,172,134,38,125,112,60
2021,Lexington city,51678,Asian ,115,50,65,92,73,64
2021,Lynchburg city,51680,Asian ,761,235,526,122,89,126
2021,Manassas city,51683,Asian ,603,473,130,104,103,69
2021,Manassas Park city,51685,Asian ,584,433,151,131,142,126
2021,Martinsville city,51690,Asian ,62,22,40,56,33,46
2021,Newport News city,51700,Asian ,1815,741,1074,201,162,231
2021,Norfolk city,51710,Asian ,3083,1614,1469,205,169,211
2021,Norton city,51720,Asian ,0,0,0,13,13,13
2021,Petersburg city,51730,Asian ,184,133,51,64,46,47
2021,Poquoson city,51735,Asian ,59,59,0,34,34,21
2021,Portsmouth city,51740,Asian ,633,440,193,110,130,103
2021,Radford city,51750,Asian ,61,45,16,42,38,27
2021,Richmond city,51760,Asian ,1863,666,1197,235,138,212
2021,Roanoke city,51770,Asian ,1468,508,960,203,134,189
2021,Salem city,51775,Asian ,192,69,123,53,43,56
2021,Staunton city,51790,Asian ,163,86,77,68,71,46
2021,Suffolk city,51800,Asian ,578,334,244,127,104,152
2021,Virginia Beach city,51810,Asian ,11248,8227,3021,471,484,412
2021,Waynesboro city,51820,Asian ,139,53,86,89,74,66
2021,Williamsburg city,51830,Asian ,43,7,36,65,12,56
2021,Winchester city,51840,Asian ,178,162,16,97,91,26
2010,Accomack County,51001,Native Hawaiian and Other Pacific Islander ,0,0,0,127,127,127
2010,Albemarle County,51003,Native Hawaiian and Other Pacific Islander ,0,0,0,127,127,127
2010,Alleghany County,51005,Native Hawaiian and Other Pacific Islander ,0,0,0,127,127,127
2010,Amelia County,51007,Native Hawaiian and Other Pacific Islander ,0,0,0,127,127,127
2010,Amherst County,51009,Native Hawaiian and Other Pacific Islander ,0,0,0,127,127,127
2010,Appomattox County,51011,Native Hawaiian and Other Pacific Islander ,0,0,0,127,127,127
2010,Arlington County,51013,Native Hawaiian and Other Pacific Islander ,49,22,27,35,25,25
2010,Augusta County,51015,Native Hawaiian and Other Pacific Islander ,5,5,0,8,8,127
2010,Bath County,51017,Native Hawaiian and Other Pacific Islander ,0,0,0,127,127,127
2010,Bedford County,51019,Native Hawaiian and Other Pacific Islander ,0,0,0,127,127,127
2010,Bland County,51021,Native Hawaiian and Other Pacific Islander ,0,0,0,127,127,127
2010,Botetourt County,51023,Native Hawaiian and Other Pacific Islander ,0,0,0,127,127,127
2010,Brunswick County,51025,Native Hawaiian and Other Pacific Islander ,0,0,0,127,127,127
2010,Buchanan County,51027,Native Hawaiian and Other Pacific Islander ,0,0,0,127,127,127
2010,Buckingham County,51029,Native Hawaiian and Other Pacific Islander ,0,0,0,127,127,127
2010,Campbell County,51031,Native Hawaiian and Other Pacific Islander ,0,0,0,127,127,127
2010,Caroline County,51033,Native Hawaiian and Other Pacific Islander ,15,15,0,25,25,127
2010,Carroll County,51035,Native Hawaiian and Other Pacific Islander ,0,0,0,127,127,127
2010,Charles City County,51036,Native Hawaiian and Other Pacific Islander ,0,0,0,127,127,127
2010,Charlotte County,51037,Native Hawaiian and Other Pacific Islander ,0,0,0,127,127,127
2010,Chesterfield County,51041,Native Hawaiian and Other Pacific Islander ,36,36,0,53,53,127
2010,Clarke County,51043,Native Hawaiian and Other Pacific Islander ,0,0,0,127,127,127
2010,Craig County,51045,Native Hawaiian and Other Pacific Islander ,0,0,0,127,127,127
2010,Culpeper County,51047,Native Hawaiian and Other Pacific Islander ,0,0,0,127,127,127
2010,Cumberland County,51049,Native Hawaiian and Other Pacific Islander ,0,0,0,127,127,127
2010,Dickenson County,51051,Native Hawaiian and Other Pacific Islander ,0,0,0,127,127,127
2010,Dinwiddie County,51053,Native Hawaiian and Other Pacific Islander ,0,0,0,127,127,127
2010,Essex County,51057,Native Hawaiian and Other Pacific Islander ,11,0,11,16,127,16
2010,Fairfax County,51059,Native Hawaiian and Other Pacific Islander ,387,251,136,106,91,92
2010,Fauquier County,51061,Native Hawaiian and Other Pacific Islander ,0,0,0,127,127,127
2010,Floyd County,51063,Native Hawaiian and Other Pacific Islander ,0,0,0,127,127,127
2010,Fluvanna County,51065,Native Hawaiian and Other Pacific Islander ,0,0,0,127,127,127
2010,Franklin County,51067,Native Hawaiian and Other Pacific Islander ,0,0,0,127,127,127
2010,Frederick County,51069,Native Hawaiian and Other Pacific Islander ,0,0,0,127,127,127
2010,Giles County,51071,Native Hawaiian and Other Pacific Islander ,0,0,0,127,127,127
2010,Gloucester County,51073,Native Hawaiian and Other Pacific Islander ,12,12,0,25,25,127
2010,Goochland County,51075,Native Hawaiian and Other Pacific Islander ,0,0,0,127,127,127
2010,Grayson County,51077,Native Hawaiian and Other Pacific Islander ,0,0,0,127,127,127
2010,Greene County,51079,Native Hawaiian and Other Pacific Islander ,0,0,0,127,127,127
2010,Greensville County,51081,Native Hawaiian and Other Pacific Islander ,0,0,0,127,127,127
2010,Halifax County,51083,Native Hawaiian and Other Pacific Islander ,18,0,18,28,127,28
2010,Hanover County,51085,Native Hawaiian and Other Pacific Islander ,44,22,22,47,33,31
2010,Henrico County,51087,Native Hawaiian and Other Pacific Islander ,34,11,23,28,22,19
2010,Henry County,51089,Native Hawaiian and Other Pacific Islander ,0,0,0,127,127,127
2010,Highland County,51091,Native Hawaiian and Other Pacific Islander ,0,0,0,127,127,127
2010,Isle of Wight County,51093,Native Hawaiian and Other Pacific Islander ,0,0,0,127,127,127
2010,James City County,51095,Native Hawaiian and Other Pacific Islander ,22,22,0,35,35,127
2010,King and Queen County,51097,Native Hawaiian and Other Pacific Islander ,0,0,0,127,127,127
2010,King George County,51099,Native Hawaiian and Other Pacific Islander ,0,0,0,127,127,127
2010,King William County,51101,Native Hawaiian and Other Pacific Islander ,0,0,0,127,127,127
2010,Lancaster County,51103,Native Hawaiian and Other Pacific Islander ,0,0,0,127,127,127
2010,Lee County,51105,Native Hawaiian and Other Pacific Islander ,0,0,0,127,127,127
2010,Loudoun County,51107,Native Hawaiian and Other Pacific Islander ,17,17,0,16,16,127
2010,Louisa County,51109,Native Hawaiian and Other Pacific Islander ,0,0,0,127,127,127
2010,Lunenburg County,51111,Native Hawaiian and Other Pacific Islander ,3,3,0,7,7,127
2010,Madison County,51113,Native Hawaiian and Other Pacific Islander ,0,0,0,127,127,127
2010,Mathews County,51115,Native Hawaiian and Other Pacific Islander ,0,0,0,127,127,127
2010,Mecklenburg County,51117,Native Hawaiian and Other Pacific Islander ,18,18,0,20,20,127
2010,Middlesex County,51119,Native Hawaiian and Other Pacific Islander ,0,0,0,127,127,127
2010,Montgomery County,51121,Native Hawaiian and Other Pacific Islander ,0,0,0,127,127,127
2010,Nelson County,51125,Native Hawaiian and Other Pacific Islander ,0,0,0,127,127,127
2010,New Kent County,51127,Native Hawaiian and Other Pacific Islander ,0,0,0,127,127,127
2010,Northampton County,51131,Native Hawaiian and Other Pacific Islander ,0,0,0,127,127,127
2010,Northumberland County,51133,Native Hawaiian and Other Pacific Islander ,0,0,0,127,127,127
2010,Nottoway County,51135,Native Hawaiian and Other Pacific Islander ,0,0,0,127,127,127
2010,Orange County,51137,Native Hawaiian and Other Pacific Islander ,0,0,0,127,127,127
2010,Page County,51139,Native Hawaiian and Other Pacific Islander ,0,0,0,127,127,127
2010,Patrick County,51141,Native Hawaiian and Other Pacific Islander ,0,0,0,127,127,127
2010,Pittsylvania County,51143,Native Hawaiian and Other Pacific Islander ,8,8,0,13,13,127
2010,Powhatan County,51145,Native Hawaiian and Other Pacific Islander ,0,0,0,127,127,127
2010,Prince Edward County,51147,Native Hawaiian and Other Pacific Islander ,0,0,0,127,127,127
2010,Prince George County,51149,Native Hawaiian and Other Pacific Islander ,11,0,11,18,127,18
2010,Prince William County,51153,Native Hawaiian and Other Pacific Islander ,88,33,55,70,41,56
2010,Pulaski County,51155,Native Hawaiian and Other Pacific Islander ,0,0,0,127,127,127
2010,Rappahannock County,51157,Native Hawaiian and Other Pacific Islander ,0,0,0,127,127,127
2010,Richmond County,51159,Native Hawaiian and Other Pacific Islander ,0,0,0,127,127,127
2010,Roanoke County,51161,Native Hawaiian and Other Pacific Islander ,7,7,0,13,13,127
2010,Rockbridge County,51163,Native Hawaiian and Other Pacific Islander ,0,0,0,127,127,127
2010,Rockingham County,51165,Native Hawaiian and Other Pacific Islander ,17,17,0,30,30,127
2010,Russell County,51167,Native Hawaiian and Other Pacific Islander ,0,0,0,127,127,127
2010,Scott County,51169,Native Hawaiian and Other Pacific Islander ,0,0,0,127,127,127
2010,Shenandoah County,51171,Native Hawaiian and Other Pacific Islander ,0,0,0,127,127,127
2010,Smyth County,51173,Native Hawaiian and Other Pacific Islander ,0,0,0,127,127,127
2010,Southampton County,51175,Native Hawaiian and Other Pacific Islander ,0,0,0,127,127,127
2010,Spotsylvania County,51177,Native Hawaiian and Other Pacific Islander ,36,0,36,41,127,41
2010,Stafford County,51179,Native Hawaiian and Other Pacific Islander ,20,20,0,30,30,127
2010,Surry County,51181,Native Hawaiian and Other Pacific Islander ,0,0,0,127,127,127
2010,Sussex County,51183,Native Hawaiian and Other Pacific Islander ,0,0,0,127,127,127
2010,Tazewell County,51185,Native Hawaiian and Other Pacific Islander ,0,0,0,127,127,127
2010,Warren County,51187,Native Hawaiian and Other Pacific Islander ,10,0,10,24,127,24
2010,Washington County,51191,Native Hawaiian and Other Pacific Islander ,0,0,0,127,127,127
2010,Westmoreland County,51193,Native Hawaiian and Other Pacific Islander ,0,0,0,127,127,127
2010,Wise County,51195,Native Hawaiian and Other Pacific Islander ,12,12,0,20,20,127
2010,Wythe County,51197,Native Hawaiian and Other Pacific Islander ,0,0,0,127,127,127
2010,York County,51199,Native Hawaiian and Other Pacific Islander ,47,47,0,53,53,127
2010,Alexandria city,51510,Native Hawaiian and Other Pacific Islander ,80,62,18,65,58,22
2010,Bedford County,51019,Native Hawaiian and Other Pacific Islander ,0,0,0,127,127,127
2010,Bristol city,51520,Native Hawaiian and Other Pacific Islander ,0,0,0,127,127,127
2010,Buena Vista city,51530,Native Hawaiian and Other Pacific Islander ,0,0,0,127,127,127
2010,Charlottesville city,51540,Native Hawaiian and Other Pacific Islander ,0,0,0,127,127,127
2010,Chesapeake city,51550,Native Hawaiian and Other Pacific Islander ,43,14,29,50,22,46
2010,Colonial Heights city,51570,Native Hawaiian and Other Pacific Islander ,0,0,0,127,127,127
2010,Covington city,51580,Native Hawaiian and Other Pacific Islander ,0,0,0,127,127,127
2010,Danville city,51590,Native Hawaiian and Other Pacific Islander ,8,8,0,12,12,127
2010,Emporia city,51595,Native Hawaiian and Other Pacific Islander ,0,0,0,127,127,127
2010,Fairfax city,51600,Native Hawaiian and Other Pacific Islander ,23,0,23,30,127,30
2010,Falls Church city,51610,Native Hawaiian and Other Pacific Islander ,0,0,0,127,127,127
2010,Franklin city,51620,Native Hawaiian and Other Pacific Islander ,0,0,0,127,127,127
2010,Fredericksburg city,51630,Native Hawaiian and Other Pacific Islander ,0,0,0,127,127,127
2010,Galax city,51640,Native Hawaiian and Other Pacific Islander ,0,0,0,127,127,127
2010,Hampton city,51650,Native Hawaiian and Other Pacific Islander ,32,18,14,36,27,26
2010,Harrisonburg city,51660,Native Hawaiian and Other Pacific Islander ,9,0,9,16,127,16
2010,Hopewell city,51670,Native Hawaiian and Other Pacific Islander ,0,0,0,127,127,127
2010,Lexington city,51678,Native Hawaiian and Other Pacific Islander ,10,10,0,16,16,127
2010,Lynchburg city,51680,Native Hawaiian and Other Pacific Islander ,0,0,0,127,127,127
2010,Manassas city,51683,Native Hawaiian and Other Pacific Islander ,0,0,0,127,127,127
2010,Manassas Park city,51685,Native Hawaiian and Other Pacific Islander ,0,0,0,127,127,127
2010,Martinsville city,51690,Native Hawaiian and Other Pacific Islander ,0,0,0,127,127,127
2010,Newport News city,51700,Native Hawaiian and Other Pacific Islander ,46,46,0,19,19,127
2010,Norfolk city,51710,Native Hawaiian and Other Pacific Islander ,90,0,90,42,127,42
2010,Norton city,51720,Native Hawaiian and Other Pacific Islander ,0,0,0,127,127,127
2010,Petersburg city,51730,Native Hawaiian and Other Pacific Islander ,32,0,32,40,127,40
2010,Poquoson city,51735,Native Hawaiian and Other Pacific Islander ,0,0,0,127,127,127
2010,Portsmouth city,51740,Native Hawaiian and Other Pacific Islander ,67,10,57,84,16,83
2010,Radford city,51750,Native Hawaiian and Other Pacific Islander ,0,0,0,127,127,127
2010,Richmond city,51760,Native Hawaiian and Other Pacific Islander ,0,0,0,127,127,127
2010,Roanoke city,51770,Native Hawaiian and Other Pacific Islander ,0,0,0,127,127,127
2010,Salem city,51775,Native Hawaiian and Other Pacific Islander ,0,0,0,127,127,127
2010,Staunton city,51790,Native Hawaiian and Other Pacific Islander ,0,0,0,127,127,127
2010,Suffolk city,51800,Native Hawaiian and Other Pacific Islander ,0,0,0,127,127,127
2010,Virginia Beach city,51810,Native Hawaiian and Other Pacific Islander ,321,147,174,121,134,136
2010,Waynesboro city,51820,Native Hawaiian and Other Pacific Islander ,0,0,0,127,127,127
2010,Williamsburg city,51830,Native Hawaiian and Other Pacific Islander ,0,0,0,127,127,127
2010,Winchester city,51840,Native Hawaiian and Other Pacific Islander ,0,0,0,127,127,127
2011,Accomack County,51001,Native Hawaiian and Other Pacific Islander ,0,0,0,95,95,95
2011,Albemarle County,51003,Native Hawaiian and Other Pacific Islander ,0,0,0,95,95,95
2011,Alleghany County,51005,Native Hawaiian and Other Pacific Islander ,0,0,0,95,95,95
2011,Amelia County,51007,Native Hawaiian and Other Pacific Islander ,0,0,0,95,95,95
2011,Amherst County,51009,Native Hawaiian and Other Pacific Islander ,0,0,0,95,95,95
2011,Appomattox County,51011,Native Hawaiian and Other Pacific Islander ,0,0,0,95,95,95
2011,Arlington County,51013,Native Hawaiian and Other Pacific Islander ,41,18,23,31,22,23
2011,Augusta County,51015,Native Hawaiian and Other Pacific Islander ,8,8,0,15,15,95
2011,Bath County,51017,Native Hawaiian and Other Pacific Islander ,0,0,0,95,95,95
2011,Bedford County,51019,Native Hawaiian and Other Pacific Islander ,0,0,0,95,95,95
2011,Bland County,51021,Native Hawaiian and Other Pacific Islander ,0,0,0,95,95,95
2011,Botetourt County,51023,Native Hawaiian and Other Pacific Islander ,0,0,0,95,95,95
2011,Brunswick County,51025,Native Hawaiian and Other Pacific Islander ,0,0,0,95,95,95
2011,Buchanan County,51027,Native Hawaiian and Other Pacific Islander ,0,0,0,95,95,95
2011,Buckingham County,51029,Native Hawaiian and Other Pacific Islander ,0,0,0,95,95,95
2011,Campbell County,51031,Native Hawaiian and Other Pacific Islander ,0,0,0,95,95,95
2011,Caroline County,51033,Native Hawaiian and Other Pacific Islander ,0,0,0,95,95,95
2011,Carroll County,51035,Native Hawaiian and Other Pacific Islander ,0,0,0,95,95,95
2011,Charles City County,51036,Native Hawaiian and Other Pacific Islander ,2,0,2,4,95,4
2011,Charlotte County,51037,Native Hawaiian and Other Pacific Islander ,0,0,0,95,95,95
2011,Chesterfield County,51041,Native Hawaiian and Other Pacific Islander ,43,40,3,33,35,7
2011,Clarke County,51043,Native Hawaiian and Other Pacific Islander ,0,0,0,95,95,95
2011,Craig County,51045,Native Hawaiian and Other Pacific Islander ,0,0,0,95,95,95
2011,Culpeper County,51047,Native Hawaiian and Other Pacific Islander ,0,0,0,95,95,95
2011,Cumberland County,51049,Native Hawaiian and Other Pacific Islander ,0,0,0,95,95,95
2011,Dickenson County,51051,Native Hawaiian and Other Pacific Islander ,0,0,0,95,95,95
2011,Dinwiddie County,51053,Native Hawaiian and Other Pacific Islander ,0,0,0,95,95,95
2011,Essex County,51057,Native Hawaiian and Other Pacific Islander ,7,0,7,15,95,15
2011,Fairfax County,51059,Native Hawaiian and Other Pacific Islander ,467,342,125,89,82,68
2011,Fauquier County,51061,Native Hawaiian and Other Pacific Islander ,18,18,0,29,29,95
2011,Floyd County,51063,Native Hawaiian and Other Pacific Islander ,0,0,0,95,95,95
2011,Fluvanna County,51065,Native Hawaiian and Other Pacific Islander ,0,0,0,95,95,95
2011,Franklin County,51067,Native Hawaiian and Other Pacific Islander ,0,0,0,95,95,95
2011,Frederick County,51069,Native Hawaiian and Other Pacific Islander ,0,0,0,95,95,95
2011,Giles County,51071,Native Hawaiian and Other Pacific Islander ,0,0,0,95,95,95
2011,Gloucester County,51073,Native Hawaiian and Other Pacific Islander ,7,7,0,14,14,95
2011,Goochland County,51075,Native Hawaiian and Other Pacific Islander ,0,0,0,95,95,95
2011,Grayson County,51077,Native Hawaiian and Other Pacific Islander ,0,0,0,95,95,95
2011,Greene County,51079,Native Hawaiian and Other Pacific Islander ,0,0,0,95,95,95
2011,Greensville County,51081,Native Hawaiian and Other Pacific Islander ,0,0,0,95,95,95
2011,Halifax County,51083,Native Hawaiian and Other Pacific Islander ,0,0,0,95,95,95
2011,Hanover County,51085,Native Hawaiian and Other Pacific Islander ,0,0,0,95,95,95
2011,Henrico County,51087,Native Hawaiian and Other Pacific Islander ,35,7,28,26,16,22
2011,Henry County,51089,Native Hawaiian and Other Pacific Islander ,0,0,0,95,95,95
2011,Highland County,51091,Native Hawaiian and Other Pacific Islander ,0,0,0,95,95,95
2011,Isle of Wight County,51093,Native Hawaiian and Other Pacific Islander ,0,0,0,95,95,95
2011,James City County,51095,Native Hawaiian and Other Pacific Islander ,20,20,0,29,29,95
2011,King and Queen County,51097,Native Hawaiian and Other Pacific Islander ,0,0,0,95,95,95
2011,King George County,51099,Native Hawaiian and Other Pacific Islander ,0,0,0,95,95,95
2011,King William County,51101,Native Hawaiian and Other Pacific Islander ,0,0,0,95,95,95
2011,Lancaster County,51103,Native Hawaiian and Other Pacific Islander ,0,0,0,95,95,95
2011,Lee County,51105,Native Hawaiian and Other Pacific Islander ,0,0,0,95,95,95
2011,Loudoun County,51107,Native Hawaiian and Other Pacific Islander ,0,0,0,95,95,95
2011,Louisa County,51109,Native Hawaiian and Other Pacific Islander ,0,0,0,95,95,95
2011,Lunenburg County,51111,Native Hawaiian and Other Pacific Islander ,3,3,0,5,5,95
2011,Madison County,51113,Native Hawaiian and Other Pacific Islander ,0,0,0,95,95,95
2011,Mathews County,51115,Native Hawaiian and Other Pacific Islander ,0,0,0,95,95,95
2011,Mecklenburg County,51117,Native Hawaiian and Other Pacific Islander ,18,18,0,21,21,95
2011,Middlesex County,51119,Native Hawaiian and Other Pacific Islander ,0,0,0,95,95,95
2011,Montgomery County,51121,Native Hawaiian and Other Pacific Islander ,0,0,0,95,95,95
2011,Nelson County,51125,Native Hawaiian and Other Pacific Islander ,0,0,0,95,95,95
2011,New Kent County,51127,Native Hawaiian and Other Pacific Islander ,0,0,0,95,95,95
2011,Northampton County,51131,Native Hawaiian and Other Pacific Islander ,0,0,0,95,95,95
2011,Northumberland County,51133,Native Hawaiian and Other Pacific Islander ,0,0,0,95,95,95
2011,Nottoway County,51135,Native Hawaiian and Other Pacific Islander ,0,0,0,95,95,95
2011,Orange County,51137,Native Hawaiian and Other Pacific Islander ,0,0,0,95,95,95
2011,Page County,51139,Native Hawaiian and Other Pacific Islander ,0,0,0,95,95,95
2011,Patrick County,51141,Native Hawaiian and Other Pacific Islander ,0,0,0,95,95,95
2011,Pittsylvania County,51143,Native Hawaiian and Other Pacific Islander ,0,0,0,95,95,95
2011,Powhatan County,51145,Native Hawaiian and Other Pacific Islander ,0,0,0,95,95,95
2011,Prince Edward County,51147,Native Hawaiian and Other Pacific Islander ,0,0,0,95,95,95
2011,Prince George County,51149,Native Hawaiian and Other Pacific Islander ,38,19,19,44,36,30
2011,Prince William County,51153,Native Hawaiian and Other Pacific Islander ,98,56,42,60,58,50
2011,Pulaski County,51155,Native Hawaiian and Other Pacific Islander ,0,0,0,95,95,95
2011,Rappahannock County,51157,Native Hawaiian and Other Pacific Islander ,0,0,0,95,95,95
2011,Richmond County,51159,Native Hawaiian and Other Pacific Islander ,0,0,0,95,95,95
2011,Roanoke County,51161,Native Hawaiian and Other Pacific Islander ,0,0,0,95,95,95
2011,Rockbridge County,51163,Native Hawaiian and Other Pacific Islander ,0,0,0,95,95,95
2011,Rockingham County,51165,Native Hawaiian and Other Pacific Islander ,12,12,0,20,20,95
2011,Russell County,51167,Native Hawaiian and Other Pacific Islander ,0,0,0,95,95,95
2011,Scott County,51169,Native Hawaiian and Other Pacific Islander ,0,0,0,95,95,95
2011,Shenandoah County,51171,Native Hawaiian and Other Pacific Islander ,0,0,0,95,95,95
2011,Smyth County,51173,Native Hawaiian and Other Pacific Islander ,0,0,0,95,95,95
2011,Southampton County,51175,Native Hawaiian and Other Pacific Islander ,0,0,0,95,95,95
2011,Spotsylvania County,51177,Native Hawaiian and Other Pacific Islander ,45,0,45,52,95,52
2011,Stafford County,51179,Native Hawaiian and Other Pacific Islander ,5,0,5,17,95,17
2011,Surry County,51181,Native Hawaiian and Other Pacific Islander ,0,0,0,95,95,95
2011,Sussex County,51183,Native Hawaiian and Other Pacific Islander ,0,0,0,95,95,95
2011,Tazewell County,51185,Native Hawaiian and Other Pacific Islander ,0,0,0,95,95,95
2011,Warren County,51187,Native Hawaiian and Other Pacific Islander ,0,0,0,95,95,95
2011,Washington County,51191,Native Hawaiian and Other Pacific Islander ,0,0,0,95,95,95
2011,Westmoreland County,51193,Native Hawaiian and Other Pacific Islander ,0,0,0,95,95,95
2011,Wise County,51195,Native Hawaiian and Other Pacific Islander ,0,0,0,95,95,95
2011,Wythe County,51197,Native Hawaiian and Other Pacific Islander ,0,0,0,95,95,95
2011,York County,51199,Native Hawaiian and Other Pacific Islander ,64,64,0,71,71,95
2011,Alexandria city,51510,Native Hawaiian and Other Pacific Islander ,54,44,10,20,17,15
2011,Bedford County,51019,Native Hawaiian and Other Pacific Islander ,0,0,0,95,95,95
2011,Bristol city,51520,Native Hawaiian and Other Pacific Islander ,0,0,0,95,95,95
2011,Buena Vista city,51530,Native Hawaiian and Other Pacific Islander ,0,0,0,95,95,95
2011,Charlottesville city,51540,Native Hawaiian and Other Pacific Islander ,0,0,0,95,95,95
2011,Chesapeake city,51550,Native Hawaiian and Other Pacific Islander ,19,9,10,32,19,23
2011,Colonial Heights city,51570,Native Hawaiian and Other Pacific Islander ,0,0,0,95,95,95
2011,Covington city,51580,Native Hawaiian and Other Pacific Islander ,0,0,0,95,95,95
2011,Danville city,51590,Native Hawaiian and Other Pacific Islander ,8,8,0,14,14,95
2011,Emporia city,51595,Native Hawaiian and Other Pacific Islander ,0,0,0,95,95,95
2011,Fairfax city,51600,Native Hawaiian and Other Pacific Islander ,22,0,22,33,95,33
2011,Falls Church city,51610,Native Hawaiian and Other Pacific Islander ,0,0,0,95,95,95
2011,Franklin city,51620,Native Hawaiian and Other Pacific Islander ,0,0,0,95,95,95
2011,Fredericksburg city,51630,Native Hawaiian and Other Pacific Islander ,3,3,0,6,6,95
2011,Galax city,51640,Native Hawaiian and Other Pacific Islander ,0,0,0,95,95,95
2011,Hampton city,51650,Native Hawaiian and Other Pacific Islander ,13,0,13,22,95,22
2011,Harrisonburg city,51660,Native Hawaiian and Other Pacific Islander ,0,0,0,95,95,95
2011,Hopewell city,51670,Native Hawaiian and Other Pacific Islander ,0,0,0,95,95,95
2011,Lexington city,51678,Native Hawaiian and Other Pacific Islander ,11,11,0,17,17,95
2011,Lynchburg city,51680,Native Hawaiian and Other Pacific Islander ,0,0,0,95,95,95
2011,Manassas city,51683,Native Hawaiian and Other Pacific Islander ,0,0,0,95,95,95
2011,Manassas Park city,51685,Native Hawaiian and Other Pacific Islander ,0,0,0,95,95,95
2011,Martinsville city,51690,Native Hawaiian and Other Pacific Islander ,0,0,0,95,95,95
2011,Newport News city,51700,Native Hawaiian and Other Pacific Islander ,62,62,0,35,35,95
2011,Norfolk city,51710,Native Hawaiian and Other Pacific Islander ,97,0,97,54,95,54
2011,Norton city,51720,Native Hawaiian and Other Pacific Islander ,0,0,0,95,95,95
2011,Petersburg city,51730,Native Hawaiian and Other Pacific Islander ,36,0,36,44,95,44
2011,Poquoson city,51735,Native Hawaiian and Other Pacific Islander ,0,0,0,95,95,95
2011,Portsmouth city,51740,Native Hawaiian and Other Pacific Islander ,49,8,41,65,14,64
2011,Radford city,51750,Native Hawaiian and Other Pacific Islander ,0,0,0,95,95,95
2011,Richmond city,51760,Native Hawaiian and Other Pacific Islander ,0,0,0,95,95,95
2011,Roanoke city,51770,Native Hawaiian and Other Pacific Islander ,0,0,0,95,95,95
2011,Salem city,51775,Native Hawaiian and Other Pacific Islander ,0,0,0,95,95,95
2011,Staunton city,51790,Native Hawaiian and Other Pacific Islander ,0,0,0,95,95,95
2011,Suffolk city,51800,Native Hawaiian and Other Pacific Islander ,0,0,0,95,95,95
2011,Virginia Beach city,51810,Native Hawaiian and Other Pacific Islander ,256,110,146,152,115,148
2011,Waynesboro city,51820,Native Hawaiian and Other Pacific Islander ,0,0,0,95,95,95
2011,Williamsburg city,51830,Native Hawaiian and Other Pacific Islander ,0,0,0,95,95,95
2011,Winchester city,51840,Native Hawaiian and Other Pacific Islander ,0,0,0,95,95,95
2012,Accomack County,51001,Native Hawaiian and Other Pacific Islander ,0,0,0,26,26,26
2012,Albemarle County,51003,Native Hawaiian and Other Pacific Islander ,0,0,0,29,29,29
2012,Alleghany County,51005,Native Hawaiian and Other Pacific Islander ,0,0,0,19,19,19
2012,Amelia County,51007,Native Hawaiian and Other Pacific Islander ,0,0,0,19,19,19
2012,Amherst County,51009,Native Hawaiian and Other Pacific Islander ,8,0,8,13,26,13
2012,Appomattox County,51011,Native Hawaiian and Other Pacific Islander ,0,0,0,19,19,19
2012,Arlington County,51013,Native Hawaiian and Other Pacific Islander ,46,28,18,28,24,13
2012,Augusta County,51015,Native Hawaiian and Other Pacific Islander ,6,6,0,10,10,29
2012,Bath County,51017,Native Hawaiian and Other Pacific Islander ,0,0,0,12,12,12
2012,Bedford County,51019,Native Hawaiian and Other Pacific Islander ,8,8,0,13,13,29
2012,Bland County,51021,Native Hawaiian and Other Pacific Islander ,0,0,0,17,17,17
2012,Botetourt County,51023,Native Hawaiian and Other Pacific Islander ,0,0,0,26,26,26
2012,Brunswick County,51025,Native Hawaiian and Other Pacific Islander ,0,0,0,19,19,19
2012,Buchanan County,51027,Native Hawaiian and Other Pacific Islander ,0,0,0,23,23,23
2012,Buckingham County,51029,Native Hawaiian and Other Pacific Islander ,0,0,0,19,19,19
2012,Campbell County,51031,Native Hawaiian and Other Pacific Islander ,8,8,0,13,13,29
2012,Caroline County,51033,Native Hawaiian and Other Pacific Islander ,0,0,0,23,23,23
2012,Carroll County,51035,Native Hawaiian and Other Pacific Islander ,0,0,0,23,23,23
2012,Charles City County,51036,Native Hawaiian and Other Pacific Islander ,1,0,1,3,17,3
2012,Charlotte County,51037,Native Hawaiian and Other Pacific Islander ,0,0,0,19,19,19
2012,Chesterfield County,51041,Native Hawaiian and Other Pacific Islander ,28,27,1,18,18,2
2012,Clarke County,51043,Native Hawaiian and Other Pacific Islander ,0,0,0,19,19,19
2012,Craig County,51045,Native Hawaiian and Other Pacific Islander ,0,0,0,17,17,17
2012,Culpeper County,51047,Native Hawaiian and Other Pacific Islander ,0,0,0,26,26,26
2012,Cumberland County,51049,Native Hawaiian and Other Pacific Islander ,0,0,0,17,17,17
2012,Dickenson County,51051,Native Hawaiian and Other Pacific Islander ,0,0,0,19,19,19
2012,Dinwiddie County,51053,Native Hawaiian and Other Pacific Islander ,0,0,0,23,23,23
2012,Essex County,51057,Native Hawaiian and Other Pacific Islander ,9,0,9,15,19,15
2012,Fairfax County,51059,Native Hawaiian and Other Pacific Islander ,537,379,158,122,101,109
2012,Fauquier County,51061,Native Hawaiian and Other Pacific Islander ,20,20,0,31,31,29
2012,Floyd County,51063,Native Hawaiian and Other Pacific Islander ,0,0,0,19,19,19
2012,Fluvanna County,51065,Native Hawaiian and Other Pacific Islander ,0,0,0,23,23,23
2012,Franklin County,51067,Native Hawaiian and Other Pacific Islander ,0,0,0,29,29,29
2012,Frederick County,51069,Native Hawaiian and Other Pacific Islander ,0,0,0,29,29,29
2012,Giles County,51071,Native Hawaiian and Other Pacific Islander ,0,0,0,19,19,19
2012,Gloucester County,51073,Native Hawaiian and Other Pacific Islander ,7,7,0,13,13,26
2012,Goochland County,51075,Native Hawaiian and Other Pacific Islander ,0,0,0,23,23,23
2012,Grayson County,51077,Native Hawaiian and Other Pacific Islander ,0,0,0,19,19,19
2012,Greene County,51079,Native Hawaiian and Other Pacific Islander ,0,0,0,19,19,19
2012,Greensville County,51081,Native Hawaiian and Other Pacific Islander ,0,0,0,19,19,19
2012,Halifax County,51083,Native Hawaiian and Other Pacific Islander ,0,0,0,26,26,26
2012,Hanover County,51085,Native Hawaiian and Other Pacific Islander ,0,0,0,29,29,29
2012,Henrico County,51087,Native Hawaiian and Other Pacific Islander ,27,13,14,24,19,17
2012,Henry County,51089,Native Hawaiian and Other Pacific Islander ,0,0,0,29,29,29
2012,Highland County,51091,Native Hawaiian and Other Pacific Islander ,0,0,0,12,12,12
2012,Isle of Wight County,51093,Native Hawaiian and Other Pacific Islander ,0,0,0,26,26,26
2012,James City County,51095,Native Hawaiian and Other Pacific Islander ,14,14,0,22,22,29
2012,King and Queen County,51097,Native Hawaiian and Other Pacific Islander ,0,0,0,17,17,17
2012,King George County,51099,Native Hawaiian and Other Pacific Islander ,0,0,0,23,23,23
2012,King William County,51101,Native Hawaiian and Other Pacific Islander ,0,0,0,19,19,19
2012,Lancaster County,51103,Native Hawaiian and Other Pacific Islander ,0,0,0,19,19,19
2012,Lee County,51105,Native Hawaiian and Other Pacific Islander ,0,0,0,23,23,23
2012,Loudoun County,51107,Native Hawaiian and Other Pacific Islander ,7,7,0,16,16,29
2012,Louisa County,51109,Native Hawaiian and Other Pacific Islander ,0,0,0,26,26,26
2012,Lunenburg County,51111,Native Hawaiian and Other Pacific Islander ,4,4,0,6,6,19
2012,Madison County,51113,Native Hawaiian and Other Pacific Islander ,0,0,0,19,19,19
2012,Mathews County,51115,Native Hawaiian and Other Pacific Islander ,0,0,0,17,17,17
2012,Mecklenburg County,51117,Native Hawaiian and Other Pacific Islander ,14,14,0,17,17,26
2012,Middlesex County,51119,Native Hawaiian and Other Pacific Islander ,0,0,0,19,19,19
2012,Montgomery County,51121,Native Hawaiian and Other Pacific Islander ,13,0,13,21,29,21
2012,Nelson County,51125,Native Hawaiian and Other Pacific Islander ,0,0,0,19,19,19
2012,New Kent County,51127,Native Hawaiian and Other Pacific Islander ,0,0,0,19,19,19
2012,Northampton County,51131,Native Hawaiian and Other Pacific Islander ,0,0,0,19,19,19
2012,Northumberland County,51133,Native Hawaiian and Other Pacific Islander ,0,0,0,19,19,19
2012,Nottoway County,51135,Native Hawaiian and Other Pacific Islander ,0,0,0,19,19,19
2012,Orange County,51137,Native Hawaiian and Other Pacific Islander ,0,0,0,26,26,26
2012,Page County,51139,Native Hawaiian and Other Pacific Islander ,0,0,0,23,23,23
2012,Patrick County,51141,Native Hawaiian and Other Pacific Islander ,0,0,0,19,19,19
2012,Pittsylvania County,51143,Native Hawaiian and Other Pacific Islander ,0,0,0,29,29,29
2012,Powhatan County,51145,Native Hawaiian and Other Pacific Islander ,0,0,0,23,23,23
2012,Prince Edward County,51147,Native Hawaiian and Other Pacific Islander ,0,0,0,23,23,23
2012,Prince George County,51149,Native Hawaiian and Other Pacific Islander ,24,12,12,17,23,9
2012,Prince William County,51153,Native Hawaiian and Other Pacific Islander ,109,87,22,35,38,20
2012,Pulaski County,51155,Native Hawaiian and Other Pacific Islander ,0,0,0,26,26,26
2012,Rappahannock County,51157,Native Hawaiian and Other Pacific Islander ,0,0,0,17,17,17
2012,Richmond County,51159,Native Hawaiian and Other Pacific Islander ,0,0,0,17,17,17
2012,Roanoke County,51161,Native Hawaiian and Other Pacific Islander ,0,0,0,29,29,29
2012,Rockbridge County,51163,Native Hawaiian and Other Pacific Islander ,0,0,0,23,23,23
2012,Rockingham County,51165,Native Hawaiian and Other Pacific Islander ,0,0,0,29,29,29
2012,Russell County,51167,Native Hawaiian and Other Pacific Islander ,0,0,0,23,23,23
2012,Scott County,51169,Native Hawaiian and Other Pacific Islander ,0,0,0,23,23,23
2012,Shenandoah County,51171,Native Hawaiian and Other Pacific Islander ,0,0,0,26,26,26
2012,Smyth County,51173,Native Hawaiian and Other Pacific Islander ,0,0,0,26,26,26
2012,Southampton County,51175,Native Hawaiian and Other Pacific Islander ,0,0,0,19,19,19
2012,Spotsylvania County,51177,Native Hawaiian and Other Pacific Islander ,35,5,30,51,13,55
2012,Stafford County,51179,Native Hawaiian and Other Pacific Islander ,34,18,16,41,28,31
2012,Surry County,51181,Native Hawaiian and Other Pacific Islander ,0,0,0,17,17,17
2012,Sussex County,51183,Native Hawaiian and Other Pacific Islander ,0,0,0,19,19,19
2012,Tazewell County,51185,Native Hawaiian and Other Pacific Islander ,0,0,0,26,26,26
2012,Warren County,51187,Native Hawaiian and Other Pacific Islander ,0,0,0,26,26,26
2012,Washington County,51191,Native Hawaiian and Other Pacific Islander ,0,0,0,29,29,29
2012,Westmoreland County,51193,Native Hawaiian and Other Pacific Islander ,0,0,0,19,19,19
2012,Wise County,51195,Native Hawaiian and Other Pacific Islander ,0,0,0,26,26,26
2012,Wythe County,51197,Native Hawaiian and Other Pacific Islander ,0,0,0,23,23,23
2012,York County,51199,Native Hawaiian and Other Pacific Islander ,71,71,0,74,74,29
2012,Alexandria city,51510,Native Hawaiian and Other Pacific Islander ,49,41,8,44,42,12
2012,Bedford County,51019,Native Hawaiian and Other Pacific Islander ,0,0,0,17,17,17
2012,Bristol city,51520,Native Hawaiian and Other Pacific Islander ,0,0,0,19,19,19
2012,Buena Vista city,51530,Native Hawaiian and Other Pacific Islander ,0,0,0,17,17,17
2012,Charlottesville city,51540,Native Hawaiian and Other Pacific Islander ,8,0,8,15,26,15
2012,Chesapeake city,51550,Native Hawaiian and Other Pacific Islander ,20,8,12,33,13,27
2012,Colonial Heights city,51570,Native Hawaiian and Other Pacific Islander ,0,0,0,19,19,19
2012,Covington city,51580,Native Hawaiian and Other Pacific Islander ,0,0,0,17,17,17
2012,Danville city,51590,Native Hawaiian and Other Pacific Islander ,8,8,0,12,12,26
2012,Emporia city,51595,Native Hawaiian and Other Pacific Islander ,0,0,0,17,17,17
2012,Fairfax city,51600,Native Hawaiian and Other Pacific Islander ,22,0,22,30,23,30
2012,Falls Church city,51610,Native Hawaiian and Other Pacific Islander ,0,0,0,19,19,19
2012,Franklin city,51620,Native Hawaiian and Other Pacific Islander ,0,0,0,17,17,17
2012,Fredericksburg city,51630,Native Hawaiian and Other Pacific Islander ,3,3,0,5,5,23
2012,Galax city,51640,Native Hawaiian and Other Pacific Islander ,0,0,0,17,17,17
2012,Hampton city,51650,Native Hawaiian and Other Pacific Islander ,8,0,8,14,29,14
2012,Harrisonburg city,51660,Native Hawaiian and Other Pacific Islander ,0,0,0,29,29,29
2012,Hopewell city,51670,Native Hawaiian and Other Pacific Islander ,0,0,0,23,23,23
2012,Lexington city,51678,Native Hawaiian and Other Pacific Islander ,0,0,0,17,17,17
2012,Lynchburg city,51680,Native Hawaiian and Other Pacific Islander ,0,0,0,29,29,29
2012,Manassas city,51683,Native Hawaiian and Other Pacific Islander ,0,0,0,26,26,26
2012,Manassas Park city,51685,Native Hawaiian and Other Pacific Islander ,0,0,0,19,19,19
2012,Martinsville city,51690,Native Hawaiian and Other Pacific Islander ,0,0,0,19,19,19
2012,Newport News city,51700,Native Hawaiian and Other Pacific Islander ,59,50,9,31,22,21
2012,Norfolk city,51710,Native Hawaiian and Other Pacific Islander ,106,0,106,53,29,53
2012,Norton city,51720,Native Hawaiian and Other Pacific Islander ,0,0,0,12,12,12
2012,Petersburg city,51730,Native Hawaiian and Other Pacific Islander ,7,0,7,12,26,12
2012,Poquoson city,51735,Native Hawaiian and Other Pacific Islander ,0,0,0,19,19,19
2012,Portsmouth city,51740,Native Hawaiian and Other Pacific Islander ,0,0,0,29,29,29
2012,Radford city,51750,Native Hawaiian and Other Pacific Islander ,0,0,0,19,19,19
2012,Richmond city,51760,Native Hawaiian and Other Pacific Islander ,0,0,0,29,29,29
2012,Roanoke city,51770,Native Hawaiian and Other Pacific Islander ,0,0,0,29,29,29
2012,Salem city,51775,Native Hawaiian and Other Pacific Islander ,0,0,0,23,23,23
2012,Staunton city,51790,Native Hawaiian and Other Pacific Islander ,0,0,0,23,23,23
2012,Suffolk city,51800,Native Hawaiian and Other Pacific Islander ,0,0,0,29,29,29
2012,Virginia Beach city,51810,Native Hawaiian and Other Pacific Islander ,214,177,37,126,129,51
2012,Waynesboro city,51820,Native Hawaiian and Other Pacific Islander ,0,0,0,23,23,23
2012,Williamsburg city,51830,Native Hawaiian and Other Pacific Islander ,0,0,0,19,19,19
2012,Winchester city,51840,Native Hawaiian and Other Pacific Islander ,0,0,0,23,23,23
2013,Accomack County,51001,Native Hawaiian and Other Pacific Islander ,0,0,0,26,26,26
2013,Albemarle County,51003,Native Hawaiian and Other Pacific Islander ,14,14,0,22,22,29
2013,Alleghany County,51005,Native Hawaiian and Other Pacific Islander ,0,0,0,19,19,19
2013,Amelia County,51007,Native Hawaiian and Other Pacific Islander ,0,0,0,19,19,19
2013,Amherst County,51009,Native Hawaiian and Other Pacific Islander ,8,0,8,13,26,13
2013,Appomattox County,51011,Native Hawaiian and Other Pacific Islander ,0,0,0,19,19,19
2013,Arlington County,51013,Native Hawaiian and Other Pacific Islander ,59,27,32,38,28,25
2013,Augusta County,51015,Native Hawaiian and Other Pacific Islander ,4,4,0,6,6,29
2013,Bath County,51017,Native Hawaiian and Other Pacific Islander ,0,0,0,12,12,12
2013,Bedford County,51019,Native Hawaiian and Other Pacific Islander ,7,7,0,11,11,29
2013,Bland County,51021,Native Hawaiian and Other Pacific Islander ,8,8,0,16,16,17
2013,Botetourt County,51023,Native Hawaiian and Other Pacific Islander ,0,0,0,26,26,26
2013,Brunswick County,51025,Native Hawaiian and Other Pacific Islander ,0,0,0,19,19,19
2013,Buchanan County,51027,Native Hawaiian and Other Pacific Islander ,0,0,0,23,23,23
2013,Buckingham County,51029,Native Hawaiian and Other Pacific Islander ,0,0,0,19,19,19
2013,Campbell County,51031,Native Hawaiian and Other Pacific Islander ,8,8,0,12,12,29
2013,Caroline County,51033,Native Hawaiian and Other Pacific Islander ,0,0,0,23,23,23
2013,Carroll County,51035,Native Hawaiian and Other Pacific Islander ,0,0,0,23,23,23
2013,Charles City County,51036,Native Hawaiian and Other Pacific Islander ,2,0,2,4,17,4
2013,Charlotte County,51037,Native Hawaiian and Other Pacific Islander ,0,0,0,19,19,19
2013,Chesterfield County,51041,Native Hawaiian and Other Pacific Islander ,18,17,1,18,19,3
2013,Clarke County,51043,Native Hawaiian and Other Pacific Islander ,0,0,0,19,19,19
2013,Craig County,51045,Native Hawaiian and Other Pacific Islander ,0,0,0,17,17,17
2013,Culpeper County,51047,Native Hawaiian and Other Pacific Islander ,0,0,0,26,26,26
2013,Cumberland County,51049,Native Hawaiian and Other Pacific Islander ,0,0,0,17,17,17
2013,Dickenson County,51051,Native Hawaiian and Other Pacific Islander ,0,0,0,19,19,19
2013,Dinwiddie County,51053,Native Hawaiian and Other Pacific Islander ,0,0,0,23,23,23
2013,Essex County,51057,Native Hawaiian and Other Pacific Islander ,13,0,13,26,19,26
2013,Fairfax County,51059,Native Hawaiian and Other Pacific Islander ,389,301,88,86,82,60
2013,Fauquier County,51061,Native Hawaiian and Other Pacific Islander ,19,19,0,23,23,29
2013,Floyd County,51063,Native Hawaiian and Other Pacific Islander ,0,0,0,19,19,19
2013,Fluvanna County,51065,Native Hawaiian and Other Pacific Islander ,0,0,0,23,23,23
2013,Franklin County,51067,Native Hawaiian and Other Pacific Islander ,0,0,0,29,29,29
2013,Frederick County,51069,Native Hawaiian and Other Pacific Islander ,0,0,0,29,29,29
2013,Giles County,51071,Native Hawaiian and Other Pacific Islander ,6,0,6,10,19,10
2013,Gloucester County,51073,Native Hawaiian and Other Pacific Islander ,0,0,0,26,26,26
2013,Goochland County,51075,Native Hawaiian and Other Pacific Islander ,0,0,0,23,23,23
2013,Grayson County,51077,Native Hawaiian and Other Pacific Islander ,0,0,0,19,19,19
2013,Greene County,51079,Native Hawaiian and Other Pacific Islander ,0,0,0,19,19,19
2013,Greensville County,51081,Native Hawaiian and Other Pacific Islander ,0,0,0,19,19,19
2013,Halifax County,51083,Native Hawaiian and Other Pacific Islander ,8,8,0,12,12,26
2013,Hanover County,51085,Native Hawaiian and Other Pacific Islander ,0,0,0,29,29,29
2013,Henrico County,51087,Native Hawaiian and Other Pacific Islander ,30,30,0,41,41,29
2013,Henry County,51089,Native Hawaiian and Other Pacific Islander ,0,0,0,29,29,29
2013,Highland County,51091,Native Hawaiian and Other Pacific Islander ,0,0,0,12,12,12
2013,Isle of Wight County,51093,Native Hawaiian and Other Pacific Islander ,0,0,0,26,26,26
2013,James City County,51095,Native Hawaiian and Other Pacific Islander ,24,24,0,35,35,29
2013,King and Queen County,51097,Native Hawaiian and Other Pacific Islander ,0,0,0,17,17,17
2013,King George County,51099,Native Hawaiian and Other Pacific Islander ,3,3,0,6,6,23
2013,King William County,51101,Native Hawaiian and Other Pacific Islander ,0,0,0,19,19,19
2013,Lancaster County,51103,Native Hawaiian and Other Pacific Islander ,0,0,0,19,19,19
2013,Lee County,51105,Native Hawaiian and Other Pacific Islander ,0,0,0,23,23,23
2013,Loudoun County,51107,Native Hawaiian and Other Pacific Islander ,65,34,31,39,26,40
2013,Louisa County,51109,Native Hawaiian and Other Pacific Islander ,0,0,0,26,26,26
2013,Lunenburg County,51111,Native Hawaiian and Other Pacific Islander ,4,4,0,7,7,19
2013,Madison County,51113,Native Hawaiian and Other Pacific Islander ,0,0,0,19,19,19
2013,Mathews County,51115,Native Hawaiian and Other Pacific Islander ,0,0,0,17,17,17
2013,Mecklenburg County,51117,Native Hawaiian and Other Pacific Islander ,0,0,0,26,26,26
2013,Middlesex County,51119,Native Hawaiian and Other Pacific Islander ,0,0,0,19,19,19
2013,Montgomery County,51121,Native Hawaiian and Other Pacific Islander ,17,0,17,27,29,27
2013,Nelson County,51125,Native Hawaiian and Other Pacific Islander ,0,0,0,19,19,19
2013,New Kent County,51127,Native Hawaiian and Other Pacific Islander ,0,0,0,19,19,19
2013,Northampton County,51131,Native Hawaiian and Other Pacific Islander ,0,0,0,19,19,19
2013,Northumberland County,51133,Native Hawaiian and Other Pacific Islander ,0,0,0,19,19,19
2013,Nottoway County,51135,Native Hawaiian and Other Pacific Islander ,0,0,0,19,19,19
2013,Orange County,51137,Native Hawaiian and Other Pacific Islander ,0,0,0,26,26,26
2013,Page County,51139,Native Hawaiian and Other Pacific Islander ,0,0,0,23,23,23
2013,Patrick County,51141,Native Hawaiian and Other Pacific Islander ,0,0,0,19,19,19
2013,Pittsylvania County,51143,Native Hawaiian and Other Pacific Islander ,0,0,0,29,29,29
2013,Powhatan County,51145,Native Hawaiian and Other Pacific Islander ,0,0,0,23,23,23
2013,Prince Edward County,51147,Native Hawaiian and Other Pacific Islander ,0,0,0,23,23,23
2013,Prince George County,51149,Native Hawaiian and Other Pacific Islander ,32,17,15,18,24,9
2013,Prince William County,51153,Native Hawaiian and Other Pacific Islander ,116,86,30,51,47,34
2013,Pulaski County,51155,Native Hawaiian and Other Pacific Islander ,0,0,0,26,26,26
2013,Rappahannock County,51157,Native Hawaiian and Other Pacific Islander ,0,0,0,17,17,17
2013,Richmond County,51159,Native Hawaiian and Other Pacific Islander ,0,0,0,17,17,17
2013,Roanoke County,51161,Native Hawaiian and Other Pacific Islander ,0,0,0,29,29,29
2013,Rockbridge County,51163,Native Hawaiian and Other Pacific Islander ,0,0,0,23,23,23
2013,Rockingham County,51165,Native Hawaiian and Other Pacific Islander ,0,0,0,29,29,29
2013,Russell County,51167,Native Hawaiian and Other Pacific Islander ,0,0,0,23,23,23
2013,Scott County,51169,Native Hawaiian and Other Pacific Islander ,0,0,0,23,23,23
2013,Shenandoah County,51171,Native Hawaiian and Other Pacific Islander ,0,0,0,26,26,26
2013,Smyth County,51173,Native Hawaiian and Other Pacific Islander ,0,0,0,26,26,26
2013,Southampton County,51175,Native Hawaiian and Other Pacific Islander ,0,0,0,19,19,19
2013,Spotsylvania County,51177,Native Hawaiian and Other Pacific Islander ,62,7,55,60,16,59
2013,Stafford County,51179,Native Hawaiian and Other Pacific Islander ,22,14,8,26,22,12
2013,Surry County,51181,Native Hawaiian and Other Pacific Islander ,0,0,0,17,17,17
2013,Sussex County,51183,Native Hawaiian and Other Pacific Islander ,0,0,0,19,19,19
2013,Tazewell County,51185,Native Hawaiian and Other Pacific Islander ,0,0,0,26,26,26
2013,Warren County,51187,Native Hawaiian and Other Pacific Islander ,0,0,0,26,26,26
2013,Washington County,51191,Native Hawaiian and Other Pacific Islander ,0,0,0,29,29,29
2013,Westmoreland County,51193,Native Hawaiian and Other Pacific Islander ,0,0,0,19,19,19
2013,Wise County,51195,Native Hawaiian and Other Pacific Islander ,0,0,0,26,26,26
2013,Wythe County,51197,Native Hawaiian and Other Pacific Islander ,0,0,0,23,23,23
2013,York County,51199,Native Hawaiian and Other Pacific Islander ,53,53,0,53,53,29
2013,Alexandria city,51510,Native Hawaiian and Other Pacific Islander ,14,14,0,22,22,29
2013,Bedford County,51019,Native Hawaiian and Other Pacific Islander ,0,0,0,17,17,17
2013,Bristol city,51520,Native Hawaiian and Other Pacific Islander ,0,0,0,19,19,19
2013,Buena Vista city,51530,Native Hawaiian and Other Pacific Islander ,0,0,0,17,17,17
2013,Charlottesville city,51540,Native Hawaiian and Other Pacific Islander ,11,0,11,18,26,18
2013,Chesapeake city,51550,Native Hawaiian and Other Pacific Islander ,25,12,13,33,19,28
2013,Colonial Heights city,51570,Native Hawaiian and Other Pacific Islander ,0,0,0,19,19,19
2013,Covington city,51580,Native Hawaiian and Other Pacific Islander ,0,0,0,17,17,17
2013,Danville city,51590,Native Hawaiian and Other Pacific Islander ,10,10,0,16,16,26
2013,Emporia city,51595,Native Hawaiian and Other Pacific Islander ,0,0,0,17,17,17
2013,Fairfax city,51600,Native Hawaiian and Other Pacific Islander ,16,0,16,23,23,23
2013,Falls Church city,51610,Native Hawaiian and Other Pacific Islander ,0,0,0,19,19,19
2013,Franklin city,51620,Native Hawaiian and Other Pacific Islander ,0,0,0,17,17,17
2013,Fredericksburg city,51630,Native Hawaiian and Other Pacific Islander ,3,3,0,6,6,23
2013,Galax city,51640,Native Hawaiian and Other Pacific Islander ,0,0,0,17,17,17
2013,Hampton city,51650,Native Hawaiian and Other Pacific Islander ,6,0,6,10,29,10
2013,Harrisonburg city,51660,Native Hawaiian and Other Pacific Islander ,0,0,0,29,29,29
2013,Hopewell city,51670,Native Hawaiian and Other Pacific Islander ,0,0,0,23,23,23
2013,Lexington city,51678,Native Hawaiian and Other Pacific Islander ,0,0,0,17,17,17
2013,Lynchburg city,51680,Native Hawaiian and Other Pacific Islander ,0,0,0,29,29,29
2013,Manassas city,51683,Native Hawaiian and Other Pacific Islander ,0,0,0,26,26,26
2013,Manassas Park city,51685,Native Hawaiian and Other Pacific Islander ,0,0,0,19,19,19
2013,Martinsville city,51690,Native Hawaiian and Other Pacific Islander ,0,0,0,19,19,19
2013,Newport News city,51700,Native Hawaiian and Other Pacific Islander ,75,51,24,24,24,25
2013,Norfolk city,51710,Native Hawaiian and Other Pacific Islander ,104,0,104,51,29,51
2013,Norton city,51720,Native Hawaiian and Other Pacific Islander ,0,0,0,12,12,12
2013,Petersburg city,51730,Native Hawaiian and Other Pacific Islander ,10,0,10,19,26,19
2013,Poquoson city,51735,Native Hawaiian and Other Pacific Islander ,0,0,0,19,19,19
2013,Portsmouth city,51740,Native Hawaiian and Other Pacific Islander ,0,0,0,29,29,29
2013,Radford city,51750,Native Hawaiian and Other Pacific Islander ,0,0,0,19,19,19
2013,Richmond city,51760,Native Hawaiian and Other Pacific Islander ,0,0,0,29,29,29
2013,Roanoke city,51770,Native Hawaiian and Other Pacific Islander ,62,0,62,95,29,95
2013,Salem city,51775,Native Hawaiian and Other Pacific Islander ,0,0,0,23,23,23
2013,Staunton city,51790,Native Hawaiian and Other Pacific Islander ,0,0,0,23,23,23
2013,Suffolk city,51800,Native Hawaiian and Other Pacific Islander ,11,11,0,18,18,29
2013,Virginia Beach city,51810,Native Hawaiian and Other Pacific Islander ,218,179,39,72,65,47
2013,Waynesboro city,51820,Native Hawaiian and Other Pacific Islander ,0,0,0,23,23,23
2013,Williamsburg city,51830,Native Hawaiian and Other Pacific Islander ,0,0,0,19,19,19
2013,Winchester city,51840,Native Hawaiian and Other Pacific Islander ,0,0,0,23,23,23
2014,Accomack County,51001,Native Hawaiian and Other Pacific Islander ,0,0,0,25,25,25
2014,Albemarle County,51003,Native Hawaiian and Other Pacific Islander ,13,13,0,22,22,28
2014,Alleghany County,51005,Native Hawaiian and Other Pacific Islander ,0,0,0,19,19,19
2014,Amelia County,51007,Native Hawaiian and Other Pacific Islander ,0,0,0,19,19,19
2014,Amherst County,51009,Native Hawaiian and Other Pacific Islander ,9,0,9,15,25,15
2014,Appomattox County,51011,Native Hawaiian and Other Pacific Islander ,0,0,0,19,19,19
2014,Arlington County,51013,Native Hawaiian and Other Pacific Islander ,69,27,42,40,21,30
2014,Augusta County,51015,Native Hawaiian and Other Pacific Islander ,3,3,0,6,6,28
2014,Bath County,51017,Native Hawaiian and Other Pacific Islander ,0,0,0,12,12,12
2014,Bedford County,51019,Native Hawaiian and Other Pacific Islander ,7,7,0,12,12,28
2014,Bland County,51021,Native Hawaiian and Other Pacific Islander ,2,2,0,13,13,17
2014,Botetourt County,51023,Native Hawaiian and Other Pacific Islander ,0,0,0,25,25,25
2014,Brunswick County,51025,Native Hawaiian and Other Pacific Islander ,0,0,0,19,19,19
2014,Buchanan County,51027,Native Hawaiian and Other Pacific Islander ,0,0,0,22,22,22
2014,Buckingham County,51029,Native Hawaiian and Other Pacific Islander ,0,0,0,19,19,19
2014,Campbell County,51031,Native Hawaiian and Other Pacific Islander ,10,10,0,16,16,28
2014,Caroline County,51033,Native Hawaiian and Other Pacific Islander ,0,0,0,22,22,22
2014,Carroll County,51035,Native Hawaiian and Other Pacific Islander ,0,0,0,22,22,22
2014,Charles City County,51036,Native Hawaiian and Other Pacific Islander ,1,0,1,3,17,3
2014,Charlotte County,51037,Native Hawaiian and Other Pacific Islander ,0,0,0,19,19,19
2014,Chesterfield County,51041,Native Hawaiian and Other Pacific Islander ,21,19,2,24,25,4
2014,Clarke County,51043,Native Hawaiian and Other Pacific Islander ,0,0,0,19,19,19
2014,Craig County,51045,Native Hawaiian and Other Pacific Islander ,0,0,0,17,17,17
2014,Culpeper County,51047,Native Hawaiian and Other Pacific Islander ,0,0,0,25,25,25
2014,Cumberland County,51049,Native Hawaiian and Other Pacific Islander ,0,0,0,17,17,17
2014,Dickenson County,51051,Native Hawaiian and Other Pacific Islander ,0,0,0,19,19,19
2014,Dinwiddie County,51053,Native Hawaiian and Other Pacific Islander ,0,0,0,22,22,22
2014,Essex County,51057,Native Hawaiian and Other Pacific Islander ,0,0,0,19,19,19
2014,Fairfax County,51059,Native Hawaiian and Other Pacific Islander ,316,270,46,88,81,33
2014,Fauquier County,51061,Native Hawaiian and Other Pacific Islander ,39,39,0,44,44,28
2014,Floyd County,51063,Native Hawaiian and Other Pacific Islander ,0,0,0,19,19,19
2014,Fluvanna County,51065,Native Hawaiian and Other Pacific Islander ,0,0,0,22,22,22
2014,Franklin County,51067,Native Hawaiian and Other Pacific Islander ,0,0,0,28,28,28
2014,Frederick County,51069,Native Hawaiian and Other Pacific Islander ,0,0,0,28,28,28
2014,Giles County,51071,Native Hawaiian and Other Pacific Islander ,15,0,15,24,19,24
2014,Gloucester County,51073,Native Hawaiian and Other Pacific Islander ,0,0,0,25,25,25
2014,Goochland County,51075,Native Hawaiian and Other Pacific Islander ,0,0,0,22,22,22
2014,Grayson County,51077,Native Hawaiian and Other Pacific Islander ,0,0,0,19,19,19
2014,Greene County,51079,Native Hawaiian and Other Pacific Islander ,0,0,0,19,19,19
2014,Greensville County,51081,Native Hawaiian and Other Pacific Islander ,0,0,0,19,19,19
2014,Halifax County,51083,Native Hawaiian and Other Pacific Islander ,9,9,0,14,14,25
2014,Hanover County,51085,Native Hawaiian and Other Pacific Islander ,0,0,0,28,28,28
2014,Henrico County,51087,Native Hawaiian and Other Pacific Islander ,53,42,11,53,49,18
2014,Henry County,51089,Native Hawaiian and Other Pacific Islander ,0,0,0,28,28,28
2014,Highland County,51091,Native Hawaiian and Other Pacific Islander ,0,0,0,12,12,12
2014,Isle of Wight County,51093,Native Hawaiian and Other Pacific Islander ,0,0,0,25,25,25
2014,James City County,51095,Native Hawaiian and Other Pacific Islander ,14,14,0,23,23,28
2014,King and Queen County,51097,Native Hawaiian and Other Pacific Islander ,0,0,0,17,17,17
2014,King George County,51099,Native Hawaiian and Other Pacific Islander ,5,5,0,8,8,22
2014,King William County,51101,Native Hawaiian and Other Pacific Islander ,0,0,0,19,19,19
2014,Lancaster County,51103,Native Hawaiian and Other Pacific Islander ,0,0,0,19,19,19
2014,Lee County,51105,Native Hawaiian and Other Pacific Islander ,0,0,0,22,22,22
2014,Loudoun County,51107,Native Hawaiian and Other Pacific Islander ,98,60,38,23,35,33
2014,Louisa County,51109,Native Hawaiian and Other Pacific Islander ,0,0,0,25,25,25
2014,Lunenburg County,51111,Native Hawaiian and Other Pacific Islander ,4,4,0,6,6,19
2014,Madison County,51113,Native Hawaiian and Other Pacific Islander ,0,0,0,19,19,19
2014,Mathews County,51115,Native Hawaiian and Other Pacific Islander ,0,0,0,17,17,17
2014,Mecklenburg County,51117,Native Hawaiian and Other Pacific Islander ,0,0,0,25,25,25
2014,Middlesex County,51119,Native Hawaiian and Other Pacific Islander ,0,0,0,19,19,19
2014,Montgomery County,51121,Native Hawaiian and Other Pacific Islander ,23,0,23,35,28,35
2014,Nelson County,51125,Native Hawaiian and Other Pacific Islander ,0,0,0,19,19,19
2014,New Kent County,51127,Native Hawaiian and Other Pacific Islander ,0,0,0,22,19,19
2014,Northampton County,51131,Native Hawaiian and Other Pacific Islander ,0,0,0,19,19,19
2014,Northumberland County,51133,Native Hawaiian and Other Pacific Islander ,0,0,0,19,19,19
2014,Nottoway County,51135,Native Hawaiian and Other Pacific Islander ,0,0,0,19,19,19
2014,Orange County,51137,Native Hawaiian and Other Pacific Islander ,0,0,0,25,25,25
2014,Page County,51139,Native Hawaiian and Other Pacific Islander ,0,0,0,22,22,22
2014,Patrick County,51141,Native Hawaiian and Other Pacific Islander ,0,0,0,19,19,19
2014,Pittsylvania County,51143,Native Hawaiian and Other Pacific Islander ,0,0,0,28,28,28
2014,Powhatan County,51145,Native Hawaiian and Other Pacific Islander ,0,0,0,22,22,22
2014,Prince Edward County,51147,Native Hawaiian and Other Pacific Islander ,0,0,0,22,22,22
2014,Prince George County,51149,Native Hawaiian and Other Pacific Islander ,44,31,13,47,44,15
2014,Prince William County,51153,Native Hawaiian and Other Pacific Islander ,130,97,33,65,56,34
2014,Pulaski County,51155,Native Hawaiian and Other Pacific Islander ,0,0,0,25,25,25
2014,Rappahannock County,51157,Native Hawaiian and Other Pacific Islander ,0,0,0,17,17,17
2014,Richmond County,51159,Native Hawaiian and Other Pacific Islander ,0,0,0,17,17,17
2014,Roanoke County,51161,Native Hawaiian and Other Pacific Islander ,0,0,0,28,28,28
2014,Rockbridge County,51163,Native Hawaiian and Other Pacific Islander ,0,0,0,22,22,22
2014,Rockingham County,51165,Native Hawaiian and Other Pacific Islander ,0,0,0,28,28,28
2014,Russell County,51167,Native Hawaiian and Other Pacific Islander ,0,0,0,22,22,22
2014,Scott County,51169,Native Hawaiian and Other Pacific Islander ,0,0,0,22,22,22
2014,Shenandoah County,51171,Native Hawaiian and Other Pacific Islander ,0,0,0,25,25,25
2014,Smyth County,51173,Native Hawaiian and Other Pacific Islander ,0,0,0,25,25,25
2014,Southampton County,51175,Native Hawaiian and Other Pacific Islander ,0,0,0,19,19,19
2014,Spotsylvania County,51177,Native Hawaiian and Other Pacific Islander ,63,8,55,62,17,61
2014,Stafford County,51179,Native Hawaiian and Other Pacific Islander ,21,6,15,23,11,23
2014,Surry County,51181,Native Hawaiian and Other Pacific Islander ,0,0,0,17,17,17
2014,Sussex County,51183,Native Hawaiian and Other Pacific Islander ,0,0,0,19,19,19
2014,Tazewell County,51185,Native Hawaiian and Other Pacific Islander ,0,0,0,25,25,25
2014,Warren County,51187,Native Hawaiian and Other Pacific Islander ,0,0,0,25,25,25
2014,Washington County,51191,Native Hawaiian and Other Pacific Islander ,0,0,0,28,28,28
2014,Westmoreland County,51193,Native Hawaiian and Other Pacific Islander ,0,0,0,19,19,19
2014,Wise County,51195,Native Hawaiian and Other Pacific Islander ,0,0,0,25,25,25
2014,Wythe County,51197,Native Hawaiian and Other Pacific Islander ,0,0,0,22,22,22
2014,York County,51199,Native Hawaiian and Other Pacific Islander ,29,29,0,39,39,28
2014,Alexandria city,51510,Native Hawaiian and Other Pacific Islander ,24,0,24,36,28,36
2014,Bristol city,51520,Native Hawaiian and Other Pacific Islander ,0,0,0,19,19,19
2014,Buena Vista city,51530,Native Hawaiian and Other Pacific Islander ,0,0,0,17,17,17
2014,Charlottesville city,51540,Native Hawaiian and Other Pacific Islander ,18,0,18,26,25,26
2014,Chesapeake city,51550,Native Hawaiian and Other Pacific Islander ,52,24,28,45,35,28
2014,Colonial Heights city,51570,Native Hawaiian and Other Pacific Islander ,0,0,0,19,19,19
2014,Covington city,51580,Native Hawaiian and Other Pacific Islander ,0,0,0,17,17,17
2014,Danville city,51590,Native Hawaiian and Other Pacific Islander ,14,14,0,21,21,25
2014,Emporia city,51595,Native Hawaiian and Other Pacific Islander ,0,0,0,17,17,17
2014,Fairfax city,51600,Native Hawaiian and Other Pacific Islander ,0,0,0,22,22,22
2014,Falls Church city,51610,Native Hawaiian and Other Pacific Islander ,0,0,0,19,19,19
2014,Franklin city,51620,Native Hawaiian and Other Pacific Islander ,0,0,0,17,17,17
2014,Fredericksburg city,51630,Native Hawaiian and Other Pacific Islander ,11,5,6,14,9,10
2014,Galax city,51640,Native Hawaiian and Other Pacific Islander ,0,0,0,17,17,17
2014,Hampton city,51650,Native Hawaiian and Other Pacific Islander ,6,0,6,10,28,10
2014,Harrisonburg city,51660,Native Hawaiian and Other Pacific Islander ,0,0,0,28,28,28
2014,Hopewell city,51670,Native Hawaiian and Other Pacific Islander ,0,0,0,22,22,22
2014,Lexington city,51678,Native Hawaiian and Other Pacific Islander ,0,0,0,17,17,17
2014,Lynchburg city,51680,Native Hawaiian and Other Pacific Islander ,0,0,0,28,28,28
2014,Manassas city,51683,Native Hawaiian and Other Pacific Islander ,0,0,0,25,25,25
2014,Manassas Park city,51685,Native Hawaiian and Other Pacific Islander ,0,0,0,19,19,19
2014,Martinsville city,51690,Native Hawaiian and Other Pacific Islander ,0,0,0,19,19,19
2014,Newport News city,51700,Native Hawaiian and Other Pacific Islander ,66,30,36,93,44,57
2014,Norfolk city,51710,Native Hawaiian and Other Pacific Islander ,122,0,122,65,28,65
2014,Norton city,51720,Native Hawaiian and Other Pacific Islander ,0,0,0,12,12,12
2014,Petersburg city,51730,Native Hawaiian and Other Pacific Islander ,12,0,12,16,25,16
2014,Poquoson city,51735,Native Hawaiian and Other Pacific Islander ,0,0,0,19,19,19
2014,Portsmouth city,51740,Native Hawaiian and Other Pacific Islander ,10,0,10,17,28,17
2014,Radford city,51750,Native Hawaiian and Other Pacific Islander ,0,0,0,19,19,19
2014,Richmond city,51760,Native Hawaiian and Other Pacific Islander ,0,0,0,28,28,28
2014,Roanoke city,51770,Native Hawaiian and Other Pacific Islander ,64,0,64,87,28,87
2014,Salem city,51775,Native Hawaiian and Other Pacific Islander ,0,0,0,22,22,22
2014,Staunton city,51790,Native Hawaiian and Other Pacific Islander ,0,0,0,22,22,22
2014,Suffolk city,51800,Native Hawaiian and Other Pacific Islander ,16,16,0,25,25,28
2014,Virginia Beach city,51810,Native Hawaiian and Other Pacific Islander ,179,133,46,89,79,37
2014,Waynesboro city,51820,Native Hawaiian and Other Pacific Islander ,0,0,0,22,22,22
2014,Williamsburg city,51830,Native Hawaiian and Other Pacific Islander ,0,0,0,19,19,19
2014,Winchester city,51840,Native Hawaiian and Other Pacific Islander ,0,0,0,22,22,22
2015,Accomack County,51001,Native Hawaiian and Other Pacific Islander ,0,0,0,25,25,25
2015,Albemarle County,51003,Native Hawaiian and Other Pacific Islander ,8,8,0,15,15,28
2015,Alleghany County,51005,Native Hawaiian and Other Pacific Islander ,0,0,0,19,19,19
2015,Amelia County,51007,Native Hawaiian and Other Pacific Islander ,0,0,0,19,19,19
2015,Amherst County,51009,Native Hawaiian and Other Pacific Islander ,7,0,7,11,25,11
2015,Appomattox County,51011,Native Hawaiian and Other Pacific Islander ,0,0,0,19,19,19
2015,Arlington County,51013,Native Hawaiian and Other Pacific Islander ,66,22,44,37,22,29
2015,Augusta County,51015,Native Hawaiian and Other Pacific Islander ,28,6,22,44,11,42
2015,Bath County,51017,Native Hawaiian and Other Pacific Islander ,0,0,0,12,12,12
2015,Bedford County,51019,Native Hawaiian and Other Pacific Islander ,7,7,0,12,12,28
2015,Bland County,51021,Native Hawaiian and Other Pacific Islander ,7,7,0,11,11,17
2015,Botetourt County,51023,Native Hawaiian and Other Pacific Islander ,0,0,0,25,25,25
2015,Brunswick County,51025,Native Hawaiian and Other Pacific Islander ,0,0,0,19,19,19
2015,Buchanan County,51027,Native Hawaiian and Other Pacific Islander ,0,0,0,22,22,22
2015,Buckingham County,51029,Native Hawaiian and Other Pacific Islander ,0,0,0,19,19,19
2015,Campbell County,51031,Native Hawaiian and Other Pacific Islander ,10,10,0,16,16,28
2015,Caroline County,51033,Native Hawaiian and Other Pacific Islander ,0,0,0,22,22,22
2015,Carroll County,51035,Native Hawaiian and Other Pacific Islander ,0,0,0,22,22,22
2015,Charles City County,51036,Native Hawaiian and Other Pacific Islander ,2,0,2,3,17,3
2015,Charlotte County,51037,Native Hawaiian and Other Pacific Islander ,0,0,0,19,19,19
2015,Chesterfield County,51041,Native Hawaiian and Other Pacific Islander ,33,29,4,34,36,7
2015,Clarke County,51043,Native Hawaiian and Other Pacific Islander ,0,0,0,19,19,19
2015,Craig County,51045,Native Hawaiian and Other Pacific Islander ,0,0,0,17,17,17
2015,Culpeper County,51047,Native Hawaiian and Other Pacific Islander ,0,0,0,25,25,25
2015,Cumberland County,51049,Native Hawaiian and Other Pacific Islander ,0,0,0,17,17,17
2015,Dickenson County,51051,Native Hawaiian and Other Pacific Islander ,0,0,0,19,19,19
2015,Dinwiddie County,51053,Native Hawaiian and Other Pacific Islander ,0,0,0,22,22,22
2015,Essex County,51057,Native Hawaiian and Other Pacific Islander ,0,0,0,19,19,19
2015,Fairfax County,51059,Native Hawaiian and Other Pacific Islander ,247,196,51,73,64,38
2015,Fauquier County,51061,Native Hawaiian and Other Pacific Islander ,19,19,0,23,23,28
2015,Floyd County,51063,Native Hawaiian and Other Pacific Islander ,0,0,0,19,19,19
2015,Fluvanna County,51065,Native Hawaiian and Other Pacific Islander ,0,0,0,22,22,22
2015,Franklin County,51067,Native Hawaiian and Other Pacific Islander ,0,0,0,28,28,28
2015,Frederick County,51069,Native Hawaiian and Other Pacific Islander ,15,15,0,25,25,28
2015,Giles County,51071,Native Hawaiian and Other Pacific Islander ,9,0,9,16,19,16
2015,Gloucester County,51073,Native Hawaiian and Other Pacific Islander ,0,0,0,25,25,25
2015,Goochland County,51075,Native Hawaiian and Other Pacific Islander ,0,0,0,22,22,22
2015,Grayson County,51077,Native Hawaiian and Other Pacific Islander ,0,0,0,19,19,19
2015,Greene County,51079,Native Hawaiian and Other Pacific Islander ,0,0,0,19,19,19
2015,Greensville County,51081,Native Hawaiian and Other Pacific Islander ,0,0,0,19,19,19
2015,Halifax County,51083,Native Hawaiian and Other Pacific Islander ,6,6,0,10,10,25
2015,Hanover County,51085,Native Hawaiian and Other Pacific Islander ,0,0,0,28,28,28
2015,Henrico County,51087,Native Hawaiian and Other Pacific Islander ,63,46,17,50,38,29
2015,Henry County,51089,Native Hawaiian and Other Pacific Islander ,0,0,0,28,28,28
2015,Highland County,51091,Native Hawaiian and Other Pacific Islander ,0,0,0,12,12,12
2015,Isle of Wight County,51093,Native Hawaiian and Other Pacific Islander ,0,0,0,25,25,25
2015,James City County,51095,Native Hawaiian and Other Pacific Islander ,0,0,0,28,28,28
2015,King and Queen County,51097,Native Hawaiian and Other Pacific Islander ,0,0,0,17,17,17
2015,King George County,51099,Native Hawaiian and Other Pacific Islander ,7,7,0,12,12,22
2015,King William County,51101,Native Hawaiian and Other Pacific Islander ,0,0,0,19,19,19
2015,Lancaster County,51103,Native Hawaiian and Other Pacific Islander ,0,0,0,19,19,19
2015,Lee County,51105,Native Hawaiian and Other Pacific Islander ,0,0,0,22,22,22
2015,Loudoun County,51107,Native Hawaiian and Other Pacific Islander ,113,100,13,36,42,28
2015,Louisa County,51109,Native Hawaiian and Other Pacific Islander ,0,0,0,25,25,25
2015,Lunenburg County,51111,Native Hawaiian and Other Pacific Islander ,0,0,0,19,19,19
2015,Madison County,51113,Native Hawaiian and Other Pacific Islander ,0,0,0,19,19,19
2015,Mathews County,51115,Native Hawaiian and Other Pacific Islander ,0,0,0,17,17,17
2015,Mecklenburg County,51117,Native Hawaiian and Other Pacific Islander ,0,0,0,25,25,25
2015,Middlesex County,51119,Native Hawaiian and Other Pacific Islander ,0,0,0,19,19,19
2015,Montgomery County,51121,Native Hawaiian and Other Pacific Islander ,45,0,45,64,28,64
2015,Nelson County,51125,Native Hawaiian and Other Pacific Islander ,0,0,0,19,19,19
2015,New Kent County,51127,Native Hawaiian and Other Pacific Islander ,0,0,0,22,22,22
2015,Northampton County,51131,Native Hawaiian and Other Pacific Islander ,0,0,0,19,19,19
2015,Northumberland County,51133,Native Hawaiian and Other Pacific Islander ,0,0,0,19,19,19
2015,Nottoway County,51135,Native Hawaiian and Other Pacific Islander ,0,0,0,19,19,19
2015,Orange County,51137,Native Hawaiian and Other Pacific Islander ,0,0,0,25,25,25
2015,Page County,51139,Native Hawaiian and Other Pacific Islander ,0,0,0,22,22,22
2015,Patrick County,51141,Native Hawaiian and Other Pacific Islander ,0,0,0,19,19,19
2015,Pittsylvania County,51143,Native Hawaiian and Other Pacific Islander ,0,0,0,28,28,28
2015,Powhatan County,51145,Native Hawaiian and Other Pacific Islander ,0,0,0,22,22,22
2015,Prince Edward County,51147,Native Hawaiian and Other Pacific Islander ,0,0,0,22,22,22
2015,Prince George County,51149,Native Hawaiian and Other Pacific Islander ,52,35,17,26,34,21
2015,Prince William County,51153,Native Hawaiian and Other Pacific Islander ,163,134,29,60,54,30
2015,Pulaski County,51155,Native Hawaiian and Other Pacific Islander ,0,0,0,25,25,25
2015,Rappahannock County,51157,Native Hawaiian and Other Pacific Islander ,0,0,0,17,17,17
2015,Richmond County,51159,Native Hawaiian and Other Pacific Islander ,0,0,0,17,17,17
2015,Roanoke County,51161,Native Hawaiian and Other Pacific Islander ,0,0,0,28,28,28
2015,Rockbridge County,51163,Native Hawaiian and Other Pacific Islander ,0,0,0,22,22,22
2015,Rockingham County,51165,Native Hawaiian and Other Pacific Islander ,0,0,0,28,28,28
2015,Russell County,51167,Native Hawaiian and Other Pacific Islander ,0,0,0,22,22,22
2015,Scott County,51169,Native Hawaiian and Other Pacific Islander ,0,0,0,22,22,22
2015,Shenandoah County,51171,Native Hawaiian and Other Pacific Islander ,0,0,0,25,25,25
2015,Smyth County,51173,Native Hawaiian and Other Pacific Islander ,0,0,0,25,25,25
2015,Southampton County,51175,Native Hawaiian and Other Pacific Islander ,0,0,0,19,19,19
2015,Spotsylvania County,51177,Native Hawaiian and Other Pacific Islander ,44,29,15,24,34,13
2015,Stafford County,51179,Native Hawaiian and Other Pacific Islander ,33,7,26,34,11,32
2015,Surry County,51181,Native Hawaiian and Other Pacific Islander ,0,0,0,17,17,17
2015,Sussex County,51183,Native Hawaiian and Other Pacific Islander ,0,0,0,19,19,19
2015,Tazewell County,51185,Native Hawaiian and Other Pacific Islander ,0,0,0,25,25,25
2015,Warren County,51187,Native Hawaiian and Other Pacific Islander ,0,0,0,25,25,25
2015,Washington County,51191,Native Hawaiian and Other Pacific Islander ,0,0,0,28,28,28
2015,Westmoreland County,51193,Native Hawaiian and Other Pacific Islander ,0,0,0,19,19,19
2015,Wise County,51195,Native Hawaiian and Other Pacific Islander ,0,0,0,25,25,25
2015,Wythe County,51197,Native Hawaiian and Other Pacific Islander ,0,0,0,22,22,22
2015,York County,51199,Native Hawaiian and Other Pacific Islander ,48,37,11,34,31,22
2015,Alexandria city,51510,Native Hawaiian and Other Pacific Islander ,26,0,26,42,28,42
2015,Bristol city,51520,Native Hawaiian and Other Pacific Islander ,0,0,0,19,19,19
2015,Buena Vista city,51530,Native Hawaiian and Other Pacific Islander ,0,0,0,17,17,17
2015,Charlottesville city,51540,Native Hawaiian and Other Pacific Islander ,19,0,19,27,25,27
2015,Chesapeake city,51550,Native Hawaiian and Other Pacific Islander ,65,31,34,59,38,46
2015,Colonial Heights city,51570,Native Hawaiian and Other Pacific Islander ,0,0,0,19,19,19
2015,Covington city,51580,Native Hawaiian and Other Pacific Islander ,0,0,0,17,17,17
2015,Danville city,51590,Native Hawaiian and Other Pacific Islander ,0,0,0,25,25,25
2015,Emporia city,51595,Native Hawaiian and Other Pacific Islander ,0,0,0,17,17,17
2015,Fairfax city,51600,Native Hawaiian and Other Pacific Islander ,0,0,0,22,22,22
2015,Falls Church city,51610,Native Hawaiian and Other Pacific Islander ,0,0,0,19,19,19
2015,Franklin city,51620,Native Hawaiian and Other Pacific Islander ,0,0,0,17,17,17
2015,Fredericksburg city,51630,Native Hawaiian and Other Pacific Islander ,18,9,9,20,16,14
2015,Galax city,51640,Native Hawaiian and Other Pacific Islander ,0,0,0,17,17,17
2015,Hampton city,51650,Native Hawaiian and Other Pacific Islander ,14,6,8,17,12,12
2015,Harrisonburg city,51660,Native Hawaiian and Other Pacific Islander ,0,0,0,28,28,28
2015,Hopewell city,51670,Native Hawaiian and Other Pacific Islander ,0,0,0,22,22,22
2015,Lexington city,51678,Native Hawaiian and Other Pacific Islander ,0,0,0,17,17,17
2015,Lynchburg city,51680,Native Hawaiian and Other Pacific Islander ,0,0,0,28,28,28
2015,Manassas city,51683,Native Hawaiian and Other Pacific Islander ,9,0,9,16,25,16
2015,Manassas Park city,51685,Native Hawaiian and Other Pacific Islander ,0,0,0,19,19,19
2015,Martinsville city,51690,Native Hawaiian and Other Pacific Islander ,0,0,0,19,19,19
2015,Newport News city,51700,Native Hawaiian and Other Pacific Islander ,122,51,71,45,40,45
2015,Norfolk city,51710,Native Hawaiian and Other Pacific Islander ,165,58,107,123,106,55
2015,Norton city,51720,Native Hawaiian and Other Pacific Islander ,0,0,0,12,12,12
2015,Petersburg city,51730,Native Hawaiian and Other Pacific Islander ,0,0,0,25,25,25
2015,Poquoson city,51735,Native Hawaiian and Other Pacific Islander ,0,0,0,19,19,19
2015,Portsmouth city,51740,Native Hawaiian and Other Pacific Islander ,11,0,11,18,28,18
2015,Radford city,51750,Native Hawaiian and Other Pacific Islander ,0,0,0,19,19,19
2015,Richmond city,51760,Native Hawaiian and Other Pacific Islander ,5,0,5,8,28,8
2015,Roanoke city,51770,Native Hawaiian and Other Pacific Islander ,51,0,51,77,28,77
2015,Salem city,51775,Native Hawaiian and Other Pacific Islander ,0,0,0,22,22,22
2015,Staunton city,51790,Native Hawaiian and Other Pacific Islander ,0,0,0,22,22,22
2015,Suffolk city,51800,Native Hawaiian and Other Pacific Islander ,13,13,0,20,20,28
2015,Virginia Beach city,51810,Native Hawaiian and Other Pacific Islander ,177,133,44,76,79,38
2015,Waynesboro city,51820,Native Hawaiian and Other Pacific Islander ,0,0,0,22,22,22
2015,Williamsburg city,51830,Native Hawaiian and Other Pacific Islander ,0,0,0,19,19,19
2015,Winchester city,51840,Native Hawaiian and Other Pacific Islander ,0,0,0,22,22,22
2016,Accomack County,51001,Native Hawaiian and Other Pacific Islander ,0,0,0,25,25,25
2016,Albemarle County,51003,Native Hawaiian and Other Pacific Islander ,25,7,18,32,11,29
2016,Alleghany County,51005,Native Hawaiian and Other Pacific Islander ,0,0,0,19,19,19
2016,Amelia County,51007,Native Hawaiian and Other Pacific Islander ,0,0,0,19,19,19
2016,Amherst County,51009,Native Hawaiian and Other Pacific Islander ,6,0,6,10,25,10
2016,Appomattox County,51011,Native Hawaiian and Other Pacific Islander ,0,0,0,19,19,19
2016,Arlington County,51013,Native Hawaiian and Other Pacific Islander ,65,12,53,40,17,34
2016,Augusta County,51015,Native Hawaiian and Other Pacific Islander ,24,0,24,41,28,41
2016,Bath County,51017,Native Hawaiian and Other Pacific Islander ,0,0,0,12,12,12
2016,Bedford County,51019,Native Hawaiian and Other Pacific Islander ,9,9,0,14,14,28
2016,Bland County,51021,Native Hawaiian and Other Pacific Islander ,4,4,0,18,18,17
2016,Botetourt County,51023,Native Hawaiian and Other Pacific Islander ,0,0,0,25,25,25
2016,Brunswick County,51025,Native Hawaiian and Other Pacific Islander ,0,0,0,19,19,19
2016,Buchanan County,51027,Native Hawaiian and Other Pacific Islander ,0,0,0,22,22,22
2016,Buckingham County,51029,Native Hawaiian and Other Pacific Islander ,0,0,0,19,19,19
2016,Campbell County,51031,Native Hawaiian and Other Pacific Islander ,8,8,0,12,12,28
2016,Caroline County,51033,Native Hawaiian and Other Pacific Islander ,0,0,0,22,22,22
2016,Carroll County,51035,Native Hawaiian and Other Pacific Islander ,0,0,0,22,22,22
2016,Charles City County,51036,Native Hawaiian and Other Pacific Islander ,0,0,0,17,17,17
2016,Charlotte County,51037,Native Hawaiian and Other Pacific Islander ,0,0,0,19,19,19
2016,Chesterfield County,51041,Native Hawaiian and Other Pacific Islander ,34,21,13,35,29,22
2016,Clarke County,51043,Native Hawaiian and Other Pacific Islander ,0,0,0,19,19,19
2016,Craig County,51045,Native Hawaiian and Other Pacific Islander ,0,0,0,17,17,17
2016,Culpeper County,51047,Native Hawaiian and Other Pacific Islander ,0,0,0,25,25,25
2016,Cumberland County,51049,Native Hawaiian and Other Pacific Islander ,0,0,0,17,17,17
2016,Dickenson County,51051,Native Hawaiian and Other Pacific Islander ,0,0,0,19,19,19
2016,Dinwiddie County,51053,Native Hawaiian and Other Pacific Islander ,0,0,0,22,22,22
2016,Essex County,51057,Native Hawaiian and Other Pacific Islander ,0,0,0,19,19,19
2016,Fairfax County,51059,Native Hawaiian and Other Pacific Islander ,183,131,52,71,56,45
2016,Fauquier County,51061,Native Hawaiian and Other Pacific Islander ,2,2,0,3,3,28
2016,Floyd County,51063,Native Hawaiian and Other Pacific Islander ,0,0,0,19,19,19
2016,Fluvanna County,51065,Native Hawaiian and Other Pacific Islander ,0,0,0,22,22,22
2016,Franklin County,51067,Native Hawaiian and Other Pacific Islander ,0,0,0,28,28,28
2016,Frederick County,51069,Native Hawaiian and Other Pacific Islander ,18,18,0,26,26,28
2016,Giles County,51071,Native Hawaiian and Other Pacific Islander ,3,0,3,7,19,7
2016,Gloucester County,51073,Native Hawaiian and Other Pacific Islander ,0,0,0,25,25,25
2016,Goochland County,51075,Native Hawaiian and Other Pacific Islander ,0,0,0,22,22,22
2016,Grayson County,51077,Native Hawaiian and Other Pacific Islander ,0,0,0,19,19,19
2016,Greene County,51079,Native Hawaiian and Other Pacific Islander ,0,0,0,19,19,19
2016,Greensville County,51081,Native Hawaiian and Other Pacific Islander ,0,0,0,19,19,19
2016,Halifax County,51083,Native Hawaiian and Other Pacific Islander ,8,8,0,12,12,25
2016,Hanover County,51085,Native Hawaiian and Other Pacific Islander ,0,0,0,28,28,28
2016,Henrico County,51087,Native Hawaiian and Other Pacific Islander ,39,31,8,33,25,15
2016,Henry County,51089,Native Hawaiian and Other Pacific Islander ,0,0,0,28,28,28
2016,Highland County,51091,Native Hawaiian and Other Pacific Islander ,0,0,0,12,12,12
2016,Isle of Wight County,51093,Native Hawaiian and Other Pacific Islander ,0,0,0,25,25,25
2016,James City County,51095,Native Hawaiian and Other Pacific Islander ,0,0,0,28,28,28
2016,King and Queen County,51097,Native Hawaiian and Other Pacific Islander ,0,0,0,17,17,17
2016,King George County,51099,Native Hawaiian and Other Pacific Islander ,5,5,0,8,8,22
2016,King William County,51101,Native Hawaiian and Other Pacific Islander ,0,0,0,19,19,19
2016,Lancaster County,51103,Native Hawaiian and Other Pacific Islander ,0,0,0,19,19,19
2016,Lee County,51105,Native Hawaiian and Other Pacific Islander ,0,0,0,22,22,22
2016,Loudoun County,51107,Native Hawaiian and Other Pacific Islander ,98,59,39,33,39,36
2016,Louisa County,51109,Native Hawaiian and Other Pacific Islander ,0,0,0,25,25,25
2016,Lunenburg County,51111,Native Hawaiian and Other Pacific Islander ,0,0,0,19,19,19
2016,Madison County,51113,Native Hawaiian and Other Pacific Islander ,0,0,0,19,19,19
2016,Mathews County,51115,Native Hawaiian and Other Pacific Islander ,0,0,0,17,17,17
2016,Mecklenburg County,51117,Native Hawaiian and Other Pacific Islander ,0,0,0,25,25,25
2016,Middlesex County,51119,Native Hawaiian and Other Pacific Islander ,0,0,0,19,19,19
2016,Montgomery County,51121,Native Hawaiian and Other Pacific Islander ,36,0,36,58,28,58
2016,Nelson County,51125,Native Hawaiian and Other Pacific Islander ,0,0,0,19,19,19
2016,New Kent County,51127,Native Hawaiian and Other Pacific Islander ,0,0,0,22,22,22
2016,Northampton County,51131,Native Hawaiian and Other Pacific Islander ,0,0,0,19,19,19
2016,Northumberland County,51133,Native Hawaiian and Other Pacific Islander ,0,0,0,19,19,19
2016,Nottoway County,51135,Native Hawaiian and Other Pacific Islander ,0,0,0,19,19,19
2016,Orange County,51137,Native Hawaiian and Other Pacific Islander ,0,0,0,25,25,25
2016,Page County,51139,Native Hawaiian and Other Pacific Islander ,0,0,0,22,22,22
2016,Patrick County,51141,Native Hawaiian and Other Pacific Islander ,0,0,0,19,19,19
2016,Pittsylvania County,51143,Native Hawaiian and Other Pacific Islander ,0,0,0,28,28,28
2016,Powhatan County,51145,Native Hawaiian and Other Pacific Islander ,0,0,0,22,22,22
2016,Prince Edward County,51147,Native Hawaiian and Other Pacific Islander ,0,0,0,22,22,22
2016,Prince George County,51149,Native Hawaiian and Other Pacific Islander ,25,0,25,20,25,20
2016,Prince William County,51153,Native Hawaiian and Other Pacific Islander ,189,96,93,67,50,60
2016,Pulaski County,51155,Native Hawaiian and Other Pacific Islander ,0,0,0,25,25,25
2016,Rappahannock County,51157,Native Hawaiian and Other Pacific Islander ,0,0,0,17,17,17
2016,Richmond County,51159,Native Hawaiian and Other Pacific Islander ,0,0,0,17,17,17
2016,Roanoke County,51161,Native Hawaiian and Other Pacific Islander ,0,0,0,28,28,28
2016,Rockbridge County,51163,Native Hawaiian and Other Pacific Islander ,0,0,0,22,22,22
2016,Rockingham County,51165,Native Hawaiian and Other Pacific Islander ,10,10,0,16,16,28
2016,Russell County,51167,Native Hawaiian and Other Pacific Islander ,0,0,0,22,22,22
2016,Scott County,51169,Native Hawaiian and Other Pacific Islander ,0,0,0,22,22,22
2016,Shenandoah County,51171,Native Hawaiian and Other Pacific Islander ,0,0,0,25,25,25
2016,Smyth County,51173,Native Hawaiian and Other Pacific Islander ,5,0,5,9,25,9
2016,Southampton County,51175,Native Hawaiian and Other Pacific Islander ,0,0,0,19,19,19
2016,Spotsylvania County,51177,Native Hawaiian and Other Pacific Islander ,35,22,13,19,25,10
2016,Stafford County,51179,Native Hawaiian and Other Pacific Islander ,21,10,11,23,16,16
2016,Surry County,51181,Native Hawaiian and Other Pacific Islander ,0,0,0,17,17,17
2016,Sussex County,51183,Native Hawaiian and Other Pacific Islander ,0,0,0,19,19,19
2016,Tazewell County,51185,Native Hawaiian and Other Pacific Islander ,0,0,0,25,25,25
2016,Warren County,51187,Native Hawaiian and Other Pacific Islander ,0,0,0,25,25,25
2016,Washington County,51191,Native Hawaiian and Other Pacific Islander ,0,0,0,28,28,28
2016,Westmoreland County,51193,Native Hawaiian and Other Pacific Islander ,0,0,0,19,19,19
2016,Wise County,51195,Native Hawaiian and Other Pacific Islander ,20,0,20,29,25,29
2016,Wythe County,51197,Native Hawaiian and Other Pacific Islander ,0,0,0,22,22,22
2016,York County,51199,Native Hawaiian and Other Pacific Islander ,27,2,25,26,6,26
2016,Alexandria city,51510,Native Hawaiian and Other Pacific Islander ,25,0,25,39,28,39
2016,Bristol city,51520,Native Hawaiian and Other Pacific Islander ,0,0,0,19,19,19
2016,Buena Vista city,51530,Native Hawaiian and Other Pacific Islander ,0,0,0,17,17,17
2016,Charlottesville city,51540,Native Hawaiian and Other Pacific Islander ,18,0,18,26,25,26
2016,Chesapeake city,51550,Native Hawaiian and Other Pacific Islander ,64,39,25,54,51,28
2016,Colonial Heights city,51570,Native Hawaiian and Other Pacific Islander ,0,0,0,19,19,19
2016,Covington city,51580,Native Hawaiian and Other Pacific Islander ,0,0,0,17,17,17
2016,Danville city,51590,Native Hawaiian and Other Pacific Islander ,0,0,0,25,25,25
2016,Emporia city,51595,Native Hawaiian and Other Pacific Islander ,0,0,0,17,17,17
2016,Fairfax city,51600,Native Hawaiian and Other Pacific Islander ,0,0,0,22,22,22
2016,Falls Church city,51610,Native Hawaiian and Other Pacific Islander ,0,0,0,19,19,19
2016,Franklin city,51620,Native Hawaiian and Other Pacific Islander ,0,0,0,17,17,17
2016,Fredericksburg city,51630,Native Hawaiian and Other Pacific Islander ,19,0,19,21,22,21
2016,Galax city,51640,Native Hawaiian and Other Pacific Islander ,0,0,0,17,17,17
2016,Hampton city,51650,Native Hawaiian and Other Pacific Islander ,50,42,8,42,40,13
2016,Harrisonburg city,51660,Native Hawaiian and Other Pacific Islander ,0,0,0,28,28,28
2016,Hopewell city,51670,Native Hawaiian and Other Pacific Islander ,0,0,0,22,22,22
2016,Lexington city,51678,Native Hawaiian and Other Pacific Islander ,0,0,0,17,17,17
2016,Lynchburg city,51680,Native Hawaiian and Other Pacific Islander ,0,0,0,28,28,28
2016,Manassas city,51683,Native Hawaiian and Other Pacific Islander ,61,0,61,79,25,79
2016,Manassas Park city,51685,Native Hawaiian and Other Pacific Islander ,0,0,0,19,19,19
2016,Martinsville city,51690,Native Hawaiian and Other Pacific Islander ,0,0,0,19,19,19
2016,Newport News city,51700,Native Hawaiian and Other Pacific Islander ,119,28,91,52,27,45
2016,Norfolk city,51710,Native Hawaiian and Other Pacific Islander ,86,26,60,72,34,60
2016,Norton city,51720,Native Hawaiian and Other Pacific Islander ,0,0,0,12,12,12
2016,Petersburg city,51730,Native Hawaiian and Other Pacific Islander ,0,0,0,25,25,25
2016,Poquoson city,51735,Native Hawaiian and Other Pacific Islander ,0,0,0,19,19,19
2016,Portsmouth city,51740,Native Hawaiian and Other Pacific Islander ,15,10,5,5,4,4
2016,Radford city,51750,Native Hawaiian and Other Pacific Islander ,0,0,0,19,19,19
2016,Richmond city,51760,Native Hawaiian and Other Pacific Islander ,6,0,6,8,28,8
2016,Roanoke city,51770,Native Hawaiian and Other Pacific Islander ,73,0,73,88,28,88
2016,Salem city,51775,Native Hawaiian and Other Pacific Islander ,0,0,0,22,22,22
2016,Staunton city,51790,Native Hawaiian and Other Pacific Islander ,0,0,0,22,22,22
2016,Suffolk city,51800,Native Hawaiian and Other Pacific Islander ,28,20,8,29,25,14
2016,Virginia Beach city,51810,Native Hawaiian and Other Pacific Islander ,194,138,56,73,70,37
2016,Waynesboro city,51820,Native Hawaiian and Other Pacific Islander ,0,0,0,22,22,22
2016,Williamsburg city,51830,Native Hawaiian and Other Pacific Islander ,0,0,0,19,19,19
2016,Winchester city,51840,Native Hawaiian and Other Pacific Islander ,0,0,0,22,22,22
2017,Accomack County,51001,Native Hawaiian and Other Pacific Islander ,0,0,0,25,25,25
2017,Albemarle County,51003,Native Hawaiian and Other Pacific Islander ,37,9,28,45,14,43
2017,Alleghany County,51005,Native Hawaiian and Other Pacific Islander ,0,0,0,19,19,19
2017,Amelia County,51007,Native Hawaiian and Other Pacific Islander ,0,0,0,19,19,19
2017,Amherst County,51009,Native Hawaiian and Other Pacific Islander ,15,15,0,23,23,25
2017,Appomattox County,51011,Native Hawaiian and Other Pacific Islander ,0,0,0,19,19,19
2017,Arlington County,51013,Native Hawaiian and Other Pacific Islander ,65,5,60,33,12,34
2017,Augusta County,51015,Native Hawaiian and Other Pacific Islander ,22,0,22,37,28,37
2017,Bath County,51017,Native Hawaiian and Other Pacific Islander ,0,0,0,12,12,12
2017,Bedford County,51019,Native Hawaiian and Other Pacific Islander ,0,0,0,28,28,28
2017,Bland County,51021,Native Hawaiian and Other Pacific Islander ,3,3,0,22,22,17
2017,Botetourt County,51023,Native Hawaiian and Other Pacific Islander ,0,0,0,25,25,25
2017,Brunswick County,51025,Native Hawaiian and Other Pacific Islander ,0,0,0,19,19,19
2017,Buchanan County,51027,Native Hawaiian and Other Pacific Islander ,0,0,0,22,22,22
2017,Buckingham County,51029,Native Hawaiian and Other Pacific Islander ,0,0,0,19,19,19
2017,Campbell County,51031,Native Hawaiian and Other Pacific Islander ,0,0,0,28,28,28
2017,Caroline County,51033,Native Hawaiian and Other Pacific Islander ,0,0,0,22,22,22
2017,Carroll County,51035,Native Hawaiian and Other Pacific Islander ,0,0,0,22,22,22
2017,Charles City County,51036,Native Hawaiian and Other Pacific Islander ,0,0,0,17,17,17
2017,Charlotte County,51037,Native Hawaiian and Other Pacific Islander ,0,0,0,19,19,19
2017,Chesterfield County,51041,Native Hawaiian and Other Pacific Islander ,63,50,13,54,50,21
2017,Clarke County,51043,Native Hawaiian and Other Pacific Islander ,0,0,0,19,19,19
2017,Craig County,51045,Native Hawaiian and Other Pacific Islander ,0,0,0,17,17,17
2017,Culpeper County,51047,Native Hawaiian and Other Pacific Islander ,0,0,0,25,25,25
2017,Cumberland County,51049,Native Hawaiian and Other Pacific Islander ,0,0,0,17,17,17
2017,Dickenson County,51051,Native Hawaiian and Other Pacific Islander ,0,0,0,19,19,19
2017,Dinwiddie County,51053,Native Hawaiian and Other Pacific Islander ,0,0,0,22,22,22
2017,Essex County,51057,Native Hawaiian and Other Pacific Islander ,0,0,0,19,19,19
2017,Fairfax County,51059,Native Hawaiian and Other Pacific Islander ,205,111,94,79,47,71
2017,Fauquier County,51061,Native Hawaiian and Other Pacific Islander ,3,3,0,6,6,28
2017,Floyd County,51063,Native Hawaiian and Other Pacific Islander ,0,0,0,19,19,19
2017,Fluvanna County,51065,Native Hawaiian and Other Pacific Islander ,0,0,0,22,22,22
2017,Franklin County,51067,Native Hawaiian and Other Pacific Islander ,0,0,0,28,28,28
2017,Frederick County,51069,Native Hawaiian and Other Pacific Islander ,21,21,0,32,32,28
2017,Giles County,51071,Native Hawaiian and Other Pacific Islander ,5,0,5,10,19,10
2017,Gloucester County,51073,Native Hawaiian and Other Pacific Islander ,0,0,0,25,25,25
2017,Goochland County,51075,Native Hawaiian and Other Pacific Islander ,0,0,0,22,22,22
2017,Grayson County,51077,Native Hawaiian and Other Pacific Islander ,0,0,0,19,19,19
2017,Greene County,51079,Native Hawaiian and Other Pacific Islander ,0,0,0,19,19,19
2017,Greensville County,51081,Native Hawaiian and Other Pacific Islander ,0,0,0,19,19,19
2017,Halifax County,51083,Native Hawaiian and Other Pacific Islander ,6,6,0,9,9,25
2017,Hanover County,51085,Native Hawaiian and Other Pacific Islander ,0,0,0,28,28,28
2017,Henrico County,51087,Native Hawaiian and Other Pacific Islander ,42,31,11,26,22,16
2017,Henry County,51089,Native Hawaiian and Other Pacific Islander ,0,0,0,28,28,28
2017,Highland County,51091,Native Hawaiian and Other Pacific Islander ,0,0,0,12,12,12
2017,Isle of Wight County,51093,Native Hawaiian and Other Pacific Islander ,0,0,0,25,25,25
2017,James City County,51095,Native Hawaiian and Other Pacific Islander ,0,0,0,28,28,28
2017,King and Queen County,51097,Native Hawaiian and Other Pacific Islander ,0,0,0,17,17,17
2017,King George County,51099,Native Hawaiian and Other Pacific Islander ,6,6,0,10,10,22
2017,King William County,51101,Native Hawaiian and Other Pacific Islander ,0,0,0,19,19,19
2017,Lancaster County,51103,Native Hawaiian and Other Pacific Islander ,0,0,0,19,19,19
2017,Lee County,51105,Native Hawaiian and Other Pacific Islander ,0,0,0,22,22,22
2017,Loudoun County,51107,Native Hawaiian and Other Pacific Islander ,109,89,20,40,40,25
2017,Louisa County,51109,Native Hawaiian and Other Pacific Islander ,0,0,0,25,25,25
2017,Lunenburg County,51111,Native Hawaiian and Other Pacific Islander ,0,0,0,19,19,19
2017,Madison County,51113,Native Hawaiian and Other Pacific Islander ,0,0,0,19,19,19
2017,Mathews County,51115,Native Hawaiian and Other Pacific Islander ,0,0,0,17,17,17
2017,Mecklenburg County,51117,Native Hawaiian and Other Pacific Islander ,0,0,0,25,25,25
2017,Middlesex County,51119,Native Hawaiian and Other Pacific Islander ,0,0,0,19,19,19
2017,Montgomery County,51121,Native Hawaiian and Other Pacific Islander ,20,0,20,33,28,33
2017,Nelson County,51125,Native Hawaiian and Other Pacific Islander ,0,0,0,19,19,19
2017,New Kent County,51127,Native Hawaiian and Other Pacific Islander ,0,0,0,22,22,22
2017,Northampton County,51131,Native Hawaiian and Other Pacific Islander ,0,0,0,19,19,19
2017,Northumberland County,51133,Native Hawaiian and Other Pacific Islander ,0,0,0,19,19,19
2017,Nottoway County,51135,Native Hawaiian and Other Pacific Islander ,0,0,0,19,19,19
2017,Orange County,51137,Native Hawaiian and Other Pacific Islander ,0,0,0,25,25,25
2017,Page County,51139,Native Hawaiian and Other Pacific Islander ,0,0,0,22,22,22
2017,Patrick County,51141,Native Hawaiian and Other Pacific Islander ,0,0,0,19,19,19
2017,Pittsylvania County,51143,Native Hawaiian and Other Pacific Islander ,0,0,0,28,28,28
2017,Powhatan County,51145,Native Hawaiian and Other Pacific Islander ,0,0,0,22,22,22
2017,Prince Edward County,51147,Native Hawaiian and Other Pacific Islander ,0,0,0,22,22,22
2017,Prince George County,51149,Native Hawaiian and Other Pacific Islander ,11,0,11,11,25,11
2017,Prince William County,51153,Native Hawaiian and Other Pacific Islander ,170,113,57,74,49,58
2017,Pulaski County,51155,Native Hawaiian and Other Pacific Islander ,0,0,0,25,25,25
2017,Rappahannock County,51157,Native Hawaiian and Other Pacific Islander ,0,0,0,17,17,17
2017,Richmond County,51159,Native Hawaiian and Other Pacific Islander ,0,0,0,17,17,17
2017,Roanoke County,51161,Native Hawaiian and Other Pacific Islander ,0,0,0,28,28,28
2017,Rockbridge County,51163,Native Hawaiian and Other Pacific Islander ,0,0,0,22,22,22
2017,Rockingham County,51165,Native Hawaiian and Other Pacific Islander ,10,10,0,16,16,28
2017,Russell County,51167,Native Hawaiian and Other Pacific Islander ,0,0,0,22,22,22
2017,Scott County,51169,Native Hawaiian and Other Pacific Islander ,0,0,0,22,22,22
2017,Shenandoah County,51171,Native Hawaiian and Other Pacific Islander ,0,0,0,25,25,25
2017,Smyth County,51173,Native Hawaiian and Other Pacific Islander ,10,0,10,16,25,16
2017,Southampton County,51175,Native Hawaiian and Other Pacific Islander ,0,0,0,19,19,19
2017,Spotsylvania County,51177,Native Hawaiian and Other Pacific Islander ,37,37,0,36,36,28
2017,Stafford County,51179,Native Hawaiian and Other Pacific Islander ,16,4,12,23,8,20
2017,Surry County,51181,Native Hawaiian and Other Pacific Islander ,0,0,0,17,17,17
2017,Sussex County,51183,Native Hawaiian and Other Pacific Islander ,0,0,0,19,19,19
2017,Tazewell County,51185,Native Hawaiian and Other Pacific Islander ,0,0,0,25,25,25
2017,Warren County,51187,Native Hawaiian and Other Pacific Islander ,0,0,0,25,25,25
2017,Washington County,51191,Native Hawaiian and Other Pacific Islander ,0,0,0,28,28,28
2017,Westmoreland County,51193,Native Hawaiian and Other Pacific Islander ,0,0,0,19,19,19
2017,Wise County,51195,Native Hawaiian and Other Pacific Islander ,20,0,20,33,25,33
2017,Wythe County,51197,Native Hawaiian and Other Pacific Islander ,0,0,0,22,22,22
2017,York County,51199,Native Hawaiian and Other Pacific Islander ,50,16,34,42,28,36
2017,Alexandria city,51510,Native Hawaiian and Other Pacific Islander ,20,0,20,35,28,35
2017,Bristol city,51520,Native Hawaiian and Other Pacific Islander ,0,0,0,19,19,19
2017,Buena Vista city,51530,Native Hawaiian and Other Pacific Islander ,0,0,0,17,17,17
2017,Charlottesville city,51540,Native Hawaiian and Other Pacific Islander ,0,0,0,25,25,25
2017,Chesapeake city,51550,Native Hawaiian and Other Pacific Islander ,64,40,24,35,40,27
2017,Colonial Heights city,51570,Native Hawaiian and Other Pacific Islander ,0,0,0,19,19,19
2017,Covington city,51580,Native Hawaiian and Other Pacific Islander ,0,0,0,17,17,17
2017,Danville city,51590,Native Hawaiian and Other Pacific Islander ,9,0,9,14,25,14
2017,Emporia city,51595,Native Hawaiian and Other Pacific Islander ,0,0,0,17,17,17
2017,Fairfax city,51600,Native Hawaiian and Other Pacific Islander ,0,0,0,22,22,22
2017,Falls Church city,51610,Native Hawaiian and Other Pacific Islander ,0,0,0,19,19,19
2017,Franklin city,51620,Native Hawaiian and Other Pacific Islander ,0,0,0,17,17,17
2017,Fredericksburg city,51630,Native Hawaiian and Other Pacific Islander ,23,0,23,25,22,25
2017,Galax city,51640,Native Hawaiian and Other Pacific Islander ,0,0,0,17,17,17
2017,Hampton city,51650,Native Hawaiian and Other Pacific Islander ,65,46,19,44,41,24
2017,Harrisonburg city,51660,Native Hawaiian and Other Pacific Islander ,0,0,0,28,28,28
2017,Hopewell city,51670,Native Hawaiian and Other Pacific Islander ,0,0,0,22,22,22
2017,Lexington city,51678,Native Hawaiian and Other Pacific Islander ,0,0,0,17,17,17
2017,Lynchburg city,51680,Native Hawaiian and Other Pacific Islander ,0,0,0,28,28,28
2017,Manassas city,51683,Native Hawaiian and Other Pacific Islander ,50,0,50,67,25,67
2017,Manassas Park city,51685,Native Hawaiian and Other Pacific Islander ,0,0,0,19,19,19
2017,Martinsville city,51690,Native Hawaiian and Other Pacific Islander ,0,0,0,19,19,19
2017,Newport News city,51700,Native Hawaiian and Other Pacific Islander ,109,38,71,49,31,42
2017,Norfolk city,51710,Native Hawaiian and Other Pacific Islander ,48,26,22,48,36,30
2017,Norton city,51720,Native Hawaiian and Other Pacific Islander ,0,0,0,12,12,12
2017,Petersburg city,51730,Native Hawaiian and Other Pacific Islander ,0,0,0,25,25,25
2017,Poquoson city,51735,Native Hawaiian and Other Pacific Islander ,0,0,0,19,19,19
2017,Portsmouth city,51740,Native Hawaiian and Other Pacific Islander ,21,12,9,9,9,16
2017,Radford city,51750,Native Hawaiian and Other Pacific Islander ,8,0,8,20,19,20
2017,Richmond city,51760,Native Hawaiian and Other Pacific Islander ,6,0,6,9,28,9
2017,Roanoke city,51770,Native Hawaiian and Other Pacific Islander ,75,0,75,97,28,97
2017,Salem city,51775,Native Hawaiian and Other Pacific Islander ,0,0,0,22,22,22
2017,Staunton city,51790,Native Hawaiian and Other Pacific Islander ,0,0,0,22,22,22
2017,Suffolk city,51800,Native Hawaiian and Other Pacific Islander ,30,22,8,30,27,14
2017,Virginia Beach city,51810,Native Hawaiian and Other Pacific Islander ,173,118,55,59,56,43
2017,Waynesboro city,51820,Native Hawaiian and Other Pacific Islander ,0,0,0,22,22,22
2017,Williamsburg city,51830,Native Hawaiian and Other Pacific Islander ,0,0,0,19,19,19
2017,Winchester city,51840,Native Hawaiian and Other Pacific Islander ,0,0,0,22,22,22
2018,Accomack County,51001,Native Hawaiian and Other Pacific Islander ,0,0,0,25,25,25
2018,Albemarle County,51003,Native Hawaiian and Other Pacific Islander ,23,0,23,36,28,36
2018,Alleghany County,51005,Native Hawaiian and Other Pacific Islander ,0,0,0,19,19,19
2018,Amelia County,51007,Native Hawaiian and Other Pacific Islander ,0,0,0,19,19,19
2018,Amherst County,51009,Native Hawaiian and Other Pacific Islander ,22,22,0,33,33,25
2018,Appomattox County,51011,Native Hawaiian and Other Pacific Islander ,0,0,0,19,19,19
2018,Arlington County,51013,Native Hawaiian and Other Pacific Islander ,73,11,62,42,12,43
2018,Augusta County,51015,Native Hawaiian and Other Pacific Islander ,24,0,24,45,28,45
2018,Bath County,51017,Native Hawaiian and Other Pacific Islander ,0,0,0,12,12,12
2018,Bedford County,51019,Native Hawaiian and Other Pacific Islander ,0,0,0,28,28,28
2018,Bland County,51021,Native Hawaiian and Other Pacific Islander ,0,0,0,17,17,17
2018,Botetourt County,51023,Native Hawaiian and Other Pacific Islander ,0,0,0,25,25,25
2018,Brunswick County,51025,Native Hawaiian and Other Pacific Islander ,0,0,0,19,19,19
2018,Buchanan County,51027,Native Hawaiian and Other Pacific Islander ,0,0,0,22,22,22
2018,Buckingham County,51029,Native Hawaiian and Other Pacific Islander ,0,0,0,19,19,19
2018,Campbell County,51031,Native Hawaiian and Other Pacific Islander ,0,0,0,28,28,28
2018,Caroline County,51033,Native Hawaiian and Other Pacific Islander ,0,0,0,25,25,25
2018,Carroll County,51035,Native Hawaiian and Other Pacific Islander ,0,0,0,22,22,22
2018,Charles City County,51036,Native Hawaiian and Other Pacific Islander ,0,0,0,17,17,17
2018,Charlotte County,51037,Native Hawaiian and Other Pacific Islander ,0,0,0,19,19,19
2018,Chesterfield County,51041,Native Hawaiian and Other Pacific Islander ,60,38,22,50,42,34
2018,Clarke County,51043,Native Hawaiian and Other Pacific Islander ,0,0,0,19,19,19
2018,Craig County,51045,Native Hawaiian and Other Pacific Islander ,0,0,0,17,17,17
2018,Culpeper County,51047,Native Hawaiian and Other Pacific Islander ,0,0,0,28,28,28
2018,Cumberland County,51049,Native Hawaiian and Other Pacific Islander ,0,0,0,17,17,17
2018,Dickenson County,51051,Native Hawaiian and Other Pacific Islander ,0,0,0,19,19,19
2018,Dinwiddie County,51053,Native Hawaiian and Other Pacific Islander ,14,14,0,22,22,22
2018,Essex County,51057,Native Hawaiian and Other Pacific Islander ,0,0,0,19,19,19
2018,Fairfax County,51059,Native Hawaiian and Other Pacific Islander ,234,98,136,93,47,84
2018,Fauquier County,51061,Native Hawaiian and Other Pacific Islander ,9,9,0,15,15,28
2018,Floyd County,51063,Native Hawaiian and Other Pacific Islander ,0,0,0,19,19,19
2018,Fluvanna County,51065,Native Hawaiian and Other Pacific Islander ,0,0,0,22,22,22
2018,Franklin County,51067,Native Hawaiian and Other Pacific Islander ,0,0,0,28,28,28
2018,Frederick County,51069,Native Hawaiian and Other Pacific Islander ,20,12,8,23,20,12
2018,Giles County,51071,Native Hawaiian and Other Pacific Islander ,0,0,0,19,19,19
2018,Gloucester County,51073,Native Hawaiian and Other Pacific Islander ,0,0,0,25,25,25
2018,Goochland County,51075,Native Hawaiian and Other Pacific Islander ,0,0,0,22,22,22
2018,Grayson County,51077,Native Hawaiian and Other Pacific Islander ,0,0,0,19,19,19
2018,Greene County,51079,Native Hawaiian and Other Pacific Islander ,0,0,0,19,19,19
2018,Greensville County,51081,Native Hawaiian and Other Pacific Islander ,0,0,0,19,19,19
2018,Halifax County,51083,Native Hawaiian and Other Pacific Islander ,0,0,0,25,25,25
2018,Hanover County,51085,Native Hawaiian and Other Pacific Islander ,0,0,0,28,28,28
2018,Henrico County,51087,Native Hawaiian and Other Pacific Islander ,38,26,12,31,29,16
2018,Henry County,51089,Native Hawaiian and Other Pacific Islander ,0,0,0,28,28,28
2018,Highland County,51091,Native Hawaiian and Other Pacific Islander ,0,0,0,12,12,12
2018,Isle of Wight County,51093,Native Hawaiian and Other Pacific Islander ,0,0,0,25,25,25
2018,James City County,51095,Native Hawaiian and Other Pacific Islander ,0,0,0,28,28,28
2018,King and Queen County,51097,Native Hawaiian and Other Pacific Islander ,0,0,0,17,17,17
2018,King George County,51099,Native Hawaiian and Other Pacific Islander ,0,0,0,22,22,22
2018,King William County,51101,Native Hawaiian and Other Pacific Islander ,0,0,0,19,19,19
2018,Lancaster County,51103,Native Hawaiian and Other Pacific Islander ,0,0,0,19,19,19
2018,Lee County,51105,Native Hawaiian and Other Pacific Islander ,0,0,0,22,22,22
2018,Loudoun County,51107,Native Hawaiian and Other Pacific Islander ,101,66,35,33,30,23
2018,Louisa County,51109,Native Hawaiian and Other Pacific Islander ,0,0,0,25,25,25
2018,Lunenburg County,51111,Native Hawaiian and Other Pacific Islander ,0,0,0,19,19,19
2018,Madison County,51113,Native Hawaiian and Other Pacific Islander ,0,0,0,19,19,19
2018,Mathews County,51115,Native Hawaiian and Other Pacific Islander ,0,0,0,17,17,17
2018,Mecklenburg County,51117,Native Hawaiian and Other Pacific Islander ,3,3,0,5,5,25
2018,Middlesex County,51119,Native Hawaiian and Other Pacific Islander ,0,0,0,19,19,19
2018,Montgomery County,51121,Native Hawaiian and Other Pacific Islander ,17,0,17,27,28,27
2018,Nelson County,51125,Native Hawaiian and Other Pacific Islander ,0,0,0,19,19,19
2018,New Kent County,51127,Native Hawaiian and Other Pacific Islander ,0,0,0,22,22,22
2018,Northampton County,51131,Native Hawaiian and Other Pacific Islander ,0,0,0,19,19,19
2018,Northumberland County,51133,Native Hawaiian and Other Pacific Islander ,0,0,0,19,19,19
2018,Nottoway County,51135,Native Hawaiian and Other Pacific Islander ,0,0,0,19,19,19
2018,Orange County,51137,Native Hawaiian and Other Pacific Islander ,0,0,0,25,25,25
2018,Page County,51139,Native Hawaiian and Other Pacific Islander ,0,0,0,22,22,22
2018,Patrick County,51141,Native Hawaiian and Other Pacific Islander ,0,0,0,19,19,19
2018,Pittsylvania County,51143,Native Hawaiian and Other Pacific Islander ,0,0,0,28,28,28
2018,Powhatan County,51145,Native Hawaiian and Other Pacific Islander ,0,0,0,22,22,22
2018,Prince Edward County,51147,Native Hawaiian and Other Pacific Islander ,0,0,0,22,22,22
2018,Prince George County,51149,Native Hawaiian and Other Pacific Islander ,16,0,16,16,25,16
2018,Prince William County,51153,Native Hawaiian and Other Pacific Islander ,166,129,37,53,45,49
2018,Pulaski County,51155,Native Hawaiian and Other Pacific Islander ,0,0,0,25,25,25
2018,Rappahannock County,51157,Native Hawaiian and Other Pacific Islander ,0,0,0,17,17,17
2018,Richmond County,51159,Native Hawaiian and Other Pacific Islander ,0,0,0,17,17,17
2018,Roanoke County,51161,Native Hawaiian and Other Pacific Islander ,17,17,0,24,24,28
2018,Rockbridge County,51163,Native Hawaiian and Other Pacific Islander ,0,0,0,22,22,22
2018,Rockingham County,51165,Native Hawaiian and Other Pacific Islander ,8,8,0,13,13,28
2018,Russell County,51167,Native Hawaiian and Other Pacific Islander ,0,0,0,22,22,22
2018,Scott County,51169,Native Hawaiian and Other Pacific Islander ,0,0,0,22,22,22
2018,Shenandoah County,51171,Native Hawaiian and Other Pacific Islander ,0,0,0,25,25,25
2018,Smyth County,51173,Native Hawaiian and Other Pacific Islander ,10,0,10,15,25,15
2018,Southampton County,51175,Native Hawaiian and Other Pacific Islander ,0,0,0,19,19,19
2018,Spotsylvania County,51177,Native Hawaiian and Other Pacific Islander ,29,29,0,25,25,28
2018,Stafford County,51179,Native Hawaiian and Other Pacific Islander ,24,5,19,36,9,34
2018,Surry County,51181,Native Hawaiian and Other Pacific Islander ,0,0,0,17,17,17
2018,Sussex County,51183,Native Hawaiian and Other Pacific Islander ,0,0,0,19,19,19
2018,Tazewell County,51185,Native Hawaiian and Other Pacific Islander ,0,0,0,25,25,25
2018,Warren County,51187,Native Hawaiian and Other Pacific Islander ,0,0,0,25,25,25
2018,Washington County,51191,Native Hawaiian and Other Pacific Islander ,0,0,0,28,28,28
2018,Westmoreland County,51193,Native Hawaiian and Other Pacific Islander ,0,0,0,19,19,19
2018,Wise County,51195,Native Hawaiian and Other Pacific Islander ,15,0,15,24,25,24
2018,Wythe County,51197,Native Hawaiian and Other Pacific Islander ,0,0,0,22,22,22
2018,York County,51199,Native Hawaiian and Other Pacific Islander ,69,18,51,52,29,50
2018,Alexandria city,51510,Native Hawaiian and Other Pacific Islander ,28,0,28,43,28,43
2018,Bristol city,51520,Native Hawaiian and Other Pacific Islander ,0,0,0,19,19,19
2018,Buena Vista city,51530,Native Hawaiian and Other Pacific Islander ,0,0,0,17,17,17
2018,Charlottesville city,51540,Native Hawaiian and Other Pacific Islander ,0,0,0,25,25,25
2018,Chesapeake city,51550,Native Hawaiian and Other Pacific Islander ,69,41,28,36,41,24
2018,Colonial Heights city,51570,Native Hawaiian and Other Pacific Islander ,0,0,0,19,19,19
2018,Covington city,51580,Native Hawaiian and Other Pacific Islander ,0,0,0,17,17,17
2018,Danville city,51590,Native Hawaiian and Other Pacific Islander ,9,0,9,14,25,14
2018,Emporia city,51595,Native Hawaiian and Other Pacific Islander ,0,0,0,17,17,17
2018,Fairfax city,51600,Native Hawaiian and Other Pacific Islander ,0,0,0,22,22,22
2018,Falls Church city,51610,Native Hawaiian and Other Pacific Islander ,0,0,0,19,19,19
2018,Franklin city,51620,Native Hawaiian and Other Pacific Islander ,0,0,0,17,17,17
2018,Fredericksburg city,51630,Native Hawaiian and Other Pacific Islander ,19,0,19,18,22,18
2018,Galax city,51640,Native Hawaiian and Other Pacific Islander ,0,0,0,17,17,17
2018,Hampton city,51650,Native Hawaiian and Other Pacific Islander ,73,61,12,49,46,21
2018,Harrisonburg city,51660,Native Hawaiian and Other Pacific Islander ,0,0,0,28,28,28
2018,Hopewell city,51670,Native Hawaiian and Other Pacific Islander ,0,0,0,22,22,22
2018,Lexington city,51678,Native Hawaiian and Other Pacific Islander ,0,0,0,17,17,17
2018,Lynchburg city,51680,Native Hawaiian and Other Pacific Islander ,0,0,0,28,28,28
2018,Manassas city,51683,Native Hawaiian and Other Pacific Islander ,58,0,58,73,25,73
2018,Manassas Park city,51685,Native Hawaiian and Other Pacific Islander ,0,0,0,19,19,19
2018,Martinsville city,51690,Native Hawaiian and Other Pacific Islander ,0,0,0,19,19,19
2018,Newport News city,51700,Native Hawaiian and Other Pacific Islander ,134,100,34,70,62,37
2018,Norfolk city,51710,Native Hawaiian and Other Pacific Islander ,59,31,28,49,34,35
2018,Norton city,51720,Native Hawaiian and Other Pacific Islander ,0,0,0,12,12,12
2018,Petersburg city,51730,Native Hawaiian and Other Pacific Islander ,0,0,0,25,25,25
2018,Poquoson city,51735,Native Hawaiian and Other Pacific Islander ,0,0,0,19,19,19
2018,Portsmouth city,51740,Native Hawaiian and Other Pacific Islander ,19,12,7,7,7,13
2018,Radford city,51750,Native Hawaiian and Other Pacific Islander ,7,0,7,14,19,14
2018,Richmond city,51760,Native Hawaiian and Other Pacific Islander ,6,0,6,9,28,9
2018,Roanoke city,51770,Native Hawaiian and Other Pacific Islander ,0,0,0,28,28,28
2018,Salem city,51775,Native Hawaiian and Other Pacific Islander ,0,0,0,22,22,22
2018,Staunton city,51790,Native Hawaiian and Other Pacific Islander ,0,0,0,22,22,22
2018,Suffolk city,51800,Native Hawaiian and Other Pacific Islander ,14,2,12,19,3,19
2018,Virginia Beach city,51810,Native Hawaiian and Other Pacific Islander ,149,108,41,75,68,36
2018,Waynesboro city,51820,Native Hawaiian and Other Pacific Islander ,0,0,0,22,22,22
2018,Williamsburg city,51830,Native Hawaiian and Other Pacific Islander ,0,0,0,19,19,19
2018,Winchester city,51840,Native Hawaiian and Other Pacific Islander ,0,0,0,22,22,22
2019,Accomack County,51001,Native Hawaiian and Other Pacific Islander ,0,0,0,26,26,26
2019,Albemarle County,51003,Native Hawaiian and Other Pacific Islander ,25,0,25,42,29,42
2019,Alleghany County,51005,Native Hawaiian and Other Pacific Islander ,0,0,0,19,19,19
2019,Amelia County,51007,Native Hawaiian and Other Pacific Islander ,0,0,0,19,19,19
2019,Amherst County,51009,Native Hawaiian and Other Pacific Islander ,19,19,0,31,31,26
2019,Appomattox County,51011,Native Hawaiian and Other Pacific Islander ,0,0,0,19,19,19
2019,Arlington County,51013,Native Hawaiian and Other Pacific Islander ,62,9,53,43,14,43
2019,Augusta County,51015,Native Hawaiian and Other Pacific Islander ,69,0,69,75,29,75
2019,Bath County,51017,Native Hawaiian and Other Pacific Islander ,0,0,0,12,12,12
2019,Bedford County,51019,Native Hawaiian and Other Pacific Islander ,0,0,0,29,29,29
2019,Bland County,51021,Native Hawaiian and Other Pacific Islander ,0,0,0,17,17,17
2019,Botetourt County,51023,Native Hawaiian and Other Pacific Islander ,0,0,0,26,26,26
2019,Brunswick County,51025,Native Hawaiian and Other Pacific Islander ,0,0,0,19,19,19
2019,Buchanan County,51027,Native Hawaiian and Other Pacific Islander ,0,0,0,23,23,23
2019,Buckingham County,51029,Native Hawaiian and Other Pacific Islander ,0,0,0,19,19,19
2019,Campbell County,51031,Native Hawaiian and Other Pacific Islander ,0,0,0,29,29,29
2019,Caroline County,51033,Native Hawaiian and Other Pacific Islander ,0,0,0,26,26,26
2019,Carroll County,51035,Native Hawaiian and Other Pacific Islander ,0,0,0,23,23,23
2019,Charles City County,51036,Native Hawaiian and Other Pacific Islander ,0,0,0,17,17,17
2019,Charlotte County,51037,Native Hawaiian and Other Pacific Islander ,0,0,0,19,19,19
2019,Chesterfield County,51041,Native Hawaiian and Other Pacific Islander ,106,86,20,63,60,32
2019,Clarke County,51043,Native Hawaiian and Other Pacific Islander ,0,0,0,19,19,19
2019,Craig County,51045,Native Hawaiian and Other Pacific Islander ,0,0,0,17,17,17
2019,Culpeper County,51047,Native Hawaiian and Other Pacific Islander ,0,0,0,29,29,29
2019,Cumberland County,51049,Native Hawaiian and Other Pacific Islander ,0,0,0,17,17,17
2019,Dickenson County,51051,Native Hawaiian and Other Pacific Islander ,0,0,0,19,19,19
2019,Dinwiddie County,51053,Native Hawaiian and Other Pacific Islander ,9,9,0,15,15,23
2019,Essex County,51057,Native Hawaiian and Other Pacific Islander ,0,0,0,19,19,19
2019,Fairfax County,51059,Native Hawaiian and Other Pacific Islander ,264,108,156,96,49,83
2019,Fauquier County,51061,Native Hawaiian and Other Pacific Islander ,9,9,0,16,16,29
2019,Floyd County,51063,Native Hawaiian and Other Pacific Islander ,0,0,0,19,19,19
2019,Fluvanna County,51065,Native Hawaiian and Other Pacific Islander ,0,0,0,23,23,23
2019,Franklin County,51067,Native Hawaiian and Other Pacific Islander ,0,0,0,29,29,29
2019,Frederick County,51069,Native Hawaiian and Other Pacific Islander ,23,15,8,29,23,15
2019,Giles County,51071,Native Hawaiian and Other Pacific Islander ,0,0,0,19,19,19
2019,Gloucester County,51073,Native Hawaiian and Other Pacific Islander ,0,0,0,26,26,26
2019,Goochland County,51075,Native Hawaiian and Other Pacific Islander ,0,0,0,23,23,23
2019,Grayson County,51077,Native Hawaiian and Other Pacific Islander ,0,0,0,19,19,19
2019,Greene County,51079,Native Hawaiian and Other Pacific Islander ,0,0,0,19,19,19
2019,Greensville County,51081,Native Hawaiian and Other Pacific Islander ,0,0,0,19,19,19
2019,Halifax County,51083,Native Hawaiian and Other Pacific Islander ,0,0,0,26,26,26
2019,Hanover County,51085,Native Hawaiian and Other Pacific Islander ,0,0,0,29,29,29
2019,Henrico County,51087,Native Hawaiian and Other Pacific Islander ,31,27,4,20,19,7
2019,Henry County,51089,Native Hawaiian and Other Pacific Islander ,0,0,0,29,29,29
2019,Highland County,51091,Native Hawaiian and Other Pacific Islander ,0,0,0,12,12,12
2019,Isle of Wight County,51093,Native Hawaiian and Other Pacific Islander ,0,0,0,26,26,26
2019,James City County,51095,Native Hawaiian and Other Pacific Islander ,0,0,0,29,29,29
2019,King and Queen County,51097,Native Hawaiian and Other Pacific Islander ,0,0,0,17,17,17
2019,King George County,51099,Native Hawaiian and Other Pacific Islander ,0,0,0,23,23,23
2019,King William County,51101,Native Hawaiian and Other Pacific Islander ,0,0,0,19,19,19
2019,Lancaster County,51103,Native Hawaiian and Other Pacific Islander ,0,0,0,19,19,19
2019,Lee County,51105,Native Hawaiian and Other Pacific Islander ,0,0,0,23,23,23
2019,Loudoun County,51107,Native Hawaiian and Other Pacific Islander ,78,49,29,26,23,21
2019,Louisa County,51109,Native Hawaiian and Other Pacific Islander ,0,0,0,26,26,26
2019,Lunenburg County,51111,Native Hawaiian and Other Pacific Islander ,0,0,0,19,19,19
2019,Madison County,51113,Native Hawaiian and Other Pacific Islander ,0,0,0,19,19,19
2019,Mathews County,51115,Native Hawaiian and Other Pacific Islander ,0,0,0,17,17,17
2019,Mecklenburg County,51117,Native Hawaiian and Other Pacific Islander ,4,4,0,6,6,26
2019,Middlesex County,51119,Native Hawaiian and Other Pacific Islander ,0,0,0,19,19,19
2019,Montgomery County,51121,Native Hawaiian and Other Pacific Islander ,19,0,19,22,29,22
2019,Nelson County,51125,Native Hawaiian and Other Pacific Islander ,0,0,0,19,19,19
2019,New Kent County,51127,Native Hawaiian and Other Pacific Islander ,0,0,0,23,23,23
2019,Northampton County,51131,Native Hawaiian and Other Pacific Islander ,0,0,0,19,19,19
2019,Northumberland County,51133,Native Hawaiian and Other Pacific Islander ,0,0,0,19,19,19
2019,Nottoway County,51135,Native Hawaiian and Other Pacific Islander ,0,0,0,19,19,19
2019,Orange County,51137,Native Hawaiian and Other Pacific Islander ,0,0,0,26,26,26
2019,Page County,51139,Native Hawaiian and Other Pacific Islander ,0,0,0,23,23,23
2019,Patrick County,51141,Native Hawaiian and Other Pacific Islander ,0,0,0,19,19,19
2019,Pittsylvania County,51143,Native Hawaiian and Other Pacific Islander ,0,0,0,29,29,29
2019,Powhatan County,51145,Native Hawaiian and Other Pacific Islander ,0,0,0,23,23,23
2019,Prince Edward County,51147,Native Hawaiian and Other Pacific Islander ,0,0,0,23,23,23
2019,Prince George County,51149,Native Hawaiian and Other Pacific Islander ,25,0,25,21,26,21
2019,Prince William County,51153,Native Hawaiian and Other Pacific Islander ,206,127,79,92,70,62
2019,Pulaski County,51155,Native Hawaiian and Other Pacific Islander ,19,0,19,27,26,27
2019,Rappahannock County,51157,Native Hawaiian and Other Pacific Islander ,0,0,0,17,17,17
2019,Richmond County,51159,Native Hawaiian and Other Pacific Islander ,0,0,0,17,17,17
2019,Roanoke County,51161,Native Hawaiian and Other Pacific Islander ,11,11,0,19,19,29
2019,Rockbridge County,51163,Native Hawaiian and Other Pacific Islander ,0,0,0,23,23,23
2019,Rockingham County,51165,Native Hawaiian and Other Pacific Islander ,17,17,0,19,19,29
2019,Russell County,51167,Native Hawaiian and Other Pacific Islander ,0,0,0,23,23,23
2019,Scott County,51169,Native Hawaiian and Other Pacific Islander ,0,0,0,23,23,23
2019,Shenandoah County,51171,Native Hawaiian and Other Pacific Islander ,0,0,0,26,26,26
2019,Smyth County,51173,Native Hawaiian and Other Pacific Islander ,16,0,16,26,26,26
2019,Southampton County,51175,Native Hawaiian and Other Pacific Islander ,0,0,0,19,19,19
2019,Spotsylvania County,51177,Native Hawaiian and Other Pacific Islander ,30,30,0,30,30,29
2019,Stafford County,51179,Native Hawaiian and Other Pacific Islander ,38,6,32,56,10,54
2019,Surry County,51181,Native Hawaiian and Other Pacific Islander ,0,0,0,17,17,17
2019,Sussex County,51183,Native Hawaiian and Other Pacific Islander ,0,0,0,19,19,19
2019,Tazewell County,51185,Native Hawaiian and Other Pacific Islander ,0,0,0,26,26,26
2019,Warren County,51187,Native Hawaiian and Other Pacific Islander ,0,0,0,26,26,26
2019,Washington County,51191,Native Hawaiian and Other Pacific Islander ,0,0,0,29,29,29
2019,Westmoreland County,51193,Native Hawaiian and Other Pacific Islander ,0,0,0,19,19,19
2019,Wise County,51195,Native Hawaiian and Other Pacific Islander ,19,0,19,30,26,30
2019,Wythe County,51197,Native Hawaiian and Other Pacific Islander ,0,0,0,23,23,23
2019,York County,51199,Native Hawaiian and Other Pacific Islander ,90,23,67,74,40,71
2019,Alexandria city,51510,Native Hawaiian and Other Pacific Islander ,0,0,0,29,29,29
2019,Bristol city,51520,Native Hawaiian and Other Pacific Islander ,0,0,0,19,19,19
2019,Buena Vista city,51530,Native Hawaiian and Other Pacific Islander ,0,0,0,17,17,17
2019,Charlottesville city,51540,Native Hawaiian and Other Pacific Islander ,0,0,0,26,26,26
2019,Chesapeake city,51550,Native Hawaiian and Other Pacific Islander ,78,64,14,56,56,20
2019,Colonial Heights city,51570,Native Hawaiian and Other Pacific Islander ,0,0,0,19,19,19
2019,Covington city,51580,Native Hawaiian and Other Pacific Islander ,0,0,0,17,17,17
2019,Danville city,51590,Native Hawaiian and Other Pacific Islander ,7,0,7,12,26,12
2019,Emporia city,51595,Native Hawaiian and Other Pacific Islander ,0,0,0,17,17,17
2019,Fairfax city,51600,Native Hawaiian and Other Pacific Islander ,0,0,0,23,23,23
2019,Falls Church city,51610,Native Hawaiian and Other Pacific Islander ,0,0,0,19,19,19
2019,Franklin city,51620,Native Hawaiian and Other Pacific Islander ,0,0,0,17,17,17
2019,Fredericksburg city,51630,Native Hawaiian and Other Pacific Islander ,12,0,12,19,23,19
2019,Galax city,51640,Native Hawaiian and Other Pacific Islander ,0,0,0,17,17,17
2019,Hampton city,51650,Native Hawaiian and Other Pacific Islander ,73,61,12,45,39,19
2019,Harrisonburg city,51660,Native Hawaiian and Other Pacific Islander ,0,0,0,29,29,29
2019,Hopewell city,51670,Native Hawaiian and Other Pacific Islander ,0,0,0,23,23,23
2019,Lexington city,51678,Native Hawaiian and Other Pacific Islander ,0,0,0,17,17,17
2019,Lynchburg city,51680,Native Hawaiian and Other Pacific Islander ,0,0,0,29,29,29
2019,Manassas city,51683,Native Hawaiian and Other Pacific Islander ,56,0,56,68,26,68
2019,Manassas Park city,51685,Native Hawaiian and Other Pacific Islander ,0,0,0,19,19,19
2019,Martinsville city,51690,Native Hawaiian and Other Pacific Islander ,0,0,0,19,19,19
2019,Newport News city,51700,Native Hawaiian and Other Pacific Islander ,150,118,32,89,98,25
2019,Norfolk city,51710,Native Hawaiian and Other Pacific Islander ,71,44,27,54,48,25
2019,Norton city,51720,Native Hawaiian and Other Pacific Islander ,0,0,0,12,12,12
2019,Petersburg city,51730,Native Hawaiian and Other Pacific Islander ,0,0,0,26,26,26
2019,Poquoson city,51735,Native Hawaiian and Other Pacific Islander ,0,0,0,19,19,19
2019,Portsmouth city,51740,Native Hawaiian and Other Pacific Islander ,43,43,0,58,58,29
2019,Radford city,51750,Native Hawaiian and Other Pacific Islander ,4,0,4,9,19,9
2019,Richmond city,51760,Native Hawaiian and Other Pacific Islander ,6,0,6,9,29,9
2019,Roanoke city,51770,Native Hawaiian and Other Pacific Islander ,0,0,0,29,29,29
2019,Salem city,51775,Native Hawaiian and Other Pacific Islander ,0,0,0,23,23,23
2019,Staunton city,51790,Native Hawaiian and Other Pacific Islander ,0,0,0,23,23,23
2019,Suffolk city,51800,Native Hawaiian and Other Pacific Islander ,15,3,12,19,5,19
2019,Virginia Beach city,51810,Native Hawaiian and Other Pacific Islander ,137,107,30,90,83,24
2019,Waynesboro city,51820,Native Hawaiian and Other Pacific Islander ,0,0,0,23,23,23
2019,Williamsburg city,51830,Native Hawaiian and Other Pacific Islander ,0,0,0,19,19,19
2019,Winchester city,51840,Native Hawaiian and Other Pacific Islander ,0,0,0,23,23,23
2020,Accomack County,51001,Native Hawaiian and Other Pacific Islander ,0,0,0,27,27,27
2020,Albemarle County,51003,Native Hawaiian and Other Pacific Islander ,21,0,21,28,30,28
2020,Alleghany County,51005,Native Hawaiian and Other Pacific Islander ,0,0,0,20,20,20
2020,Amelia County,51007,Native Hawaiian and Other Pacific Islander ,0,0,0,20,20,20
2020,Amherst County,51009,Native Hawaiian and Other Pacific Islander ,12,12,0,18,18,27
2020,Appomattox County,51011,Native Hawaiian and Other Pacific Islander ,0,0,0,20,20,20
2020,Arlington County,51013,Native Hawaiian and Other Pacific Islander ,88,8,80,47,15,48
2020,Augusta County,51015,Native Hawaiian and Other Pacific Islander ,43,0,43,60,30,60
2020,Bath County,51017,Native Hawaiian and Other Pacific Islander ,0,0,0,13,13,13
2020,Bedford County,51019,Native Hawaiian and Other Pacific Islander ,0,0,0,30,30,30
2020,Bland County,51021,Native Hawaiian and Other Pacific Islander ,0,0,0,18,18,18
2020,Botetourt County,51023,Native Hawaiian and Other Pacific Islander ,0,0,0,27,27,27
2020,Brunswick County,51025,Native Hawaiian and Other Pacific Islander ,0,0,0,20,20,20
2020,Buchanan County,51027,Native Hawaiian and Other Pacific Islander ,0,0,0,24,24,24
2020,Buckingham County,51029,Native Hawaiian and Other Pacific Islander ,0,0,0,20,20,20
2020,Campbell County,51031,Native Hawaiian and Other Pacific Islander ,0,0,0,30,30,30
2020,Caroline County,51033,Native Hawaiian and Other Pacific Islander ,0,0,0,27,27,27
2020,Carroll County,51035,Native Hawaiian and Other Pacific Islander ,0,0,0,24,24,24
2020,Charles City County,51036,Native Hawaiian and Other Pacific Islander ,0,0,0,18,18,18
2020,Charlotte County,51037,Native Hawaiian and Other Pacific Islander ,0,0,0,20,20,20
2020,Chesterfield County,51041,Native Hawaiian and Other Pacific Islander ,61,44,17,54,39,31
2020,Clarke County,51043,Native Hawaiian and Other Pacific Islander ,0,0,0,20,20,20
2020,Craig County,51045,Native Hawaiian and Other Pacific Islander ,0,0,0,18,18,18
2020,Culpeper County,51047,Native Hawaiian and Other Pacific Islander ,0,0,0,30,30,30
2020,Cumberland County,51049,Native Hawaiian and Other Pacific Islander ,0,0,0,18,18,18
2020,Dickenson County,51051,Native Hawaiian and Other Pacific Islander ,0,0,0,20,20,20
2020,Dinwiddie County,51053,Native Hawaiian and Other Pacific Islander ,16,16,0,25,25,24
2020,Essex County,51057,Native Hawaiian and Other Pacific Islander ,0,0,0,20,20,20
2020,Fairfax County,51059,Native Hawaiian and Other Pacific Islander ,266,134,132,103,93,82
2020,Fauquier County,51061,Native Hawaiian and Other Pacific Islander ,10,10,0,17,17,30
2020,Floyd County,51063,Native Hawaiian and Other Pacific Islander ,0,0,0,20,20,20
2020,Fluvanna County,51065,Native Hawaiian and Other Pacific Islander ,0,0,0,24,24,24
2020,Franklin County,51067,Native Hawaiian and Other Pacific Islander ,0,0,0,30,30,30
2020,Frederick County,51069,Native Hawaiian and Other Pacific Islander ,7,0,7,11,30,11
2020,Giles County,51071,Native Hawaiian and Other Pacific Islander ,0,0,0,20,20,20
2020,Gloucester County,51073,Native Hawaiian and Other Pacific Islander ,0,0,0,27,27,27
2020,Goochland County,51075,Native Hawaiian and Other Pacific Islander ,0,0,0,24,24,24
2020,Grayson County,51077,Native Hawaiian and Other Pacific Islander ,0,0,0,20,20,20
2020,Greene County,51079,Native Hawaiian and Other Pacific Islander ,0,0,0,20,20,20
2020,Greensville County,51081,Native Hawaiian and Other Pacific Islander ,0,0,0,20,20,20
2020,Halifax County,51083,Native Hawaiian and Other Pacific Islander ,0,0,0,27,27,27
2020,Hanover County,51085,Native Hawaiian and Other Pacific Islander ,1,1,0,3,3,30
2020,Henrico County,51087,Native Hawaiian and Other Pacific Islander ,34,29,5,35,35,7
2020,Henry County,51089,Native Hawaiian and Other Pacific Islander ,0,0,0,30,30,30
2020,Highland County,51091,Native Hawaiian and Other Pacific Islander ,0,0,0,13,13,13
2020,Isle of Wight County,51093,Native Hawaiian and Other Pacific Islander ,0,0,0,27,27,27
2020,James City County,51095,Native Hawaiian and Other Pacific Islander ,0,0,0,30,30,30
2020,King and Queen County,51097,Native Hawaiian and Other Pacific Islander ,0,0,0,18,18,18
2020,King George County,51099,Native Hawaiian and Other Pacific Islander ,0,0,0,24,24,24
2020,King William County,51101,Native Hawaiian and Other Pacific Islander ,0,0,0,20,20,20
2020,Lancaster County,51103,Native Hawaiian and Other Pacific Islander ,0,0,0,20,20,20
2020,Lee County,51105,Native Hawaiian and Other Pacific Islander ,0,0,0,24,24,24
2020,Loudoun County,51107,Native Hawaiian and Other Pacific Islander ,77,45,32,29,26,21
2020,Louisa County,51109,Native Hawaiian and Other Pacific Islander ,0,0,0,27,27,27
2020,Lunenburg County,51111,Native Hawaiian and Other Pacific Islander ,0,0,0,20,20,20
2020,Madison County,51113,Native Hawaiian and Other Pacific Islander ,0,0,0,20,20,20
2020,Mathews County,51115,Native Hawaiian and Other Pacific Islander ,0,0,0,18,18,18
2020,Mecklenburg County,51117,Native Hawaiian and Other Pacific Islander ,4,4,0,6,6,27
2020,Middlesex County,51119,Native Hawaiian and Other Pacific Islander ,0,0,0,20,20,20
2020,Montgomery County,51121,Native Hawaiian and Other Pacific Islander ,26,0,26,31,30,31
2020,Nelson County,51125,Native Hawaiian and Other Pacific Islander ,0,0,0,20,20,20
2020,New Kent County,51127,Native Hawaiian and Other Pacific Islander ,0,0,0,24,24,24
2020,Northampton County,51131,Native Hawaiian and Other Pacific Islander ,0,0,0,20,20,20
2020,Northumberland County,51133,Native Hawaiian and Other Pacific Islander ,0,0,0,20,20,20
2020,Nottoway County,51135,Native Hawaiian and Other Pacific Islander ,0,0,0,20,20,20
2020,Orange County,51137,Native Hawaiian and Other Pacific Islander ,0,0,0,27,27,27
2020,Page County,51139,Native Hawaiian and Other Pacific Islander ,0,0,0,24,24,24
2020,Patrick County,51141,Native Hawaiian and Other Pacific Islander ,0,0,0,20,20,20
2020,Pittsylvania County,51143,Native Hawaiian and Other Pacific Islander ,0,0,0,30,30,30
2020,Powhatan County,51145,Native Hawaiian and Other Pacific Islander ,0,0,0,24,24,24
2020,Prince Edward County,51147,Native Hawaiian and Other Pacific Islander ,0,0,0,24,24,24
2020,Prince George County,51149,Native Hawaiian and Other Pacific Islander ,51,0,51,29,27,29
2020,Prince William County,51153,Native Hawaiian and Other Pacific Islander ,196,119,77,95,68,71
2020,Pulaski County,51155,Native Hawaiian and Other Pacific Islander ,48,0,48,65,27,65
2020,Rappahannock County,51157,Native Hawaiian and Other Pacific Islander ,0,0,0,18,18,18
2020,Richmond County,51159,Native Hawaiian and Other Pacific Islander ,0,0,0,18,18,18
2020,Roanoke County,51161,Native Hawaiian and Other Pacific Islander ,14,14,0,22,22,30
2020,Rockbridge County,51163,Native Hawaiian and Other Pacific Islander ,0,0,0,24,24,24
2020,Rockingham County,51165,Native Hawaiian and Other Pacific Islander ,20,20,0,24,24,30
2020,Russell County,51167,Native Hawaiian and Other Pacific Islander ,0,0,0,24,24,24
2020,Scott County,51169,Native Hawaiian and Other Pacific Islander ,0,0,0,24,24,24
2020,Shenandoah County,51171,Native Hawaiian and Other Pacific Islander ,0,0,0,27,27,27
2020,Smyth County,51173,Native Hawaiian and Other Pacific Islander ,15,0,15,26,27,26
2020,Southampton County,51175,Native Hawaiian and Other Pacific Islander ,0,0,0,20,20,20
2020,Spotsylvania County,51177,Native Hawaiian and Other Pacific Islander ,0,0,0,30,30,30
2020,Stafford County,51179,Native Hawaiian and Other Pacific Islander ,15,15,0,21,21,30
2020,Surry County,51181,Native Hawaiian and Other Pacific Islander ,0,0,0,18,18,18
2020,Sussex County,51183,Native Hawaiian and Other Pacific Islander ,0,0,0,20,20,20
2020,Tazewell County,51185,Native Hawaiian and Other Pacific Islander ,0,0,0,27,27,27
2020,Warren County,51187,Native Hawaiian and Other Pacific Islander ,0,0,0,27,27,27
2020,Washington County,51191,Native Hawaiian and Other Pacific Islander ,0,0,0,30,30,30
2020,Westmoreland County,51193,Native Hawaiian and Other Pacific Islander ,0,0,0,20,20,20
2020,Wise County,51195,Native Hawaiian and Other Pacific Islander ,14,0,14,20,27,20
2020,Wythe County,51197,Native Hawaiian and Other Pacific Islander ,0,0,0,24,24,24
2020,York County,51199,Native Hawaiian and Other Pacific Islander ,52,9,43,77,14,77
2020,Alexandria city,51510,Native Hawaiian and Other Pacific Islander ,6,0,6,11,30,11
2020,Bristol city,51520,Native Hawaiian and Other Pacific Islander ,5,0,5,11,20,11
2020,Buena Vista city,51530,Native Hawaiian and Other Pacific Islander ,0,0,0,18,18,18
2020,Charlottesville city,51540,Native Hawaiian and Other Pacific Islander ,0,0,0,27,27,27
2020,Chesapeake city,51550,Native Hawaiian and Other Pacific Islander ,23,18,5,43,39,9
2020,Colonial Heights city,51570,Native Hawaiian and Other Pacific Islander ,0,0,0,20,20,20
2020,Covington city,51580,Native Hawaiian and Other Pacific Islander ,0,0,0,18,18,18
2020,Danville city,51590,Native Hawaiian and Other Pacific Islander ,8,0,8,13,27,13
2020,Emporia city,51595,Native Hawaiian and Other Pacific Islander ,0,0,0,18,18,18
2020,Fairfax city,51600,Native Hawaiian and Other Pacific Islander ,0,0,0,24,24,24
2020,Falls Church city,51610,Native Hawaiian and Other Pacific Islander ,0,0,0,20,20,20
2020,Franklin city,51620,Native Hawaiian and Other Pacific Islander ,0,0,0,18,18,18
2020,Fredericksburg city,51630,Native Hawaiian and Other Pacific Islander ,17,0,17,28,24,28
2020,Galax city,51640,Native Hawaiian and Other Pacific Islander ,0,0,0,18,18,18
2020,Hampton city,51650,Native Hawaiian and Other Pacific Islander ,83,71,12,48,45,21
2020,Harrisonburg city,51660,Native Hawaiian and Other Pacific Islander ,0,0,0,30,30,30
2020,Hopewell city,51670,Native Hawaiian and Other Pacific Islander ,0,0,0,24,24,24
2020,Lexington city,51678,Native Hawaiian and Other Pacific Islander ,0,0,0,18,18,18
2020,Lynchburg city,51680,Native Hawaiian and Other Pacific Islander ,0,0,0,30,30,30
2020,Manassas city,51683,Native Hawaiian and Other Pacific Islander ,40,0,40,59,27,59
2020,Manassas Park city,51685,Native Hawaiian and Other Pacific Islander ,0,0,0,20,20,20
2020,Martinsville city,51690,Native Hawaiian and Other Pacific Islander ,0,0,0,20,20,20
2020,Newport News city,51700,Native Hawaiian and Other Pacific Islander ,124,101,23,118,111,27
2020,Norfolk city,51710,Native Hawaiian and Other Pacific Islander ,63,32,31,41,34,26
2020,Norton city,51720,Native Hawaiian and Other Pacific Islander ,0,0,0,13,13,13
2020,Petersburg city,51730,Native Hawaiian and Other Pacific Islander ,0,0,0,27,27,27
2020,Poquoson city,51735,Native Hawaiian and Other Pacific Islander ,0,0,0,20,20,20
2020,Portsmouth city,51740,Native Hawaiian and Other Pacific Islander ,43,43,0,55,55,30
2020,Radford city,51750,Native Hawaiian and Other Pacific Islander ,4,0,4,9,20,9
2020,Richmond city,51760,Native Hawaiian and Other Pacific Islander ,0,0,0,30,30,30
2020,Roanoke city,51770,Native Hawaiian and Other Pacific Islander ,16,16,0,25,25,30
2020,Salem city,51775,Native Hawaiian and Other Pacific Islander ,0,0,0,24,24,24
2020,Staunton city,51790,Native Hawaiian and Other Pacific Islander ,0,0,0,24,24,24
2020,Suffolk city,51800,Native Hawaiian and Other Pacific Islander ,9,3,6,13,5,13
2020,Virginia Beach city,51810,Native Hawaiian and Other Pacific Islander ,162,66,96,94,55,83
2020,Waynesboro city,51820,Native Hawaiian and Other Pacific Islander ,0,0,0,24,24,24
2020,Williamsburg city,51830,Native Hawaiian and Other Pacific Islander ,0,0,0,20,20,20
2020,Winchester city,51840,Native Hawaiian and Other Pacific Islander ,0,0,0,24,24,24
2021,Accomack County,51001,Native Hawaiian and Other Pacific Islander ,0,0,0,28,28,28
2021,Albemarle County,51003,Native Hawaiian and Other Pacific Islander ,0,0,0,31,31,31
2021,Alleghany County,51005,Native Hawaiian and Other Pacific Islander ,0,0,0,21,21,21
2021,Amelia County,51007,Native Hawaiian and Other Pacific Islander ,0,0,0,21,21,21
2021,Amherst County,51009,Native Hawaiian and Other Pacific Islander ,13,13,0,17,17,28
2021,Appomattox County,51011,Native Hawaiian and Other Pacific Islander ,0,0,0,21,21,21
2021,Arlington County,51013,Native Hawaiian and Other Pacific Islander ,62,7,55,66,10,65
2021,Augusta County,51015,Native Hawaiian and Other Pacific Islander ,42,0,42,58,31,58
2021,Bath County,51017,Native Hawaiian and Other Pacific Islander ,0,0,0,13,13,13
2021,Bedford County,51019,Native Hawaiian and Other Pacific Islander ,0,0,0,31,31,31
2021,Bland County,51021,Native Hawaiian and Other Pacific Islander ,0,0,0,19,19,19
2021,Botetourt County,51023,Native Hawaiian and Other Pacific Islander ,0,0,0,28,28,28
2021,Brunswick County,51025,Native Hawaiian and Other Pacific Islander ,0,0,0,21,21,21
2021,Buchanan County,51027,Native Hawaiian and Other Pacific Islander ,0,0,0,25,25,25
2021,Buckingham County,51029,Native Hawaiian and Other Pacific Islander ,0,0,0,21,21,21
2021,Campbell County,51031,Native Hawaiian and Other Pacific Islander ,0,0,0,31,31,31
2021,Caroline County,51033,Native Hawaiian and Other Pacific Islander ,0,0,0,28,28,28
2021,Carroll County,51035,Native Hawaiian and Other Pacific Islander ,0,0,0,25,25,25
2021,Charles City County,51036,Native Hawaiian and Other Pacific Islander ,0,0,0,19,19,19
2021,Charlotte County,51037,Native Hawaiian and Other Pacific Islander ,0,0,0,21,21,21
2021,Chesterfield County,51041,Native Hawaiian and Other Pacific Islander ,68,68,0,41,41,31
2021,Clarke County,51043,Native Hawaiian and Other Pacific Islander ,0,0,0,21,21,21
2021,Craig County,51045,Native Hawaiian and Other Pacific Islander ,0,0,0,13,13,13
2021,Culpeper County,51047,Native Hawaiian and Other Pacific Islander ,10,10,0,19,19,31
2021,Cumberland County,51049,Native Hawaiian and Other Pacific Islander ,0,0,0,19,19,19
2021,Dickenson County,51051,Native Hawaiian and Other Pacific Islander ,0,0,0,21,21,21
2021,Dinwiddie County,51053,Native Hawaiian and Other Pacific Islander ,15,15,0,23,23,25
2021,Essex County,51057,Native Hawaiian and Other Pacific Islander ,0,0,0,21,21,21
2021,Fairfax County,51059,Native Hawaiian and Other Pacific Islander ,277,82,195,96,52,89
2021,Fauquier County,51061,Native Hawaiian and Other Pacific Islander ,12,12,0,22,22,31
2021,Floyd County,51063,Native Hawaiian and Other Pacific Islander ,0,0,0,21,21,21
2021,Fluvanna County,51065,Native Hawaiian and Other Pacific Islander ,0,0,0,25,25,25
2021,Franklin County,51067,Native Hawaiian and Other Pacific Islander ,0,0,0,31,31,31
2021,Frederick County,51069,Native Hawaiian and Other Pacific Islander ,13,9,4,11,14,8
2021,Giles County,51071,Native Hawaiian and Other Pacific Islander ,11,11,0,21,21,21
2021,Gloucester County,51073,Native Hawaiian and Other Pacific Islander ,0,0,0,28,28,28
2021,Goochland County,51075,Native Hawaiian and Other Pacific Islander ,0,0,0,25,25,25
2021,Grayson County,51077,Native Hawaiian and Other Pacific Islander ,0,0,0,21,21,21
2021,Greene County,51079,Native Hawaiian and Other Pacific Islander ,16,16,0,29,29,25
2021,Greensville County,51081,Native Hawaiian and Other Pacific Islander ,0,0,0,21,21,21
2021,Halifax County,51083,Native Hawaiian and Other Pacific Islander ,0,0,0,28,28,28
2021,Hanover County,51085,Native Hawaiian and Other Pacific Islander ,5,5,0,8,8,31
2021,Henrico County,51087,Native Hawaiian and Other Pacific Islander ,63,54,9,53,59,14
2021,Henry County,51089,Native Hawaiian and Other Pacific Islander ,0,0,0,31,31,31
2021,Highland County,51091,Native Hawaiian and Other Pacific Islander ,0,0,0,13,13,13
2021,Isle of Wight County,51093,Native Hawaiian and Other Pacific Islander ,0,0,0,28,28,28
2021,James City County,51095,Native Hawaiian and Other Pacific Islander ,0,0,0,31,31,31
2021,King and Queen County,51097,Native Hawaiian and Other Pacific Islander ,0,0,0,19,19,19
2021,King George County,51099,Native Hawaiian and Other Pacific Islander ,0,0,0,25,25,25
2021,King William County,51101,Native Hawaiian and Other Pacific Islander ,7,7,0,15,15,21
2021,Lancaster County,51103,Native Hawaiian and Other Pacific Islander ,0,0,0,21,21,21
2021,Lee County,51105,Native Hawaiian and Other Pacific Islander ,0,0,0,25,25,25
2021,Loudoun County,51107,Native Hawaiian and Other Pacific Islander ,92,67,25,30,28,19
2021,Louisa County,51109,Native Hawaiian and Other Pacific Islander ,0,0,0,28,28,28
2021,Lunenburg County,51111,Native Hawaiian and Other Pacific Islander ,0,0,0,21,21,21
2021,Madison County,51113,Native Hawaiian and Other Pacific Islander ,0,0,0,21,21,21
2021,Mathews County,51115,Native Hawaiian and Other Pacific Islander ,0,0,0,19,19,19
2021,Mecklenburg County,51117,Native Hawaiian and Other Pacific Islander ,4,4,0,6,6,28
2021,Middlesex County,51119,Native Hawaiian and Other Pacific Islander ,0,0,0,21,21,21
2021,Montgomery County,51121,Native Hawaiian and Other Pacific Islander ,111,0,111,124,31,124
2021,Nelson County,51125,Native Hawaiian and Other Pacific Islander ,0,0,0,21,21,21
2021,New Kent County,51127,Native Hawaiian and Other Pacific Islander ,0,0,0,25,25,25
2021,Northampton County,51131,Native Hawaiian and Other Pacific Islander ,0,0,0,21,21,21
2021,Northumberland County,51133,Native Hawaiian and Other Pacific Islander ,0,0,0,21,21,21
2021,Nottoway County,51135,Native Hawaiian and Other Pacific Islander ,0,0,0,21,21,21
2021,Orange County,51137,Native Hawaiian and Other Pacific Islander ,0,0,0,28,28,28
2021,Page County,51139,Native Hawaiian and Other Pacific Islander ,0,0,0,25,25,25
2021,Patrick County,51141,Native Hawaiian and Other Pacific Islander ,0,0,0,21,21,21
2021,Pittsylvania County,51143,Native Hawaiian and Other Pacific Islander ,0,0,0,31,31,31
2021,Powhatan County,51145,Native Hawaiian and Other Pacific Islander ,0,0,0,25,25,25
2021,Prince Edward County,51147,Native Hawaiian and Other Pacific Islander ,38,0,38,55,25,55
2021,Prince George County,51149,Native Hawaiian and Other Pacific Islander ,48,0,48,24,28,24
2021,Prince William County,51153,Native Hawaiian and Other Pacific Islander ,165,153,12,92,93,22
2021,Pulaski County,51155,Native Hawaiian and Other Pacific Islander ,33,0,33,51,28,51
2021,Rappahannock County,51157,Native Hawaiian and Other Pacific Islander ,0,0,0,19,19,19
2021,Richmond County,51159,Native Hawaiian and Other Pacific Islander ,0,0,0,19,19,19
2021,Roanoke County,51161,Native Hawaiian and Other Pacific Islander ,18,18,0,29,29,31
2021,Rockbridge County,51163,Native Hawaiian and Other Pacific Islander ,0,0,0,25,25,25
2021,Rockingham County,51165,Native Hawaiian and Other Pacific Islander ,36,36,0,46,46,31
2021,Russell County,51167,Native Hawaiian and Other Pacific Islander ,0,0,0,25,25,25
2021,Scott County,51169,Native Hawaiian and Other Pacific Islander ,0,0,0,25,25,25
2021,Shenandoah County,51171,Native Hawaiian and Other Pacific Islander ,0,0,0,28,28,28
2021,Smyth County,51173,Native Hawaiian and Other Pacific Islander ,0,0,0,25,25,25
2021,Southampton County,51175,Native Hawaiian and Other Pacific Islander ,0,0,0,21,21,21
2021,Spotsylvania County,51177,Native Hawaiian and Other Pacific Islander ,0,0,0,31,31,31
2021,Stafford County,51179,Native Hawaiian and Other Pacific Islander ,16,10,6,25,23,10
2021,Surry County,51181,Native Hawaiian and Other Pacific Islander ,0,0,0,19,19,19
2021,Sussex County,51183,Native Hawaiian and Other Pacific Islander ,0,0,0,21,21,21
2021,Tazewell County,51185,Native Hawaiian and Other Pacific Islander ,0,0,0,28,28,28
2021,Warren County,51187,Native Hawaiian and Other Pacific Islander ,0,0,0,28,28,28
2021,Washington County,51191,Native Hawaiian and Other Pacific Islander ,0,0,0,31,31,31
2021,Westmoreland County,51193,Native Hawaiian and Other Pacific Islander ,0,0,0,21,21,21
2021,Wise County,51195,Native Hawaiian and Other Pacific Islander ,0,0,0,28,28,28
2021,Wythe County,51197,Native Hawaiian and Other Pacific Islander ,26,0,26,49,25,49
2021,York County,51199,Native Hawaiian and Other Pacific Islander ,8,8,0,13,13,31
2021,Alexandria city,51510,Native Hawaiian and Other Pacific Islander ,4,0,4,6,31,6
2021,Bristol city,51520,Native Hawaiian and Other Pacific Islander ,1,0,1,3,21,3
2021,Buena Vista city,51530,Native Hawaiian and Other Pacific Islander ,0,0,0,19,19,19
2021,Charlottesville city,51540,Native Hawaiian and Other Pacific Islander ,0,0,0,28,28,28
2021,Chesapeake city,51550,Native Hawaiian and Other Pacific Islander ,69,57,12,52,41,24
2021,Colonial Heights city,51570,Native Hawaiian and Other Pacific Islander ,0,0,0,21,21,21
2021,Covington city,51580,Native Hawaiian and Other Pacific Islander ,0,0,0,19,19,19
2021,Danville city,51590,Native Hawaiian and Other Pacific Islander ,8,0,8,12,28,12
2021,Emporia city,51595,Native Hawaiian and Other Pacific Islander ,0,0,0,19,19,19
2021,Fairfax city,51600,Native Hawaiian and Other Pacific Islander ,0,0,0,25,25,25
2021,Falls Church city,51610,Native Hawaiian and Other Pacific Islander ,0,0,0,21,21,21
2021,Franklin city,51620,Native Hawaiian and Other Pacific Islander ,0,0,0,19,19,19
2021,Fredericksburg city,51630,Native Hawaiian and Other Pacific Islander ,0,0,0,25,25,25
2021,Galax city,51640,Native Hawaiian and Other Pacific Islander ,0,0,0,19,19,19
2021,Hampton city,51650,Native Hawaiian and Other Pacific Islander ,45,34,11,42,40,18
2021,Harrisonburg city,51660,Native Hawaiian and Other Pacific Islander ,0,0,0,31,31,31
2021,Hopewell city,51670,Native Hawaiian and Other Pacific Islander ,0,0,0,25,25,25
2021,Lexington city,51678,Native Hawaiian and Other Pacific Islander ,0,0,0,19,19,19
2021,Lynchburg city,51680,Native Hawaiian and Other Pacific Islander ,0,0,0,31,31,31
2021,Manassas city,51683,Native Hawaiian and Other Pacific Islander ,0,0,0,28,28,28
2021,Manassas Park city,51685,Native Hawaiian and Other Pacific Islander ,0,0,0,21,21,21
2021,Martinsville city,51690,Native Hawaiian and Other Pacific Islander ,0,0,0,21,21,21
2021,Newport News city,51700,Native Hawaiian and Other Pacific Islander ,110,92,18,121,119,24
2021,Norfolk city,51710,Native Hawaiian and Other Pacific Islander ,53,29,24,40,31,25
2021,Norton city,51720,Native Hawaiian and Other Pacific Islander ,0,0,0,13,13,13
2021,Petersburg city,51730,Native Hawaiian and Other Pacific Islander ,11,11,0,18,18,28
2021,Poquoson city,51735,Native Hawaiian and Other Pacific Islander ,0,0,0,21,21,21
2021,Portsmouth city,51740,Native Hawaiian and Other Pacific Islander ,0,0,0,31,31,31
2021,Radford city,51750,Native Hawaiian and Other Pacific Islander ,5,0,5,13,21,13
2021,Richmond city,51760,Native Hawaiian and Other Pacific Islander ,0,0,0,31,31,31
2021,Roanoke city,51770,Native Hawaiian and Other Pacific Islander ,71,33,38,89,61,64
2021,Salem city,51775,Native Hawaiian and Other Pacific Islander ,0,0,0,25,25,25
2021,Staunton city,51790,Native Hawaiian and Other Pacific Islander ,0,0,0,25,25,25
2021,Suffolk city,51800,Native Hawaiian and Other Pacific Islander ,0,0,0,31,31,31
2021,Virginia Beach city,51810,Native Hawaiian and Other Pacific Islander ,191,85,106,95,64,92
2021,Waynesboro city,51820,Native Hawaiian and Other Pacific Islander ,0,0,0,25,25,25
2021,Williamsburg city,51830,Native Hawaiian and Other Pacific Islander ,0,0,0,21,21,21
2021,Winchester city,51840,Native Hawaiian and Other Pacific Islander ,0,0,0,25,25,25
2010,Accomack County,51001,Some Other Race ,187,29,158,107,39,109
2010,Albemarle County,51003,Some Other Race ,469,179,290,214,116,166
2010,Alleghany County,51005,Some Other Race ,0,0,0,127,127,127
2010,Amelia County,51007,Some Other Race ,25,0,25,38,127,38
2010,Amherst County,51009,Some Other Race ,69,49,20,80,74,32
2010,Appomattox County,51011,Some Other Race ,0,0,0,127,127,127
2010,Arlington County,51013,Some Other Race ,4329,968,3361,401,234,412
2010,Augusta County,51015,Some Other Race ,194,117,77,131,108,86
2010,Bath County,51017,Some Other Race ,0,0,0,127,127,127
2010,Bedford County,51019,Some Other Race ,120,71,49,83,54,67
2010,Bland County,51021,Some Other Race ,0,0,0,127,127,127
2010,Botetourt County,51023,Some Other Race ,0,0,0,127,127,127
2010,Brunswick County,51025,Some Other Race ,0,0,0,127,127,127
2010,Buchanan County,51027,Some Other Race ,0,0,0,127,127,127
2010,Buckingham County,51029,Some Other Race ,0,0,0,127,127,127
2010,Campbell County,51031,Some Other Race ,12,0,12,19,127,19
2010,Caroline County,51033,Some Other Race ,69,69,0,58,58,127
2010,Carroll County,51035,Some Other Race ,0,0,0,127,127,127
2010,Charles City County,51036,Some Other Race ,0,0,0,127,127,127
2010,Charlotte County,51037,Some Other Race ,12,0,12,21,127,21
2010,Chesterfield County,51041,Some Other Race ,1386,864,522,213,173,166
2010,Clarke County,51043,Some Other Race ,60,12,48,35,19,34
2010,Craig County,51045,Some Other Race ,0,0,0,127,127,127
2010,Culpeper County,51047,Some Other Race ,297,163,134,115,76,86
2010,Cumberland County,51049,Some Other Race ,0,0,0,127,127,127
2010,Dickenson County,51051,Some Other Race ,0,0,0,127,127,127
2010,Dinwiddie County,51053,Some Other Race ,15,15,0,23,23,127
2010,Essex County,51057,Some Other Race ,0,0,0,127,127,127
2010,Fairfax County,51059,Some Other Race ,13413,6970,6443,742,573,641
2010,Fauquier County,51061,Some Other Race ,211,185,26,101,94,30
2010,Floyd County,51063,Some Other Race ,0,0,0,127,127,127
2010,Fluvanna County,51065,Some Other Race ,90,70,20,62,51,36
2010,Franklin County,51067,Some Other Race ,99,17,82,85,28,79
2010,Frederick County,51069,Some Other Race ,291,204,87,189,123,97
2010,Giles County,51071,Some Other Race ,32,32,0,29,29,127
2010,Gloucester County,51073,Some Other Race ,52,52,0,46,46,127
2010,Goochland County,51075,Some Other Race ,92,5,87,62,8,62
2010,Grayson County,51077,Some Other Race ,0,0,0,127,127,127
2010,Greene County,51079,Some Other Race ,51,48,3,61,62,8
2010,Greensville County,51081,Some Other Race ,3,0,3,4,127,4
2010,Halifax County,51083,Some Other Race ,72,45,27,35,32,44
2010,Hanover County,51085,Some Other Race ,165,126,39,83,72,40
2010,Henrico County,51087,Some Other Race ,1197,433,764,243,143,204
2010,Henry County,51089,Some Other Race ,243,134,109,131,76,86
2010,Highland County,51091,Some Other Race ,0,0,0,127,127,127
2010,Isle of Wight County,51093,Some Other Race ,11,11,0,17,17,127
2010,James City County,51095,Some Other Race ,120,41,79,97,50,77
2010,King and Queen County,51097,Some Other Race ,0,0,0,127,127,127
2010,King George County,51099,Some Other Race ,4,0,4,8,127,8
2010,King William County,51101,Some Other Race ,43,43,0,43,43,127
2010,Lancaster County,51103,Some Other Race ,0,0,0,127,127,127
2010,Lee County,51105,Some Other Race ,0,0,0,127,127,127
2010,Loudoun County,51107,Some Other Race ,3223,2204,1019,405,359,222
2010,Louisa County,51109,Some Other Race ,23,0,23,30,127,30
2010,Lunenburg County,51111,Some Other Race ,28,0,28,26,127,26
2010,Madison County,51113,Some Other Race ,61,46,15,68,65,24
2010,Mathews County,51115,Some Other Race ,0,0,0,127,127,127
2010,Mecklenburg County,51117,Some Other Race ,28,11,17,28,13,28
2010,Middlesex County,51119,Some Other Race ,9,9,0,14,14,127
2010,Montgomery County,51121,Some Other Race ,219,30,189,89,33,85
2010,Nelson County,51125,Some Other Race ,67,49,18,50,55,25
2010,New Kent County,51127,Some Other Race ,12,9,3,15,14,5
2010,Northampton County,51131,Some Other Race ,0,0,0,127,127,127
2010,Northumberland County,51133,Some Other Race ,0,0,0,127,127,127
2010,Nottoway County,51135,Some Other Race ,35,17,18,24,25,14
2010,Orange County,51137,Some Other Race ,54,22,32,58,37,45
2010,Page County,51139,Some Other Race ,6,0,6,11,127,11
2010,Patrick County,51141,Some Other Race ,10,0,10,16,127,16
2010,Pittsylvania County,51143,Some Other Race ,91,57,34,112,68,58
2010,Powhatan County,51145,Some Other Race ,0,0,0,127,127,127
2010,Prince Edward County,51147,Some Other Race ,14,0,14,21,127,21
2010,Prince George County,51149,Some Other Race ,35,35,0,49,49,127
2010,Prince William County,51153,Some Other Race ,9020,5668,3352,615,509,474
2010,Pulaski County,51155,Some Other Race ,51,34,17,47,37,28
2010,Rappahannock County,51157,Some Other Race ,13,0,13,15,127,15
2010,Richmond County,51159,Some Other Race ,6,0,6,12,127,12
2010,Roanoke County,51161,Some Other Race ,139,109,30,82,68,42
2010,Rockbridge County,51163,Some Other Race ,5,0,5,8,127,8
2010,Rockingham County,51165,Some Other Race ,135,115,20,61,59,31
2010,Russell County,51167,Some Other Race ,0,0,0,127,127,127
2010,Scott County,51169,Some Other Race ,4,0,4,10,127,10
2010,Shenandoah County,51171,Some Other Race ,100,24,76,89,28,88
2010,Smyth County,51173,Some Other Race ,0,0,0,127,127,127
2010,Southampton County,51175,Some Other Race ,0,0,0,127,127,127
2010,Spotsylvania County,51177,Some Other Race ,860,718,142,173,183,101
2010,Stafford County,51179,Some Other Race ,1444,990,454,160,178,136
2010,Surry County,51181,Some Other Race ,0,0,0,127,127,127
2010,Sussex County,51183,Some Other Race ,8,0,8,13,127,13
2010,Tazewell County,51185,Some Other Race ,0,0,0,127,127,127
2010,Warren County,51187,Some Other Race ,30,30,0,32,32,127
2010,Washington County,51191,Some Other Race ,72,0,72,59,127,59
2010,Westmoreland County,51193,Some Other Race ,35,29,6,32,29,11
2010,Wise County,51195,Some Other Race ,32,0,32,22,127,22
2010,Wythe County,51197,Some Other Race ,0,0,0,127,127,127
2010,York County,51199,Some Other Race ,145,58,87,102,71,74
2010,Alexandria city,51510,Some Other Race ,1802,388,1414,288,151,280
2010,Bedford County,51019,Some Other Race ,0,0,0,127,127,127
2010,Bristol city,51520,Some Other Race ,0,0,0,127,127,127
2010,Buena Vista city,51530,Some Other Race ,0,0,0,127,127,127
2010,Charlottesville city,51540,Some Other Race ,164,15,149,91,23,90
2010,Chesapeake city,51550,Some Other Race ,788,434,354,214,170,169
2010,Colonial Heights city,51570,Some Other Race ,32,0,32,39,127,39
2010,Covington city,51580,Some Other Race ,0,0,0,127,127,127
2010,Danville city,51590,Some Other Race ,173,55,118,63,56,75
2010,Emporia city,51595,Some Other Race ,38,0,38,40,127,40
2010,Fairfax city,51600,Some Other Race ,234,144,90,108,84,71
2010,Falls Church city,51610,Some Other Race ,125,77,48,78,74,43
2010,Franklin city,51620,Some Other Race ,0,0,0,127,127,127
2010,Fredericksburg city,51630,Some Other Race ,326,33,293,124,43,111
2010,Galax city,51640,Some Other Race ,0,0,0,127,127,127
2010,Hampton city,51650,Some Other Race ,586,251,335,213,155,142
2010,Harrisonburg city,51660,Some Other Race ,239,95,144,128,66,107
2010,Hopewell city,51670,Some Other Race ,103,19,84,111,32,103
2010,Lexington city,51678,Some Other Race ,114,42,72,117,44,117
2010,Lynchburg city,51680,Some Other Race ,189,79,110,86,56,79
2010,Manassas city,51683,Some Other Race ,879,434,445,209,144,167
2010,Manassas Park city,51685,Some Other Race ,571,507,64,127,123,59
2010,Martinsville city,51690,Some Other Race ,81,14,67,56,23,51
2010,Newport News city,51700,Some Other Race ,961,359,602,232,176,199
2010,Norfolk city,51710,Some Other Race ,1153,178,975,252,93,225
2010,Norton city,51720,Some Other Race ,0,0,0,127,127,127
2010,Petersburg city,51730,Some Other Race ,10,10,0,17,17,127
2010,Poquoson city,51735,Some Other Race ,0,0,0,127,127,127
2010,Portsmouth city,51740,Some Other Race ,266,106,160,124,84,110
2010,Radford city,51750,Some Other Race ,49,0,49,37,127,37
2010,Richmond city,51760,Some Other Race ,974,277,697,221,128,186
2010,Roanoke city,51770,Some Other Race ,550,114,436,189,76,176
2010,Salem city,51775,Some Other Race ,45,0,45,49,127,49
2010,Staunton city,51790,Some Other Race ,13,13,0,23,23,127
2010,Suffolk city,51800,Some Other Race ,307,227,80,143,136,61
2010,Virginia Beach city,51810,Some Other Race ,1462,785,677,215,185,195
2010,Waynesboro city,51820,Some Other Race ,132,0,132,120,127,120
2010,Williamsburg city,51830,Some Other Race ,24,0,24,37,127,37
2010,Winchester city,51840,Some Other Race ,175,63,112,82,47,65
2011,Accomack County,51001,Some Other Race ,155,0,155,141,95,141
2011,Albemarle County,51003,Some Other Race ,255,93,162,96,73,81
2011,Alleghany County,51005,Some Other Race ,9,9,0,16,16,95
2011,Amelia County,51007,Some Other Race ,26,0,26,44,95,44
2011,Amherst County,51009,Some Other Race ,70,43,27,74,66,39
2011,Appomattox County,51011,Some Other Race ,0,0,0,95,95,95
2011,Arlington County,51013,Some Other Race ,4304,980,3324,456,253,454
2011,Augusta County,51015,Some Other Race ,166,80,86,89,79,58
2011,Bath County,51017,Some Other Race ,0,0,0,95,95,95
2011,Bedford County,51019,Some Other Race ,70,22,48,69,27,69
2011,Bland County,51021,Some Other Race ,0,0,0,95,95,95
2011,Botetourt County,51023,Some Other Race ,0,0,0,95,95,95
2011,Brunswick County,51025,Some Other Race ,0,0,0,95,95,95
2011,Buchanan County,51027,Some Other Race ,8,8,0,14,14,95
2011,Buckingham County,51029,Some Other Race ,0,0,0,95,95,95
2011,Campbell County,51031,Some Other Race ,11,0,11,17,95,17
2011,Caroline County,51033,Some Other Race ,73,73,0,43,43,95
2011,Carroll County,51035,Some Other Race ,0,0,0,95,95,95
2011,Charles City County,51036,Some Other Race ,1,1,0,2,2,95
2011,Charlotte County,51037,Some Other Race ,6,0,6,10,95,10
2011,Chesterfield County,51041,Some Other Race ,1327,708,619,264,203,193
2011,Clarke County,51043,Some Other Race ,53,19,34,32,22,28
2011,Craig County,51045,Some Other Race ,0,0,0,95,95,95
2011,Culpeper County,51047,Some Other Race ,314,146,168,161,105,127
2011,Cumberland County,51049,Some Other Race ,0,0,0,95,95,95
2011,Dickenson County,51051,Some Other Race ,0,0,0,95,95,95
2011,Dinwiddie County,51053,Some Other Race ,37,37,0,36,36,95
2011,Essex County,51057,Some Other Race ,0,0,0,95,95,95
2011,Fairfax County,51059,Some Other Race ,12912,6362,6550,798,625,691
2011,Fauquier County,51061,Some Other Race ,145,126,19,83,77,30
2011,Floyd County,51063,Some Other Race ,0,0,0,95,95,95
2011,Fluvanna County,51065,Some Other Race ,76,55,21,72,61,36
2011,Franklin County,51067,Some Other Race ,46,14,32,41,23,35
2011,Frederick County,51069,Some Other Race ,308,231,77,201,184,82
2011,Giles County,51071,Some Other Race ,21,21,0,22,22,95
2011,Gloucester County,51073,Some Other Race ,33,33,0,40,40,95
2011,Goochland County,51075,Some Other Race ,10,10,0,16,16,95
2011,Grayson County,51077,Some Other Race ,0,0,0,95,95,95
2011,Greene County,51079,Some Other Race ,54,50,4,71,71,6
2011,Greensville County,51081,Some Other Race ,8,0,8,16,95,16
2011,Halifax County,51083,Some Other Race ,80,51,29,30,25,41
2011,Hanover County,51085,Some Other Race ,214,177,37,97,88,38
2011,Henrico County,51087,Some Other Race ,980,302,678,202,111,187
2011,Henry County,51089,Some Other Race ,166,79,87,95,54,73
2011,Highland County,51091,Some Other Race ,0,0,0,95,95,95
2011,Isle of Wight County,51093,Some Other Race ,5,0,5,9,95,9
2011,James City County,51095,Some Other Race ,155,19,136,96,32,97
2011,King and Queen County,51097,Some Other Race ,0,0,0,95,95,95
2011,King George County,51099,Some Other Race ,13,8,5,17,13,10
2011,King William County,51101,Some Other Race ,62,62,0,76,76,95
2011,Lancaster County,51103,Some Other Race ,0,0,0,95,95,95
2011,Lee County,51105,Some Other Race ,0,0,0,95,95,95
2011,Loudoun County,51107,Some Other Race ,2678,1607,1071,369,301,290
2011,Louisa County,51109,Some Other Race ,63,35,28,56,51,35
2011,Lunenburg County,51111,Some Other Race ,23,0,23,32,95,32
2011,Madison County,51113,Some Other Race ,59,42,17,70,61,27
2011,Mathews County,51115,Some Other Race ,0,0,0,95,95,95
2011,Mecklenburg County,51117,Some Other Race ,31,7,24,36,16,33
2011,Middlesex County,51119,Some Other Race ,7,7,0,11,11,95
2011,Montgomery County,51121,Some Other Race ,184,23,161,98,27,94
2011,Nelson County,51125,Some Other Race ,0,0,0,95,95,95
2011,New Kent County,51127,Some Other Race ,20,18,2,23,22,4
2011,Northampton County,51131,Some Other Race ,0,0,0,95,95,95
2011,Northumberland County,51133,Some Other Race ,0,0,0,95,95,95
2011,Nottoway County,51135,Some Other Race ,52,25,27,31,28,12
2011,Orange County,51137,Some Other Race ,84,42,42,53,58,55
2011,Page County,51139,Some Other Race ,6,0,6,9,95,9
2011,Patrick County,51141,Some Other Race ,7,0,7,9,95,9
2011,Pittsylvania County,51143,Some Other Race ,146,89,57,66,69,40
2011,Powhatan County,51145,Some Other Race ,0,0,0,95,95,95
2011,Prince Edward County,51147,Some Other Race ,30,0,30,46,95,46
2011,Prince George County,51149,Some Other Race ,71,67,4,54,54,7
2011,Prince William County,51153,Some Other Race ,8182,5049,3133,633,511,438
2011,Pulaski County,51155,Some Other Race ,36,36,0,33,33,95
2011,Rappahannock County,51157,Some Other Race ,20,0,20,26,95,26
2011,Richmond County,51159,Some Other Race ,5,0,5,9,95,9
2011,Roanoke County,51161,Some Other Race ,158,138,20,88,82,34
2011,Rockbridge County,51163,Some Other Race ,3,0,3,8,95,8
2011,Rockingham County,51165,Some Other Race ,119,95,24,74,62,40
2011,Russell County,51167,Some Other Race ,0,0,0,95,95,95
2011,Scott County,51169,Some Other Race ,2,0,2,6,95,6
2011,Shenandoah County,51171,Some Other Race ,69,26,43,52,26,44
2011,Smyth County,51173,Some Other Race ,0,0,0,95,95,95
2011,Southampton County,51175,Some Other Race ,0,0,0,95,95,95
2011,Spotsylvania County,51177,Some Other Race ,905,733,172,195,192,109
2011,Stafford County,51179,Some Other Race ,1513,938,575,174,172,179
2011,Surry County,51181,Some Other Race ,8,0,8,7,95,7
2011,Sussex County,51183,Some Other Race ,0,0,0,95,95,95
2011,Tazewell County,51185,Some Other Race ,0,0,0,95,95,95
2011,Warren County,51187,Some Other Race ,29,29,0,28,28,95
2011,Washington County,51191,Some Other Race ,117,0,117,85,95,85
2011,Westmoreland County,51193,Some Other Race ,36,26,10,28,30,17
2011,Wise County,51195,Some Other Race ,21,0,21,19,95,19
2011,Wythe County,51197,Some Other Race ,0,0,0,95,95,95
2011,York County,51199,Some Other Race ,171,63,108,95,51,83
2011,Alexandria city,51510,Some Other Race ,1701,408,1293,294,180,222
2011,Bedford County,51019,Some Other Race ,0,0,0,95,95,95
2011,Bristol city,51520,Some Other Race ,0,0,0,95,95,95
2011,Buena Vista city,51530,Some Other Race ,0,0,0,95,95,95
2011,Charlottesville city,51540,Some Other Race ,137,19,118,55,28,54
2011,Chesapeake city,51550,Some Other Race ,785,444,341,193,160,168
2011,Colonial Heights city,51570,Some Other Race ,40,0,40,55,95,55
2011,Covington city,51580,Some Other Race ,0,0,0,95,95,95
2011,Danville city,51590,Some Other Race ,173,47,126,72,42,76
2011,Emporia city,51595,Some Other Race ,44,0,44,55,95,55
2011,Fairfax city,51600,Some Other Race ,183,84,99,105,59,71
2011,Falls Church city,51610,Some Other Race ,105,38,67,57,32,52
2011,Franklin city,51620,Some Other Race ,3,3,0,8,8,95
2011,Fredericksburg city,51630,Some Other Race ,424,36,388,142,47,141
2011,Galax city,51640,Some Other Race ,0,0,0,95,95,95
2011,Hampton city,51650,Some Other Race ,502,217,285,175,115,139
2011,Harrisonburg city,51660,Some Other Race ,195,85,110,95,59,72
2011,Hopewell city,51670,Some Other Race ,184,38,146,140,55,129
2011,Lexington city,51678,Some Other Race ,89,36,53,93,46,82
2011,Lynchburg city,51680,Some Other Race ,190,43,147,119,47,115
2011,Manassas city,51683,Some Other Race ,526,276,250,201,152,114
2011,Manassas Park city,51685,Some Other Race ,490,420,70,119,110,60
2011,Martinsville city,51690,Some Other Race ,71,10,61,49,15,47
2011,Newport News city,51700,Some Other Race ,837,324,513,228,148,166
2011,Norfolk city,51710,Some Other Race ,1117,238,879,269,125,263
2011,Norton city,51720,Some Other Race ,0,0,0,95,95,95
2011,Petersburg city,51730,Some Other Race ,12,12,0,19,19,95
2011,Poquoson city,51735,Some Other Race ,0,0,0,95,95,95
2011,Portsmouth city,51740,Some Other Race ,338,125,213,128,103,119
2011,Radford city,51750,Some Other Race ,40,0,40,51,95,51
2011,Richmond city,51760,Some Other Race ,872,225,647,203,98,178
2011,Roanoke city,51770,Some Other Race ,569,106,463,201,60,202
2011,Salem city,51775,Some Other Race ,43,0,43,51,95,51
2011,Staunton city,51790,Some Other Race ,70,39,31,78,50,55
2011,Suffolk city,51800,Some Other Race ,214,117,97,98,91,73
2011,Virginia Beach city,51810,Some Other Race ,1535,712,823,311,186,262
2011,Waynesboro city,51820,Some Other Race ,107,0,107,119,95,119
2011,Williamsburg city,51830,Some Other Race ,106,0,106,112,95,112
2011,Winchester city,51840,Some Other Race ,86,47,39,57,42,33
2012,Accomack County,51001,Some Other Race ,89,0,89,81,26,81
2012,Albemarle County,51003,Some Other Race ,290,97,193,126,65,107
2012,Alleghany County,51005,Some Other Race ,9,9,0,13,13,19
2012,Amelia County,51007,Some Other Race ,0,0,0,19,19,19
2012,Amherst County,51009,Some Other Race ,51,39,12,63,59,19
2012,Appomattox County,51011,Some Other Race ,0,0,0,19,19,19
2012,Arlington County,51013,Some Other Race ,3754,997,2757,374,262,328
2012,Augusta County,51015,Some Other Race ,134,31,103,78,35,78
2012,Bath County,51017,Some Other Race ,0,0,0,12,12,12
2012,Bedford County,51019,Some Other Race ,0,0,0,29,29,29
2012,Bland County,51021,Some Other Race ,0,0,0,17,17,17
2012,Botetourt County,51023,Some Other Race ,6,6,0,10,10,26
2012,Brunswick County,51025,Some Other Race ,7,0,7,15,19,15
2012,Buchanan County,51027,Some Other Race ,11,11,0,18,18,23
2012,Buckingham County,51029,Some Other Race ,0,0,0,19,19,19
2012,Campbell County,51031,Some Other Race ,34,26,8,44,41,15
2012,Caroline County,51033,Some Other Race ,51,51,0,44,44,23
2012,Carroll County,51035,Some Other Race ,0,0,0,23,23,23
2012,Charles City County,51036,Some Other Race ,3,3,0,6,6,17
2012,Charlotte County,51037,Some Other Race ,9,0,9,14,19,14
2012,Chesterfield County,51041,Some Other Race ,1395,801,594,257,222,165
2012,Clarke County,51043,Some Other Race ,31,21,10,26,24,15
2012,Craig County,51045,Some Other Race ,0,0,0,17,17,17
2012,Culpeper County,51047,Some Other Race ,247,130,117,132,88,90
2012,Cumberland County,51049,Some Other Race ,0,0,0,17,17,17
2012,Dickenson County,51051,Some Other Race ,0,0,0,19,19,19
2012,Dinwiddie County,51053,Some Other Race ,36,36,0,35,35,23
2012,Essex County,51057,Some Other Race ,5,5,0,10,10,19
2012,Fairfax County,51059,Some Other Race ,13089,5618,7471,745,575,707
2012,Fauquier County,51061,Some Other Race ,139,118,21,92,87,31
2012,Floyd County,51063,Some Other Race ,0,0,0,19,19,19
2012,Fluvanna County,51065,Some Other Race ,8,8,0,11,11,23
2012,Franklin County,51067,Some Other Race ,14,14,0,24,24,29
2012,Frederick County,51069,Some Other Race ,359,245,114,223,198,91
2012,Giles County,51071,Some Other Race ,9,9,0,16,16,19
2012,Gloucester County,51073,Some Other Race ,32,32,0,35,35,26
2012,Goochland County,51075,Some Other Race ,0,0,0,23,23,23
2012,Grayson County,51077,Some Other Race ,0,0,0,19,19,19
2012,Greene County,51079,Some Other Race ,27,27,0,44,44,19
2012,Greensville County,51081,Some Other Race ,4,0,4,5,19,5
2012,Halifax County,51083,Some Other Race ,89,57,32,50,27,40
2012,Hanover County,51085,Some Other Race ,210,161,49,100,98,45
2012,Henrico County,51087,Some Other Race ,1057,337,720,236,125,187
2012,Henry County,51089,Some Other Race ,151,61,90,72,40,64
2012,Highland County,51091,Some Other Race ,0,0,0,12,12,12
2012,Isle of Wight County,51093,Some Other Race ,4,0,4,7,26,7
2012,James City County,51095,Some Other Race ,79,11,68,60,22,60
2012,King and Queen County,51097,Some Other Race ,8,8,0,15,15,17
2012,King George County,51099,Some Other Race ,12,7,5,14,11,9
2012,King William County,51101,Some Other Race ,34,34,0,34,34,19
2012,Lancaster County,51103,Some Other Race ,0,0,0,19,19,19
2012,Lee County,51105,Some Other Race ,0,0,0,23,23,23
2012,Loudoun County,51107,Some Other Race ,3028,1543,1485,416,279,302
2012,Louisa County,51109,Some Other Race ,65,34,31,54,35,46
2012,Lunenburg County,51111,Some Other Race ,31,6,25,22,7,21
2012,Madison County,51113,Some Other Race ,15,0,15,26,19,26
2012,Mathews County,51115,Some Other Race ,0,0,0,17,17,17
2012,Mecklenburg County,51117,Some Other Race ,73,53,20,40,35,22
2012,Middlesex County,51119,Some Other Race ,5,5,0,10,10,19
2012,Montgomery County,51121,Some Other Race ,262,22,240,104,28,105
2012,Nelson County,51125,Some Other Race ,0,0,0,19,19,19
2012,New Kent County,51127,Some Other Race ,23,23,0,26,26,19
2012,Northampton County,51131,Some Other Race ,19,17,2,28,28,3
2012,Northumberland County,51133,Some Other Race ,0,0,0,19,19,19
2012,Nottoway County,51135,Some Other Race ,58,45,13,61,52,25
2012,Orange County,51137,Some Other Race ,79,52,27,51,53,46
2012,Page County,51139,Some Other Race ,7,0,7,8,23,8
2012,Patrick County,51141,Some Other Race ,0,0,0,19,19,19
2012,Pittsylvania County,51143,Some Other Race ,110,82,28,84,67,37
2012,Powhatan County,51145,Some Other Race ,0,0,0,23,23,23
2012,Prince Edward County,51147,Some Other Race ,41,0,41,56,23,56
2012,Prince George County,51149,Some Other Race ,110,58,52,80,54,64
2012,Prince William County,51153,Some Other Race ,6816,3923,2893,606,502,425
2012,Pulaski County,51155,Some Other Race ,24,24,0,29,29,26
2012,Rappahannock County,51157,Some Other Race ,0,0,0,17,17,17
2012,Richmond County,51159,Some Other Race ,6,0,6,8,17,8
2012,Roanoke County,51161,Some Other Race ,120,120,0,74,74,29
2012,Rockbridge County,51163,Some Other Race ,4,0,4,9,23,9
2012,Rockingham County,51165,Some Other Race ,126,107,19,64,60,29
2012,Russell County,51167,Some Other Race ,42,0,42,85,23,85
2012,Scott County,51169,Some Other Race ,0,0,0,23,23,23
2012,Shenandoah County,51171,Some Other Race ,87,39,48,54,36,43
2012,Smyth County,51173,Some Other Race ,0,0,0,26,26,26
2012,Southampton County,51175,Some Other Race ,6,0,6,8,19,8
2012,Spotsylvania County,51177,Some Other Race ,1067,793,274,178,187,144
2012,Stafford County,51179,Some Other Race ,1583,899,684,217,181,188
2012,Surry County,51181,Some Other Race ,8,0,8,7,17,7
2012,Sussex County,51183,Some Other Race ,2,0,2,7,19,7
2012,Tazewell County,51185,Some Other Race ,0,0,0,26,26,26
2012,Warren County,51187,Some Other Race ,38,38,0,39,39,26
2012,Washington County,51191,Some Other Race ,34,0,34,44,29,44
2012,Westmoreland County,51193,Some Other Race ,20,16,4,25,24,8
2012,Wise County,51195,Some Other Race ,11,0,11,11,26,11
2012,Wythe County,51197,Some Other Race ,0,0,0,23,23,23
2012,York County,51199,Some Other Race ,110,90,20,70,61,36
2012,Alexandria city,51510,Some Other Race ,1683,355,1328,293,156,262
2012,Bedford County,51019,Some Other Race ,0,0,0,17,17,17
2012,Bristol city,51520,Some Other Race ,0,0,0,19,19,19
2012,Buena Vista city,51530,Some Other Race ,0,0,0,17,17,17
2012,Charlottesville city,51540,Some Other Race ,115,38,77,66,39,67
2012,Chesapeake city,51550,Some Other Race ,757,338,419,194,122,183
2012,Colonial Heights city,51570,Some Other Race ,26,0,26,33,19,33
2012,Covington city,51580,Some Other Race ,0,0,0,17,17,17
2012,Danville city,51590,Some Other Race ,142,48,94,59,39,60
2012,Emporia city,51595,Some Other Race ,41,0,41,37,17,37
2012,Fairfax city,51600,Some Other Race ,173,62,111,108,44,95
2012,Falls Church city,51610,Some Other Race ,106,70,36,50,36,38
2012,Franklin city,51620,Some Other Race ,15,15,0,27,27,17
2012,Fredericksburg city,51630,Some Other Race ,398,43,355,162,66,148
2012,Galax city,51640,Some Other Race ,0,0,0,17,17,17
2012,Hampton city,51650,Some Other Race ,348,141,207,129,87,113
2012,Harrisonburg city,51660,Some Other Race ,174,34,140,90,36,88
2012,Hopewell city,51670,Some Other Race ,125,31,94,103,41,97
2012,Lexington city,51678,Some Other Race ,54,19,35,62,27,58
2012,Lynchburg city,51680,Some Other Race ,175,14,161,122,18,119
2012,Manassas city,51683,Some Other Race ,336,173,163,132,100,80
2012,Manassas Park city,51685,Some Other Race ,335,323,12,140,144,22
2012,Martinsville city,51690,Some Other Race ,69,10,59,60,17,56
2012,Newport News city,51700,Some Other Race ,825,342,483,181,130,150
2012,Norfolk city,51710,Some Other Race ,1210,242,968,290,92,267
2012,Norton city,51720,Some Other Race ,19,0,19,31,12,31
2012,Petersburg city,51730,Some Other Race ,0,0,0,26,26,26
2012,Poquoson city,51735,Some Other Race ,0,0,0,19,19,19
2012,Portsmouth city,51740,Some Other Race ,297,118,179,144,100,113
2012,Radford city,51750,Some Other Race ,26,0,26,31,19,31
2012,Richmond city,51760,Some Other Race ,855,156,699,202,61,188
2012,Roanoke city,51770,Some Other Race ,474,91,383,198,58,187
2012,Salem city,51775,Some Other Race ,71,24,47,68,33,64
2012,Staunton city,51790,Some Other Race ,41,16,25,45,28,33
2012,Suffolk city,51800,Some Other Race ,136,60,76,85,70,57
2012,Virginia Beach city,51810,Some Other Race ,1410,686,724,270,180,207
2012,Waynesboro city,51820,Some Other Race ,104,25,79,104,46,103
2012,Williamsburg city,51830,Some Other Race ,75,0,75,92,19,92
2012,Winchester city,51840,Some Other Race ,95,45,50,61,44,42
2013,Accomack County,51001,Some Other Race ,101,0,101,104,26,104
2013,Albemarle County,51003,Some Other Race ,279,92,187,131,58,113
2013,Alleghany County,51005,Some Other Race ,5,5,0,10,10,19
2013,Amelia County,51007,Some Other Race ,0,0,0,19,19,19
2013,Amherst County,51009,Some Other Race ,42,0,42,39,26,39
2013,Appomattox County,51011,Some Other Race ,0,0,0,19,19,19
2013,Arlington County,51013,Some Other Race ,3932,959,2973,486,222,428
2013,Augusta County,51015,Some Other Race ,115,14,101,71,16,74
2013,Bath County,51017,Some Other Race ,0,0,0,12,12,12
2013,Bedford County,51019,Some Other Race ,0,0,0,29,29,29
2013,Bland County,51021,Some Other Race ,0,0,0,17,17,17
2013,Botetourt County,51023,Some Other Race ,8,8,0,9,9,26
2013,Brunswick County,51025,Some Other Race ,6,0,6,15,19,15
2013,Buchanan County,51027,Some Other Race ,9,9,0,14,14,23
2013,Buckingham County,51029,Some Other Race ,33,33,0,44,44,19
2013,Campbell County,51031,Some Other Race ,32,22,10,38,35,16
2013,Caroline County,51033,Some Other Race ,52,52,0,42,42,23
2013,Carroll County,51035,Some Other Race ,5,5,0,12,12,23
2013,Charles City County,51036,Some Other Race ,5,5,0,6,6,17
2013,Charlotte County,51037,Some Other Race ,6,0,6,9,19,9
2013,Chesterfield County,51041,Some Other Race ,1912,1071,841,345,290,197
2013,Clarke County,51043,Some Other Race ,19,19,0,27,27,19
2013,Craig County,51045,Some Other Race ,0,0,0,17,17,17
2013,Culpeper County,51047,Some Other Race ,212,82,130,128,69,95
2013,Cumberland County,51049,Some Other Race ,0,0,0,17,17,17
2013,Dickenson County,51051,Some Other Race ,0,0,0,19,19,19
2013,Dinwiddie County,51053,Some Other Race ,27,27,0,35,35,23
2013,Essex County,51057,Some Other Race ,4,4,0,8,8,19
2013,Fairfax County,51059,Some Other Race ,12968,5201,7767,872,490,700
2013,Fauquier County,51061,Some Other Race ,126,91,35,67,55,36
2013,Floyd County,51063,Some Other Race ,0,0,0,19,19,19
2013,Fluvanna County,51065,Some Other Race ,60,60,0,74,74,23
2013,Franklin County,51067,Some Other Race ,74,56,18,70,66,30
2013,Frederick County,51069,Some Other Race ,400,258,142,202,195,74
2013,Giles County,51071,Some Other Race ,6,6,0,12,12,19
2013,Gloucester County,51073,Some Other Race ,50,50,0,48,48,26
2013,Goochland County,51075,Some Other Race ,26,26,0,45,45,23
2013,Grayson County,51077,Some Other Race ,0,0,0,19,19,19
2013,Greene County,51079,Some Other Race ,91,41,50,70,39,61
2013,Greensville County,51081,Some Other Race ,0,0,0,19,19,19
2013,Halifax County,51083,Some Other Race ,81,49,32,38,26,47
2013,Hanover County,51085,Some Other Race ,170,132,38,91,83,37
2013,Henrico County,51087,Some Other Race ,1108,335,773,264,127,218
2013,Henry County,51089,Some Other Race ,177,106,71,81,66,56
2013,Highland County,51091,Some Other Race ,0,0,0,12,12,12
2013,Isle of Wight County,51093,Some Other Race ,10,0,10,12,26,12
2013,James City County,51095,Some Other Race ,110,48,62,105,52,85
2013,King and Queen County,51097,Some Other Race ,12,12,0,24,24,17
2013,King George County,51099,Some Other Race ,27,22,5,26,23,10
2013,King William County,51101,Some Other Race ,9,9,0,14,14,19
2013,Lancaster County,51103,Some Other Race ,0,0,0,19,19,19
2013,Lee County,51105,Some Other Race ,0,0,0,23,23,23
2013,Loudoun County,51107,Some Other Race ,2901,1345,1556,395,301,390
2013,Louisa County,51109,Some Other Race ,93,54,39,59,55,45
2013,Lunenburg County,51111,Some Other Race ,34,7,27,27,8,25
2013,Madison County,51113,Some Other Race ,19,0,19,30,19,30
2013,Mathews County,51115,Some Other Race ,0,0,0,17,17,17
2013,Mecklenburg County,51117,Some Other Race ,74,55,19,37,36,22
2013,Middlesex County,51119,Some Other Race ,5,5,0,8,8,19
2013,Montgomery County,51121,Some Other Race ,233,13,220,133,21,132
2013,Nelson County,51125,Some Other Race ,0,0,0,19,19,19
2013,New Kent County,51127,Some Other Race ,13,13,0,21,21,19
2013,Northampton County,51131,Some Other Race ,18,16,2,25,24,3
2013,Northumberland County,51133,Some Other Race ,0,0,0,19,19,19
2013,Nottoway County,51135,Some Other Race ,80,65,15,63,60,26
2013,Orange County,51137,Some Other Race ,69,58,11,40,39,20
2013,Page County,51139,Some Other Race ,6,0,6,11,23,11
2013,Patrick County,51141,Some Other Race ,0,0,0,19,19,19
2013,Pittsylvania County,51143,Some Other Race ,91,76,15,65,63,29
2013,Powhatan County,51145,Some Other Race ,0,0,0,23,23,23
2013,Prince Edward County,51147,Some Other Race ,0,0,0,23,23,23
2013,Prince George County,51149,Some Other Race ,230,60,170,99,50,110
2013,Prince William County,51153,Some Other Race ,5666,3469,2197,505,394,356
2013,Pulaski County,51155,Some Other Race ,22,22,0,26,26,26
2013,Rappahannock County,51157,Some Other Race ,0,0,0,17,17,17
2013,Richmond County,51159,Some Other Race ,8,0,8,12,17,12
2013,Roanoke County,51161,Some Other Race ,90,90,0,50,50,29
2013,Rockbridge County,51163,Some Other Race ,31,12,19,21,17,21
2013,Rockingham County,51165,Some Other Race ,187,104,83,69,70,79
2013,Russell County,51167,Some Other Race ,19,0,19,36,23,36
2013,Scott County,51169,Some Other Race ,0,0,0,23,23,23
2013,Shenandoah County,51171,Some Other Race ,85,42,43,51,41,31
2013,Smyth County,51173,Some Other Race ,0,0,0,26,26,26
2013,Southampton County,51175,Some Other Race ,9,0,9,13,19,13
2013,Spotsylvania County,51177,Some Other Race ,1092,655,437,171,158,163
2013,Stafford County,51179,Some Other Race ,1659,816,843,217,181,230
2013,Surry County,51181,Some Other Race ,11,0,11,7,17,7
2013,Sussex County,51183,Some Other Race ,8,3,5,15,7,12
2013,Tazewell County,51185,Some Other Race ,0,0,0,26,26,26
2013,Warren County,51187,Some Other Race ,47,47,0,43,43,26
2013,Washington County,51191,Some Other Race ,53,26,27,58,41,42
2013,Westmoreland County,51193,Some Other Race ,5,0,5,13,19,13
2013,Wise County,51195,Some Other Race ,21,11,10,17,12,12
2013,Wythe County,51197,Some Other Race ,0,0,0,23,23,23
2013,York County,51199,Some Other Race ,78,65,13,47,43,20
2013,Alexandria city,51510,Some Other Race ,1516,331,1185,268,135,248
2013,Bedford County,51019,Some Other Race ,0,0,0,17,17,17
2013,Bristol city,51520,Some Other Race ,0,0,0,19,19,19
2013,Buena Vista city,51530,Some Other Race ,0,0,0,17,17,17
2013,Charlottesville city,51540,Some Other Race ,82,26,56,58,30,52
2013,Chesapeake city,51550,Some Other Race ,504,247,257,151,115,116
2013,Colonial Heights city,51570,Some Other Race ,62,55,7,61,59,14
2013,Covington city,51580,Some Other Race ,0,0,0,17,17,17
2013,Danville city,51590,Some Other Race ,156,48,108,66,32,63
2013,Emporia city,51595,Some Other Race ,21,0,21,31,17,31
2013,Fairfax city,51600,Some Other Race ,269,60,209,125,43,118
2013,Falls Church city,51610,Some Other Race ,116,65,51,56,46,40
2013,Franklin city,51620,Some Other Race ,13,13,0,22,22,17
2013,Fredericksburg city,51630,Some Other Race ,303,49,254,128,75,107
2013,Galax city,51640,Some Other Race ,0,0,0,17,17,17
2013,Hampton city,51650,Some Other Race ,369,152,217,128,95,95
2013,Harrisonburg city,51660,Some Other Race ,156,39,117,101,35,94
2013,Hopewell city,51670,Some Other Race ,266,144,122,153,115,108
2013,Lexington city,51678,Some Other Race ,37,0,37,60,17,60
2013,Lynchburg city,51680,Some Other Race ,161,16,145,176,17,175
2013,Manassas city,51683,Some Other Race ,211,73,138,116,67,88
2013,Manassas Park city,51685,Some Other Race ,100,75,25,71,65,36
2013,Martinsville city,51690,Some Other Race ,88,24,64,42,27,39
2013,Newport News city,51700,Some Other Race ,770,238,532,203,90,166
2013,Norfolk city,51710,Some Other Race ,1364,288,1076,219,107,207
2013,Norton city,51720,Some Other Race ,29,0,29,44,12,44
2013,Petersburg city,51730,Some Other Race ,46,0,46,44,26,44
2013,Poquoson city,51735,Some Other Race ,0,0,0,19,19,19
2013,Portsmouth city,51740,Some Other Race ,261,113,148,125,112,89
2013,Radford city,51750,Some Other Race ,26,0,26,31,19,31
2013,Richmond city,51760,Some Other Race ,912,127,785,214,59,212
2013,Roanoke city,51770,Some Other Race ,380,103,277,168,82,155
2013,Salem city,51775,Some Other Race ,67,20,47,55,31,55
2013,Staunton city,51790,Some Other Race ,36,19,17,41,32,31
2013,Suffolk city,51800,Some Other Race ,103,45,58,67,48,40
2013,Virginia Beach city,51810,Some Other Race ,1371,649,722,246,160,204
2013,Waynesboro city,51820,Some Other Race ,74,34,40,58,45,60
2013,Williamsburg city,51830,Some Other Race ,48,0,48,59,19,59
2013,Winchester city,51840,Some Other Race ,108,31,77,67,34,50
2014,Accomack County,51001,Some Other Race ,41,0,41,44,25,44
2014,Albemarle County,51003,Some Other Race ,266,78,188,119,52,114
2014,Alleghany County,51005,Some Other Race ,7,7,0,9,9,19
2014,Amelia County,51007,Some Other Race ,0,0,0,19,19,19
2014,Amherst County,51009,Some Other Race ,77,29,48,70,43,66
2014,Appomattox County,51011,Some Other Race ,0,0,0,19,19,19
2014,Arlington County,51013,Some Other Race ,3676,860,2816,409,227,377
2014,Augusta County,51015,Some Other Race ,125,11,114,77,16,79
2014,Bath County,51017,Some Other Race ,0,0,0,12,12,12
2014,Bedford County,51019,Some Other Race ,0,0,0,28,28,28
2014,Bland County,51021,Some Other Race ,0,0,0,17,17,17
2014,Botetourt County,51023,Some Other Race ,35,14,21,24,16,25
2014,Brunswick County,51025,Some Other Race ,16,0,16,23,19,23
2014,Buchanan County,51027,Some Other Race ,11,11,0,17,17,22
2014,Buckingham County,51029,Some Other Race ,44,31,13,50,45,25
2014,Campbell County,51031,Some Other Race ,102,25,77,68,38,55
2014,Caroline County,51033,Some Other Race ,38,38,0,36,36,22
2014,Carroll County,51035,Some Other Race ,7,7,0,13,13,22
2014,Charles City County,51036,Some Other Race ,7,7,0,6,6,17
2014,Charlotte County,51037,Some Other Race ,9,0,9,12,19,12
2014,Chesterfield County,51041,Some Other Race ,1858,1053,805,280,227,212
2014,Clarke County,51043,Some Other Race ,22,22,0,24,24,19
2014,Craig County,51045,Some Other Race ,0,0,0,17,17,17
2014,Culpeper County,51047,Some Other Race ,238,51,187,121,53,120
2014,Cumberland County,51049,Some Other Race ,0,0,0,17,17,17
2014,Dickenson County,51051,Some Other Race ,0,0,0,19,19,19
2014,Dinwiddie County,51053,Some Other Race ,18,18,0,27,27,22
2014,Essex County,51057,Some Other Race ,6,6,0,10,10,19
2014,Fairfax County,51059,Some Other Race ,12439,4696,7743,785,450,722
2014,Fauquier County,51061,Some Other Race ,42,27,15,32,28,18
2014,Floyd County,51063,Some Other Race ,10,10,0,21,21,19
2014,Fluvanna County,51065,Some Other Race ,118,118,0,90,90,22
2014,Franklin County,51067,Some Other Race ,143,51,92,120,59,104
2014,Frederick County,51069,Some Other Race ,234,92,142,128,82,87
2014,Giles County,51071,Some Other Race ,10,10,0,19,19,19
2014,Gloucester County,51073,Some Other Race ,62,62,0,51,51,25
2014,Goochland County,51075,Some Other Race ,26,26,0,35,35,22
2014,Grayson County,51077,Some Other Race ,0,0,0,19,19,19
2014,Greene County,51079,Some Other Race ,43,0,43,64,19,64
2014,Greensville County,51081,Some Other Race ,0,0,0,19,19,19
2014,Halifax County,51083,Some Other Race ,99,73,26,56,54,35
2014,Hanover County,51085,Some Other Race ,125,73,52,76,64,44
2014,Henrico County,51087,Some Other Race ,1145,414,731,283,171,203
2014,Henry County,51089,Some Other Race ,306,168,138,131,87,104
2014,Highland County,51091,Some Other Race ,0,0,0,12,12,12
2014,Isle of Wight County,51093,Some Other Race ,10,0,10,17,25,17
2014,James City County,51095,Some Other Race ,195,87,108,113,79,92
2014,King and Queen County,51097,Some Other Race ,8,8,0,15,15,17
2014,King George County,51099,Some Other Race ,46,38,8,40,39,13
2014,King William County,51101,Some Other Race ,9,9,0,16,16,19
2014,Lancaster County,51103,Some Other Race ,0,0,0,19,19,19
2014,Lee County,51105,Some Other Race ,0,0,0,22,22,22
2014,Loudoun County,51107,Some Other Race ,3055,1455,1600,406,298,276
2014,Louisa County,51109,Some Other Race ,129,76,53,74,61,43
2014,Lunenburg County,51111,Some Other Race ,49,7,42,35,8,35
2014,Madison County,51113,Some Other Race ,0,0,0,19,19,19
2014,Mathews County,51115,Some Other Race ,0,0,0,17,17,17
2014,Mecklenburg County,51117,Some Other Race ,139,115,24,48,48,30
2014,Middlesex County,51119,Some Other Race ,6,6,0,10,10,19
2014,Montgomery County,51121,Some Other Race ,194,0,194,110,28,110
2014,Nelson County,51125,Some Other Race ,71,15,56,63,38,68
2014,New Kent County,51127,Some Other Race ,13,13,0,22,22,19
2014,Northampton County,51131,Some Other Race ,17,15,2,23,22,3
2014,Northumberland County,51133,Some Other Race ,0,0,0,19,19,19
2014,Nottoway County,51135,Some Other Race ,117,93,24,79,84,38
2014,Orange County,51137,Some Other Race ,95,79,16,46,44,23
2014,Page County,51139,Some Other Race ,6,0,6,9,22,9
2014,Patrick County,51141,Some Other Race ,8,0,8,20,19,20
2014,Pittsylvania County,51143,Some Other Race ,173,93,80,67,72,55
2014,Powhatan County,51145,Some Other Race ,0,0,0,22,22,22
2014,Prince Edward County,51147,Some Other Race ,0,0,0,22,22,22
2014,Prince George County,51149,Some Other Race ,247,76,171,107,55,99
2014,Prince William County,51153,Some Other Race ,4494,2912,1582,481,409,343
2014,Pulaski County,51155,Some Other Race ,7,0,7,12,25,12
2014,Rappahannock County,51157,Some Other Race ,0,0,0,17,17,17
2014,Richmond County,51159,Some Other Race ,0,0,0,17,17,17
2014,Roanoke County,51161,Some Other Race ,63,63,0,54,54,28
2014,Rockbridge County,51163,Some Other Race ,35,12,23,18,17,19
2014,Rockingham County,51165,Some Other Race ,199,116,83,71,61,61
2014,Russell County,51167,Some Other Race ,23,0,23,50,22,50
2014,Scott County,51169,Some Other Race ,0,0,0,22,22,22
2014,Shenandoah County,51171,Some Other Race ,140,48,92,69,38,56
2014,Smyth County,51173,Some Other Race ,5,5,0,9,9,25
2014,Southampton County,51175,Some Other Race ,8,0,8,14,19,14
2014,Spotsylvania County,51177,Some Other Race ,1251,663,588,211,207,190
2014,Stafford County,51179,Some Other Race ,1829,807,1022,246,187,203
2014,Surry County,51181,Some Other Race ,10,0,10,16,17,16
2014,Sussex County,51183,Some Other Race ,18,7,11,18,10,16
2014,Tazewell County,51185,Some Other Race ,0,0,0,25,25,25
2014,Warren County,51187,Some Other Race ,11,11,0,17,17,25
2014,Washington County,51191,Some Other Race ,41,20,21,40,25,31
2014,Westmoreland County,51193,Some Other Race ,14,0,14,21,19,21
2014,Wise County,51195,Some Other Race ,21,14,7,19,15,12
2014,Wythe County,51197,Some Other Race ,0,0,0,22,22,22
2014,York County,51199,Some Other Race ,55,41,14,40,32,20
2014,Alexandria city,51510,Some Other Race ,1520,310,1210,313,132,269
2014,Bristol city,51520,Some Other Race ,53,0,53,78,19,78
2014,Buena Vista city,51530,Some Other Race ,0,0,0,17,17,17
2014,Charlottesville city,51540,Some Other Race ,36,15,21,27,20,16
2014,Chesapeake city,51550,Some Other Race ,600,296,304,197,119,141
2014,Colonial Heights city,51570,Some Other Race ,57,48,9,53,52,16
2014,Covington city,51580,Some Other Race ,0,0,0,17,17,17
2014,Danville city,51590,Some Other Race ,172,84,88,69,52,55
2014,Emporia city,51595,Some Other Race ,12,0,12,23,17,23
2014,Fairfax city,51600,Some Other Race ,293,54,239,117,37,114
2014,Falls Church city,51610,Some Other Race ,108,63,45,52,46,38
2014,Franklin city,51620,Some Other Race ,14,14,0,29,29,17
2014,Fredericksburg city,51630,Some Other Race ,227,0,227,127,22,127
2014,Galax city,51640,Some Other Race ,0,0,0,17,17,17
2014,Hampton city,51650,Some Other Race ,434,143,291,122,67,104
2014,Harrisonburg city,51660,Some Other Race ,134,63,71,67,49,48
2014,Hopewell city,51670,Some Other Race ,389,146,243,148,98,126
2014,Lexington city,51678,Some Other Race ,0,0,0,17,17,17
2014,Lynchburg city,51680,Some Other Race ,117,12,105,125,20,122
2014,Manassas city,51683,Some Other Race ,240,146,94,111,86,65
2014,Manassas Park city,51685,Some Other Race ,67,36,31,51,32,39
2014,Martinsville city,51690,Some Other Race ,95,25,70,51,36,37
2014,Newport News city,51700,Some Other Race ,885,360,525,227,152,144
2014,Norfolk city,51710,Some Other Race ,1514,264,1250,277,92,264
2014,Norton city,51720,Some Other Race ,25,0,25,36,12,36
2014,Petersburg city,51730,Some Other Race ,73,0,73,72,25,72
2014,Poquoson city,51735,Some Other Race ,0,0,0,19,19,19
2014,Portsmouth city,51740,Some Other Race ,305,99,206,148,96,130
2014,Radford city,51750,Some Other Race ,0,0,0,19,19,19
2014,Richmond city,51760,Some Other Race ,792,93,699,175,53,178
2014,Roanoke city,51770,Some Other Race ,335,145,190,170,92,137
2014,Salem city,51775,Some Other Race ,67,23,44,46,44,42
2014,Staunton city,51790,Some Other Race ,38,18,20,44,34,32
2014,Suffolk city,51800,Some Other Race ,131,75,56,78,63,53
2014,Virginia Beach city,51810,Some Other Race ,1536,601,935,260,143,234
2014,Waynesboro city,51820,Some Other Race ,114,114,0,82,82,22
2014,Williamsburg city,51830,Some Other Race ,13,0,13,17,19,17
2014,Winchester city,51840,Some Other Race ,221,70,151,87,60,92
2015,Accomack County,51001,Some Other Race ,75,9,66,55,13,53
2015,Albemarle County,51003,Some Other Race ,210,82,128,99,53,81
2015,Alleghany County,51005,Some Other Race ,20,6,14,26,9,23
2015,Amelia County,51007,Some Other Race ,0,0,0,19,19,19
2015,Amherst County,51009,Some Other Race ,59,4,55,64,14,64
2015,Appomattox County,51011,Some Other Race ,0,0,0,19,19,19
2015,Arlington County,51013,Some Other Race ,3691,887,2804,406,207,421
2015,Augusta County,51015,Some Other Race ,85,5,80,56,11,57
2015,Bath County,51017,Some Other Race ,0,0,0,12,12,12
2015,Bedford County,51019,Some Other Race ,0,0,0,28,28,28
2015,Bland County,51021,Some Other Race ,0,0,0,17,17,17
2015,Botetourt County,51023,Some Other Race ,31,12,19,28,14,24
2015,Brunswick County,51025,Some Other Race ,14,3,11,17,6,15
2015,Buchanan County,51027,Some Other Race ,10,10,0,17,17,22
2015,Buckingham County,51029,Some Other Race ,39,34,5,21,21,12
2015,Campbell County,51031,Some Other Race ,121,30,91,69,43,55
2015,Caroline County,51033,Some Other Race ,61,61,0,43,43,22
2015,Carroll County,51035,Some Other Race ,7,7,0,11,11,22
2015,Charles City County,51036,Some Other Race ,8,8,0,6,6,17
2015,Charlotte County,51037,Some Other Race ,0,0,0,19,19,19
2015,Chesterfield County,51041,Some Other Race ,1923,969,954,291,255,222
2015,Clarke County,51043,Some Other Race ,58,58,0,41,41,19
2015,Craig County,51045,Some Other Race ,0,0,0,17,17,17
2015,Culpeper County,51047,Some Other Race ,242,19,223,125,35,119
2015,Cumberland County,51049,Some Other Race ,0,0,0,17,17,17
2015,Dickenson County,51051,Some Other Race ,0,0,0,19,19,19
2015,Dinwiddie County,51053,Some Other Race ,75,27,48,79,25,69
2015,Essex County,51057,Some Other Race ,6,6,0,13,13,19
2015,Fairfax County,51059,Some Other Race ,12176,4670,7506,812,464,604
2015,Fauquier County,51061,Some Other Race ,88,60,28,59,50,29
2015,Floyd County,51063,Some Other Race ,16,16,0,29,29,19
2015,Fluvanna County,51065,Some Other Race ,128,128,0,105,105,22
2015,Franklin County,51067,Some Other Race ,154,35,119,129,50,119
2015,Frederick County,51069,Some Other Race ,199,83,116,125,77,98
2015,Giles County,51071,Some Other Race ,11,0,11,20,19,20
2015,Gloucester County,51073,Some Other Race ,55,55,0,49,49,25
2015,Goochland County,51075,Some Other Race ,20,20,0,32,32,22
2015,Grayson County,51077,Some Other Race ,0,0,0,19,19,19
2015,Greene County,51079,Some Other Race ,120,70,50,61,49,75
2015,Greensville County,51081,Some Other Race ,0,0,0,19,19,19
2015,Halifax County,51083,Some Other Race ,82,78,4,57,57,8
2015,Hanover County,51085,Some Other Race ,129,98,31,78,70,32
2015,Henrico County,51087,Some Other Race ,1404,418,986,341,146,287
2015,Henry County,51089,Some Other Race ,283,150,133,120,81,89
2015,Highland County,51091,Some Other Race ,0,0,0,12,12,12
2015,Isle of Wight County,51093,Some Other Race ,10,0,10,19,25,19
2015,James City County,51095,Some Other Race ,193,91,102,121,84,95
2015,King and Queen County,51097,Some Other Race ,7,7,0,14,14,17
2015,King George County,51099,Some Other Race ,37,34,3,37,36,6
2015,King William County,51101,Some Other Race ,13,13,0,19,19,19
2015,Lancaster County,51103,Some Other Race ,0,0,0,19,19,19
2015,Lee County,51105,Some Other Race ,0,0,0,22,22,22
2015,Loudoun County,51107,Some Other Race ,2961,1311,1650,407,293,360
2015,Louisa County,51109,Some Other Race ,144,74,70,75,68,47
2015,Lunenburg County,51111,Some Other Race ,55,13,42,30,13,32
2015,Madison County,51113,Some Other Race ,22,10,12,20,14,18
2015,Mathews County,51115,Some Other Race ,0,0,0,17,17,17
2015,Mecklenburg County,51117,Some Other Race ,132,115,17,38,40,20
2015,Middlesex County,51119,Some Other Race ,0,0,0,19,19,19
2015,Montgomery County,51121,Some Other Race ,237,61,176,150,73,127
2015,Nelson County,51125,Some Other Race ,51,13,38,59,28,58
2015,New Kent County,51127,Some Other Race ,14,14,0,23,23,22
2015,Northampton County,51131,Some Other Race ,21,19,2,31,31,4
2015,Northumberland County,51133,Some Other Race ,0,0,0,19,19,19
2015,Nottoway County,51135,Some Other Race ,64,50,14,57,55,25
2015,Orange County,51137,Some Other Race ,82,82,0,54,54,25
2015,Page County,51139,Some Other Race ,7,0,7,11,22,11
2015,Patrick County,51141,Some Other Race ,18,0,18,45,19,45
2015,Pittsylvania County,51143,Some Other Race ,267,90,177,91,61,81
2015,Powhatan County,51145,Some Other Race ,0,0,0,22,22,22
2015,Prince Edward County,51147,Some Other Race ,0,0,0,22,22,22
2015,Prince George County,51149,Some Other Race ,302,114,188,145,67,140
2015,Prince William County,51153,Some Other Race ,4620,2973,1647,470,344,341
2015,Pulaski County,51155,Some Other Race ,18,0,18,26,25,26
2015,Rappahannock County,51157,Some Other Race ,0,0,0,17,17,17
2015,Richmond County,51159,Some Other Race ,0,0,0,17,17,17
2015,Roanoke County,51161,Some Other Race ,38,38,0,37,37,28
2015,Rockbridge County,51163,Some Other Race ,37,18,19,24,24,26
2015,Rockingham County,51165,Some Other Race ,263,115,148,85,61,91
2015,Russell County,51167,Some Other Race ,25,0,25,33,22,33
2015,Scott County,51169,Some Other Race ,13,13,0,22,22,22
2015,Shenandoah County,51171,Some Other Race ,263,56,207,81,43,78
2015,Smyth County,51173,Some Other Race ,4,4,0,8,8,25
2015,Southampton County,51175,Some Other Race ,16,10,6,20,16,13
2015,Spotsylvania County,51177,Some Other Race ,1221,560,661,229,220,194
2015,Stafford County,51179,Some Other Race ,1785,697,1088,257,167,273
2015,Surry County,51181,Some Other Race ,26,11,15,18,15,12
2015,Sussex County,51183,Some Other Race ,17,7,10,22,12,18
2015,Tazewell County,51185,Some Other Race ,0,0,0,25,25,25
2015,Warren County,51187,Some Other Race ,16,16,0,29,29,25
2015,Washington County,51191,Some Other Race ,50,23,27,42,28,29
2015,Westmoreland County,51193,Some Other Race ,20,0,20,27,19,27
2015,Wise County,51195,Some Other Race ,13,13,0,15,15,25
2015,Wythe County,51197,Some Other Race ,0,0,0,22,22,22
2015,York County,51199,Some Other Race ,56,47,9,46,43,19
2015,Alexandria city,51510,Some Other Race ,1414,313,1101,277,154,255
2015,Bristol city,51520,Some Other Race ,55,0,55,75,19,75
2015,Buena Vista city,51530,Some Other Race ,0,0,0,17,17,17
2015,Charlottesville city,51540,Some Other Race ,46,22,24,32,22,24
2015,Chesapeake city,51550,Some Other Race ,654,279,375,206,130,166
2015,Colonial Heights city,51570,Some Other Race ,113,72,41,65,54,40
2015,Covington city,51580,Some Other Race ,0,0,0,17,17,17
2015,Danville city,51590,Some Other Race ,204,84,120,65,50,60
2015,Emporia city,51595,Some Other Race ,47,0,47,52,17,52
2015,Fairfax city,51600,Some Other Race ,245,49,196,126,39,120
2015,Falls Church city,51610,Some Other Race ,151,83,68,69,43,56
2015,Franklin city,51620,Some Other Race ,42,36,6,52,51,10
2015,Fredericksburg city,51630,Some Other Race ,144,0,144,88,22,88
2015,Galax city,51640,Some Other Race ,10,0,10,19,17,19
2015,Hampton city,51650,Some Other Race ,511,186,325,142,81,118
2015,Harrisonburg city,51660,Some Other Race ,127,40,87,70,41,56
2015,Hopewell city,51670,Some Other Race ,418,175,243,149,118,124
2015,Lexington city,51678,Some Other Race ,0,0,0,17,17,17
2015,Lynchburg city,51680,Some Other Race ,153,5,148,107,7,106
2015,Manassas city,51683,Some Other Race ,389,176,213,171,97,130
2015,Manassas Park city,51685,Some Other Race ,199,124,75,97,78,63
2015,Martinsville city,51690,Some Other Race ,63,8,55,40,15,42
2015,Newport News city,51700,Some Other Race ,979,376,603,232,120,195
2015,Norfolk city,51710,Some Other Race ,1795,412,1383,303,135,266
2015,Norton city,51720,Some Other Race ,19,0,19,30,12,30
2015,Petersburg city,51730,Some Other Race ,110,8,102,89,14,90
2015,Poquoson city,51735,Some Other Race ,0,0,0,19,19,19
2015,Portsmouth city,51740,Some Other Race ,262,74,188,113,67,103
2015,Radford city,51750,Some Other Race ,0,0,0,19,19,19
2015,Richmond city,51760,Some Other Race ,782,122,660,192,63,180
2015,Roanoke city,51770,Some Other Race ,400,169,231,197,98,179
2015,Salem city,51775,Some Other Race ,46,46,0,71,71,22
2015,Staunton city,51790,Some Other Race ,46,27,19,42,33,31
2015,Suffolk city,51800,Some Other Race ,146,96,50,85,74,39
2015,Virginia Beach city,51810,Some Other Race ,1814,679,1135,272,155,261
2015,Waynesboro city,51820,Some Other Race ,116,116,0,104,104,22
2015,Williamsburg city,51830,Some Other Race ,23,0,23,34,19,34
2015,Winchester city,51840,Some Other Race ,164,14,150,110,25,106
2016,Accomack County,51001,Some Other Race ,80,25,55,55,20,51
2016,Albemarle County,51003,Some Other Race ,290,107,183,136,60,111
2016,Alleghany County,51005,Some Other Race ,24,5,19,27,8,27
2016,Amelia County,51007,Some Other Race ,0,0,0,19,19,19
2016,Amherst County,51009,Some Other Race ,78,5,73,89,26,87
2016,Appomattox County,51011,Some Other Race ,0,0,0,19,19,19
2016,Arlington County,51013,Some Other Race ,3452,798,2654,450,195,429
2016,Augusta County,51015,Some Other Race ,67,8,59,67,13,65
2016,Bath County,51017,Some Other Race ,0,0,0,12,12,12
2016,Bedford County,51019,Some Other Race ,54,30,24,55,47,36
2016,Bland County,51021,Some Other Race ,0,0,0,17,17,17
2016,Botetourt County,51023,Some Other Race ,42,15,27,38,18,34
2016,Brunswick County,51025,Some Other Race ,18,3,15,23,9,19
2016,Buchanan County,51027,Some Other Race ,0,0,0,22,22,22
2016,Buckingham County,51029,Some Other Race ,46,33,13,24,26,29
2016,Campbell County,51031,Some Other Race ,164,26,138,109,40,103
2016,Caroline County,51033,Some Other Race ,93,54,39,73,41,59
2016,Carroll County,51035,Some Other Race ,8,8,0,14,14,22
2016,Charles City County,51036,Some Other Race ,9,9,0,9,9,17
2016,Charlotte County,51037,Some Other Race ,0,0,0,19,19,19
2016,Chesterfield County,51041,Some Other Race ,2223,1127,1096,328,257,229
2016,Clarke County,51043,Some Other Race ,37,37,0,50,50,19
2016,Craig County,51045,Some Other Race ,0,0,0,17,17,17
2016,Culpeper County,51047,Some Other Race ,251,21,230,105,27,105
2016,Cumberland County,51049,Some Other Race ,0,0,0,17,17,17
2016,Dickenson County,51051,Some Other Race ,0,0,0,19,19,19
2016,Dinwiddie County,51053,Some Other Race ,73,26,47,75,35,68
2016,Essex County,51057,Some Other Race ,11,11,0,16,16,19
2016,Fairfax County,51059,Some Other Race ,11523,4267,7256,659,463,587
2016,Fauquier County,51061,Some Other Race ,101,70,31,55,46,32
2016,Floyd County,51063,Some Other Race ,25,25,0,42,42,19
2016,Fluvanna County,51065,Some Other Race ,39,39,0,42,42,22
2016,Franklin County,51067,Some Other Race ,277,40,237,178,57,146
2016,Frederick County,51069,Some Other Race ,185,61,124,115,57,91
2016,Giles County,51071,Some Other Race ,2,0,2,6,19,6
2016,Gloucester County,51073,Some Other Race ,36,36,0,34,34,25
2016,Goochland County,51075,Some Other Race ,31,31,0,35,35,22
2016,Grayson County,51077,Some Other Race ,11,11,0,18,18,19
2016,Greene County,51079,Some Other Race ,122,40,82,97,48,111
2016,Greensville County,51081,Some Other Race ,0,0,0,19,19,19
2016,Halifax County,51083,Some Other Race ,38,38,0,55,55,25
2016,Hanover County,51085,Some Other Race ,93,56,37,56,42,37
2016,Henrico County,51087,Some Other Race ,1429,447,982,276,193,222
2016,Henry County,51089,Some Other Race ,390,177,213,158,104,144
2016,Highland County,51091,Some Other Race ,0,0,0,12,12,12
2016,Isle of Wight County,51093,Some Other Race ,29,0,29,42,25,42
2016,James City County,51095,Some Other Race ,150,125,25,116,103,42
2016,King and Queen County,51097,Some Other Race ,9,9,0,18,18,17
2016,King George County,51099,Some Other Race ,35,29,6,39,35,13
2016,King William County,51101,Some Other Race ,16,16,0,20,20,19
2016,Lancaster County,51103,Some Other Race ,0,0,0,19,19,19
2016,Lee County,51105,Some Other Race ,0,0,0,22,22,22
2016,Loudoun County,51107,Some Other Race ,2952,1432,1520,399,263,304
2016,Louisa County,51109,Some Other Race ,151,37,114,80,46,70
2016,Lunenburg County,51111,Some Other Race ,51,15,36,36,16,38
2016,Madison County,51113,Some Other Race ,26,15,11,22,22,17
2016,Mathews County,51115,Some Other Race ,0,0,0,17,17,17
2016,Mecklenburg County,51117,Some Other Race ,110,96,14,40,38,23
2016,Middlesex County,51119,Some Other Race ,0,0,0,19,19,19
2016,Montgomery County,51121,Some Other Race ,161,62,99,107,68,80
2016,Nelson County,51125,Some Other Race ,60,19,41,56,28,54
2016,New Kent County,51127,Some Other Race ,24,24,0,39,39,22
2016,Northampton County,51131,Some Other Race ,28,25,3,35,35,5
2016,Northumberland County,51133,Some Other Race ,0,0,0,19,19,19
2016,Nottoway County,51135,Some Other Race ,33,0,33,52,19,52
2016,Orange County,51137,Some Other Race ,88,88,0,49,49,25
2016,Page County,51139,Some Other Race ,18,0,18,19,22,19
2016,Patrick County,51141,Some Other Race ,46,27,19,47,28,40
2016,Pittsylvania County,51143,Some Other Race ,299,110,189,69,58,73
2016,Powhatan County,51145,Some Other Race ,0,0,0,22,22,22
2016,Prince Edward County,51147,Some Other Race ,5,0,5,22,22,22
2016,Prince George County,51149,Some Other Race ,296,62,234,176,54,156
2016,Prince William County,51153,Some Other Race ,5279,3048,2231,503,429,347
2016,Pulaski County,51155,Some Other Race ,38,0,38,38,25,38
2016,Rappahannock County,51157,Some Other Race ,0,0,0,17,17,17
2016,Richmond County,51159,Some Other Race ,3,0,3,8,17,8
2016,Roanoke County,51161,Some Other Race ,62,54,8,64,61,14
2016,Rockbridge County,51163,Some Other Race ,24,14,10,19,17,17
2016,Rockingham County,51165,Some Other Race ,274,116,158,91,67,88
2016,Russell County,51167,Some Other Race ,25,0,25,30,22,30
2016,Scott County,51169,Some Other Race ,11,11,0,18,18,22
2016,Shenandoah County,51171,Some Other Race ,156,33,123,81,27,74
2016,Smyth County,51173,Some Other Race ,12,6,6,14,9,10
2016,Southampton County,51175,Some Other Race ,22,11,11,20,20,16
2016,Spotsylvania County,51177,Some Other Race ,1166,626,540,217,188,141
2016,Stafford County,51179,Some Other Race ,1941,838,1103,307,220,268
2016,Surry County,51181,Some Other Race ,12,12,0,14,14,17
2016,Sussex County,51183,Some Other Race ,44,15,29,43,25,37
2016,Tazewell County,51185,Some Other Race ,0,0,0,25,25,25
2016,Warren County,51187,Some Other Race ,14,14,0,27,27,25
2016,Washington County,51191,Some Other Race ,42,32,10,34,30,17
2016,Westmoreland County,51193,Some Other Race ,13,0,13,22,19,22
2016,Wise County,51195,Some Other Race ,13,13,0,14,14,25
2016,Wythe County,51197,Some Other Race ,0,0,0,22,22,22
2016,York County,51199,Some Other Race ,68,49,19,53,49,20
2016,Alexandria city,51510,Some Other Race ,1749,204,1545,320,91,307
2016,Bristol city,51520,Some Other Race ,55,0,55,75,19,75
2016,Buena Vista city,51530,Some Other Race ,0,0,0,17,17,17
2016,Charlottesville city,51540,Some Other Race ,50,16,34,36,19,28
2016,Chesapeake city,51550,Some Other Race ,658,220,438,215,105,180
2016,Colonial Heights city,51570,Some Other Race ,161,76,85,67,55,61
2016,Covington city,51580,Some Other Race ,0,0,0,17,17,17
2016,Danville city,51590,Some Other Race ,162,53,109,62,32,62
2016,Emporia city,51595,Some Other Race ,35,0,35,41,17,41
2016,Fairfax city,51600,Some Other Race ,312,73,239,128,45,121
2016,Falls Church city,51610,Some Other Race ,150,84,66,49,44,46
2016,Franklin city,51620,Some Other Race ,18,8,10,20,13,15
2016,Fredericksburg city,51630,Some Other Race ,278,16,262,132,23,131
2016,Galax city,51640,Some Other Race ,6,0,6,14,17,14
2016,Hampton city,51650,Some Other Race ,662,241,421,171,89,162
2016,Harrisonburg city,51660,Some Other Race ,162,69,93,82,70,53
2016,Hopewell city,51670,Some Other Race ,378,109,269,141,97,141
2016,Lexington city,51678,Some Other Race ,0,0,0,17,17,17
2016,Lynchburg city,51680,Some Other Race ,196,32,164,103,33,107
2016,Manassas city,51683,Some Other Race ,563,234,329,229,104,177
2016,Manassas Park city,51685,Some Other Race ,187,133,54,99,94,54
2016,Martinsville city,51690,Some Other Race ,72,10,62,50,17,49
2016,Newport News city,51700,Some Other Race ,1104,478,626,232,154,189
2016,Norfolk city,51710,Some Other Race ,1735,360,1375,268,110,262
2016,Norton city,51720,Some Other Race ,20,0,20,26,12,26
2016,Petersburg city,51730,Some Other Race ,194,40,154,94,38,94
2016,Poquoson city,51735,Some Other Race ,0,0,0,19,19,19
2016,Portsmouth city,51740,Some Other Race ,289,69,220,157,55,134
2016,Radford city,51750,Some Other Race ,0,0,0,19,19,19
2016,Richmond city,51760,Some Other Race ,753,124,629,168,56,159
2016,Roanoke city,51770,Some Other Race ,362,158,204,148,113,137
2016,Salem city,51775,Some Other Race ,42,42,0,60,60,22
2016,Staunton city,51790,Some Other Race ,15,15,0,20,20,22
2016,Suffolk city,51800,Some Other Race ,156,108,48,88,72,45
2016,Virginia Beach city,51810,Some Other Race ,1961,645,1316,265,156,213
2016,Waynesboro city,51820,Some Other Race ,64,64,0,72,72,22
2016,Williamsburg city,51830,Some Other Race ,18,0,18,27,19,27
2016,Winchester city,51840,Some Other Race ,172,14,158,104,25,100
2017,Accomack County,51001,Some Other Race ,43,28,15,33,25,23
2017,Albemarle County,51003,Some Other Race ,274,106,168,118,52,102
2017,Alleghany County,51005,Some Other Race ,30,4,26,34,8,34
2017,Amelia County,51007,Some Other Race ,0,0,0,19,19,19
2017,Amherst County,51009,Some Other Race ,82,21,61,66,39,80
2017,Appomattox County,51011,Some Other Race ,0,0,0,19,19,19
2017,Arlington County,51013,Some Other Race ,3496,841,2655,519,211,490
2017,Augusta County,51015,Some Other Race ,25,3,22,32,5,30
2017,Bath County,51017,Some Other Race ,0,0,0,12,12,12
2017,Bedford County,51019,Some Other Race ,79,58,21,66,62,34
2017,Bland County,51021,Some Other Race ,0,0,0,17,17,17
2017,Botetourt County,51023,Some Other Race ,40,11,29,32,13,32
2017,Brunswick County,51025,Some Other Race ,32,12,20,24,16,22
2017,Buchanan County,51027,Some Other Race ,0,0,0,22,22,22
2017,Buckingham County,51029,Some Other Race ,54,41,13,22,26,22
2017,Campbell County,51031,Some Other Race ,168,38,130,98,48,83
2017,Caroline County,51033,Some Other Race ,78,48,30,61,40,49
2017,Carroll County,51035,Some Other Race ,10,10,0,17,17,22
2017,Charles City County,51036,Some Other Race ,7,7,0,8,8,17
2017,Charlotte County,51037,Some Other Race ,15,0,15,21,19,21
2017,Chesterfield County,51041,Some Other Race ,2120,1030,1090,323,252,270
2017,Clarke County,51043,Some Other Race ,29,29,0,48,48,19
2017,Craig County,51045,Some Other Race ,0,0,0,17,17,17
2017,Culpeper County,51047,Some Other Race ,376,90,286,173,72,153
2017,Cumberland County,51049,Some Other Race ,0,0,0,17,17,17
2017,Dickenson County,51051,Some Other Race ,0,0,0,19,19,19
2017,Dinwiddie County,51053,Some Other Race ,70,31,39,58,36,55
2017,Essex County,51057,Some Other Race ,41,0,41,39,19,39
2017,Fairfax County,51059,Some Other Race ,10994,4041,6953,724,473,563
2017,Fauquier County,51061,Some Other Race ,123,75,48,53,47,40
2017,Floyd County,51063,Some Other Race ,24,24,0,48,48,19
2017,Fluvanna County,51065,Some Other Race ,41,41,0,40,40,22
2017,Franklin County,51067,Some Other Race ,224,49,175,123,75,131
2017,Frederick County,51069,Some Other Race ,118,69,49,75,59,46
2017,Giles County,51071,Some Other Race ,2,0,2,4,19,4
2017,Gloucester County,51073,Some Other Race ,27,27,0,35,35,25
2017,Goochland County,51075,Some Other Race ,28,28,0,29,29,22
2017,Grayson County,51077,Some Other Race ,11,11,0,17,17,19
2017,Greene County,51079,Some Other Race ,203,161,42,71,81,68
2017,Greensville County,51081,Some Other Race ,0,0,0,19,19,19
2017,Halifax County,51083,Some Other Race ,46,46,0,64,64,25
2017,Hanover County,51085,Some Other Race ,77,54,23,49,40,29
2017,Henrico County,51087,Some Other Race ,1676,388,1288,305,139,277
2017,Henry County,51089,Some Other Race ,421,191,230,140,110,126
2017,Highland County,51091,Some Other Race ,0,0,0,12,12,12
2017,Isle of Wight County,51093,Some Other Race ,42,0,42,60,25,60
2017,James City County,51095,Some Other Race ,155,126,29,118,93,54
2017,King and Queen County,51097,Some Other Race ,0,0,0,17,17,17
2017,King George County,51099,Some Other Race ,32,29,3,31,31,6
2017,King William County,51101,Some Other Race ,5,5,0,8,8,19
2017,Lancaster County,51103,Some Other Race ,0,0,0,19,19,19
2017,Lee County,51105,Some Other Race ,0,0,0,22,22,22
2017,Loudoun County,51107,Some Other Race ,2590,1404,1186,356,268,299
2017,Louisa County,51109,Some Other Race ,165,62,103,71,57,57
2017,Lunenburg County,51111,Some Other Race ,30,6,24,34,11,35
2017,Madison County,51113,Some Other Race ,49,31,18,27,35,24
2017,Mathews County,51115,Some Other Race ,0,0,0,17,17,17
2017,Mecklenburg County,51117,Some Other Race ,39,39,0,47,47,25
2017,Middlesex County,51119,Some Other Race ,0,0,0,19,19,19
2017,Montgomery County,51121,Some Other Race ,150,122,28,124,118,33
2017,Nelson County,51125,Some Other Race ,58,24,34,63,38,52
2017,New Kent County,51127,Some Other Race ,43,43,0,47,47,22
2017,Northampton County,51131,Some Other Race ,4,4,0,9,9,19
2017,Northumberland County,51133,Some Other Race ,0,0,0,19,19,19
2017,Nottoway County,51135,Some Other Race ,36,0,36,55,19,55
2017,Orange County,51137,Some Other Race ,132,132,0,76,76,25
2017,Page County,51139,Some Other Race ,21,0,21,32,22,32
2017,Patrick County,51141,Some Other Race ,43,31,12,47,36,26
2017,Pittsylvania County,51143,Some Other Race ,283,79,204,84,46,83
2017,Powhatan County,51145,Some Other Race ,21,21,0,38,38,22
2017,Prince Edward County,51147,Some Other Race ,52,0,52,62,22,62
2017,Prince George County,51149,Some Other Race ,264,63,201,153,55,134
2017,Prince William County,51153,Some Other Race ,6427,4094,2333,612,501,401
2017,Pulaski County,51155,Some Other Race ,27,0,27,25,25,25
2017,Rappahannock County,51157,Some Other Race ,0,0,0,17,17,17
2017,Richmond County,51159,Some Other Race ,34,0,34,35,17,35
2017,Roanoke County,51161,Some Other Race ,85,72,13,70,71,17
2017,Rockbridge County,51163,Some Other Race ,27,13,14,24,19,20
2017,Rockingham County,51165,Some Other Race ,218,109,109,92,72,68
2017,Russell County,51167,Some Other Race ,0,0,0,22,22,22
2017,Scott County,51169,Some Other Race ,9,9,0,18,18,22
2017,Shenandoah County,51171,Some Other Race ,69,34,35,32,24,21
2017,Smyth County,51173,Some Other Race ,10,5,5,10,7,7
2017,Southampton County,51175,Some Other Race ,16,12,4,19,18,8
2017,Spotsylvania County,51177,Some Other Race ,1300,715,585,217,149,162
2017,Stafford County,51179,Some Other Race ,2077,934,1143,284,220,266
2017,Surry County,51181,Some Other Race ,11,11,0,14,14,17
2017,Sussex County,51183,Some Other Race ,62,24,38,44,36,45
2017,Tazewell County,51185,Some Other Race ,0,0,0,25,25,25
2017,Warren County,51187,Some Other Race ,13,13,0,23,23,25
2017,Washington County,51191,Some Other Race ,48,34,14,40,33,24
2017,Westmoreland County,51193,Some Other Race ,45,0,45,49,19,49
2017,Wise County,51195,Some Other Race ,13,13,0,16,16,25
2017,Wythe County,51197,Some Other Race ,12,12,0,22,22,22
2017,York County,51199,Some Other Race ,127,77,50,73,64,45
2017,Alexandria city,51510,Some Other Race ,1764,223,1541,297,91,264
2017,Bristol city,51520,Some Other Race ,58,0,58,83,19,83
2017,Buena Vista city,51530,Some Other Race ,0,0,0,17,17,17
2017,Charlottesville city,51540,Some Other Race ,38,6,32,30,10,27
2017,Chesapeake city,51550,Some Other Race ,702,301,401,209,113,178
2017,Colonial Heights city,51570,Some Other Race ,178,81,97,75,55,72
2017,Covington city,51580,Some Other Race ,0,0,0,17,17,17
2017,Danville city,51590,Some Other Race ,137,53,84,65,42,63
2017,Emporia city,51595,Some Other Race ,0,0,0,17,17,17
2017,Fairfax city,51600,Some Other Race ,348,130,218,117,66,99
2017,Falls Church city,51610,Some Other Race ,108,35,73,61,45,55
2017,Franklin city,51620,Some Other Race ,25,10,15,27,15,26
2017,Fredericksburg city,51630,Some Other Race ,234,19,215,140,25,147
2017,Galax city,51640,Some Other Race ,10,0,10,20,17,20
2017,Hampton city,51650,Some Other Race ,866,385,481,221,135,191
2017,Harrisonburg city,51660,Some Other Race ,214,56,158,94,56,82
2017,Hopewell city,51670,Some Other Race ,342,121,221,133,108,98
2017,Lexington city,51678,Some Other Race ,0,0,0,17,17,17
2017,Lynchburg city,51680,Some Other Race ,193,46,147,99,48,93
2017,Manassas city,51683,Some Other Race ,657,320,337,206,138,156
2017,Manassas Park city,51685,Some Other Race ,242,143,99,110,90,64
2017,Martinsville city,51690,Some Other Race ,43,11,32,48,18,48
2017,Newport News city,51700,Some Other Race ,1051,515,536,252,185,160
2017,Norfolk city,51710,Some Other Race ,1872,319,1553,266,101,253
2017,Norton city,51720,Some Other Race ,0,0,0,12,12,12
2017,Petersburg city,51730,Some Other Race ,193,58,135,77,50,77
2017,Poquoson city,51735,Some Other Race ,0,0,0,19,19,19
2017,Portsmouth city,51740,Some Other Race ,449,89,360,164,58,154
2017,Radford city,51750,Some Other Race ,0,0,0,19,19,19
2017,Richmond city,51760,Some Other Race ,728,143,585,181,48,180
2017,Roanoke city,51770,Some Other Race ,508,255,253,203,134,169
2017,Salem city,51775,Some Other Race ,0,0,0,22,22,22
2017,Staunton city,51790,Some Other Race ,15,15,0,20,20,22
2017,Suffolk city,51800,Some Other Race ,140,106,34,83,78,30
2017,Virginia Beach city,51810,Some Other Race ,2236,893,1343,381,248,275
2017,Waynesboro city,51820,Some Other Race ,39,39,0,44,44,22
2017,Williamsburg city,51830,Some Other Race ,24,0,24,33,19,33
2017,Winchester city,51840,Some Other Race ,223,55,168,128,56,112
2018,Accomack County,51001,Some Other Race ,46,31,15,35,27,21
2018,Albemarle County,51003,Some Other Race ,200,74,126,88,55,78
2018,Alleghany County,51005,Some Other Race ,25,5,20,28,9,27
2018,Amelia County,51007,Some Other Race ,0,0,0,19,19,19
2018,Amherst County,51009,Some Other Race ,22,22,0,38,38,25
2018,Appomattox County,51011,Some Other Race ,4,4,0,7,7,19
2018,Arlington County,51013,Some Other Race ,3186,825,2361,382,212,372
2018,Augusta County,51015,Some Other Race ,31,2,29,33,3,33
2018,Bath County,51017,Some Other Race ,0,0,0,12,12,12
2018,Bedford County,51019,Some Other Race ,62,48,14,53,49,21
2018,Bland County,51021,Some Other Race ,0,0,0,17,17,17
2018,Botetourt County,51023,Some Other Race ,68,12,56,33,19,29
2018,Brunswick County,51025,Some Other Race ,44,19,25,30,29,28
2018,Buchanan County,51027,Some Other Race ,19,7,12,23,11,20
2018,Buckingham County,51029,Some Other Race ,44,35,9,17,21,18
2018,Campbell County,51031,Some Other Race ,180,47,133,118,53,107
2018,Caroline County,51033,Some Other Race ,101,28,73,64,28,65
2018,Carroll County,51035,Some Other Race ,0,0,0,22,22,22
2018,Charles City County,51036,Some Other Race ,5,5,0,5,5,17
2018,Charlotte County,51037,Some Other Race ,16,0,16,16,19,16
2018,Chesterfield County,51041,Some Other Race ,1634,929,705,267,218,162
2018,Clarke County,51043,Some Other Race ,36,36,0,31,31,19
2018,Craig County,51045,Some Other Race ,0,0,0,17,17,17
2018,Culpeper County,51047,Some Other Race ,482,185,297,198,132,170
2018,Cumberland County,51049,Some Other Race ,0,0,0,17,17,17
2018,Dickenson County,51051,Some Other Race ,0,0,0,19,19,19
2018,Dinwiddie County,51053,Some Other Race ,67,30,37,66,35,54
2018,Essex County,51057,Some Other Race ,43,0,43,38,19,38
2018,Fairfax County,51059,Some Other Race ,11119,4169,6950,691,459,621
2018,Fauquier County,51061,Some Other Race ,114,104,10,83,83,14
2018,Floyd County,51063,Some Other Race ,41,41,0,49,49,19
2018,Fluvanna County,51065,Some Other Race ,26,26,0,34,34,22
2018,Franklin County,51067,Some Other Race ,181,0,181,134,28,134
2018,Frederick County,51069,Some Other Race ,143,71,72,87,60,66
2018,Giles County,51071,Some Other Race ,1,0,1,3,19,3
2018,Gloucester County,51073,Some Other Race ,10,10,0,23,23,25
2018,Goochland County,51075,Some Other Race ,23,9,14,29,16,21
2018,Grayson County,51077,Some Other Race ,9,9,0,15,15,19
2018,Greene County,51079,Some Other Race ,167,167,0,96,96,19
2018,Greensville County,51081,Some Other Race ,0,0,0,19,19,19
2018,Halifax County,51083,Some Other Race ,60,51,9,68,69,16
2018,Hanover County,51085,Some Other Race ,104,62,42,52,33,38
2018,Henrico County,51087,Some Other Race ,1734,416,1318,332,138,316
2018,Henry County,51089,Some Other Race ,349,142,207,149,102,126
2018,Highland County,51091,Some Other Race ,0,0,0,12,12,12
2018,Isle of Wight County,51093,Some Other Race ,107,0,107,104,25,104
2018,James City County,51095,Some Other Race ,132,78,54,100,77,59
2018,King and Queen County,51097,Some Other Race ,0,0,0,17,17,17
2018,King George County,51099,Some Other Race ,9,4,5,10,7,8
2018,King William County,51101,Some Other Race ,6,6,0,10,10,19
2018,Lancaster County,51103,Some Other Race ,0,0,0,19,19,19
2018,Lee County,51105,Some Other Race ,0,0,0,22,22,22
2018,Loudoun County,51107,Some Other Race ,2666,1487,1179,404,282,258
2018,Louisa County,51109,Some Other Race ,161,63,98,94,63,69
2018,Lunenburg County,51111,Some Other Race ,30,4,26,35,7,34
2018,Madison County,51113,Some Other Race ,42,26,16,35,40,19
2018,Mathews County,51115,Some Other Race ,0,0,0,17,17,17
2018,Mecklenburg County,51117,Some Other Race ,37,27,10,35,26,21
2018,Middlesex County,51119,Some Other Race ,44,0,44,61,19,61
2018,Montgomery County,51121,Some Other Race ,243,186,57,145,141,45
2018,Nelson County,51125,Some Other Race ,112,54,58,88,68,59
2018,New Kent County,51127,Some Other Race ,97,97,0,89,89,22
2018,Northampton County,51131,Some Other Race ,6,6,0,12,12,19
2018,Northumberland County,51133,Some Other Race ,0,0,0,19,19,19
2018,Nottoway County,51135,Some Other Race ,50,0,50,62,19,62
2018,Orange County,51137,Some Other Race ,129,129,0,80,80,25
2018,Page County,51139,Some Other Race ,19,0,19,32,22,32
2018,Patrick County,51141,Some Other Race ,27,20,7,34,25,22
2018,Pittsylvania County,51143,Some Other Race ,279,103,176,76,54,78
2018,Powhatan County,51145,Some Other Race ,16,16,0,31,31,22
2018,Prince Edward County,51147,Some Other Race ,48,0,48,54,22,54
2018,Prince George County,51149,Some Other Race ,159,72,87,87,52,65
2018,Prince William County,51153,Some Other Race ,7238,4688,2550,620,503,462
2018,Pulaski County,51155,Some Other Race ,28,0,28,23,25,23
2018,Rappahannock County,51157,Some Other Race ,0,0,0,17,17,17
2018,Richmond County,51159,Some Other Race ,61,4,57,45,7,44
2018,Roanoke County,51161,Some Other Race ,68,54,14,72,72,16
2018,Rockbridge County,51163,Some Other Race ,0,0,0,22,22,22
2018,Rockingham County,51165,Some Other Race ,197,161,36,109,109,42
2018,Russell County,51167,Some Other Race ,0,0,0,22,22,22
2018,Scott County,51169,Some Other Race ,7,7,0,14,14,22
2018,Shenandoah County,51171,Some Other Race ,66,23,43,32,21,30
2018,Smyth County,51173,Some Other Race ,34,30,4,40,39,6
2018,Southampton County,51175,Some Other Race ,24,18,6,29,27,12
2018,Spotsylvania County,51177,Some Other Race ,1347,791,556,221,187,184
2018,Stafford County,51179,Some Other Race ,2382,1244,1138,302,263,283
2018,Surry County,51181,Some Other Race ,11,11,0,14,14,17
2018,Sussex County,51183,Some Other Race ,22,0,22,25,19,25
2018,Tazewell County,51185,Some Other Race ,0,0,0,25,25,25
2018,Warren County,51187,Some Other Race ,84,23,61,64,29,59
2018,Washington County,51191,Some Other Race ,34,20,14,33,23,24
2018,Westmoreland County,51193,Some Other Race ,118,66,52,98,64,68
2018,Wise County,51195,Some Other Race ,0,0,0,25,25,25
2018,Wythe County,51197,Some Other Race ,8,8,0,13,13,22
2018,York County,51199,Some Other Race ,145,81,64,80,63,59
2018,Alexandria city,51510,Some Other Race ,1867,254,1613,288,94,278
2018,Bristol city,51520,Some Other Race ,71,0,71,94,19,94
2018,Buena Vista city,51530,Some Other Race ,0,0,0,17,17,17
2018,Charlottesville city,51540,Some Other Race ,41,6,35,32,11,29
2018,Chesapeake city,51550,Some Other Race ,1008,425,583,204,147,180
2018,Colonial Heights city,51570,Some Other Race ,114,8,106,72,17,67
2018,Covington city,51580,Some Other Race ,0,0,0,17,17,17
2018,Danville city,51590,Some Other Race ,110,61,49,70,50,55
2018,Emporia city,51595,Some Other Race ,0,0,0,17,17,17
2018,Fairfax city,51600,Some Other Race ,245,165,80,109,89,66
2018,Falls Church city,51610,Some Other Race ,71,23,48,53,37,42
2018,Franklin city,51620,Some Other Race ,52,15,37,50,24,48
2018,Fredericksburg city,51630,Some Other Race ,181,9,172,88,15,86
2018,Galax city,51640,Some Other Race ,12,0,12,20,17,20
2018,Hampton city,51650,Some Other Race ,879,337,542,243,145,216
2018,Harrisonburg city,51660,Some Other Race ,201,29,172,101,31,92
2018,Hopewell city,51670,Some Other Race ,302,24,278,142,32,137
2018,Lexington city,51678,Some Other Race ,0,0,0,17,17,17
2018,Lynchburg city,51680,Some Other Race ,186,57,129,100,54,89
2018,Manassas city,51683,Some Other Race ,740,374,366,211,125,184
2018,Manassas Park city,51685,Some Other Race ,208,127,81,100,69,68
2018,Martinsville city,51690,Some Other Race ,13,13,0,20,20,19
2018,Newport News city,51700,Some Other Race ,1296,654,642,273,213,211
2018,Norfolk city,51710,Some Other Race ,2047,325,1722,268,110,264
2018,Norton city,51720,Some Other Race ,0,0,0,12,12,12
2018,Petersburg city,51730,Some Other Race ,149,73,76,83,68,57
2018,Poquoson city,51735,Some Other Race ,0,0,0,19,19,19
2018,Portsmouth city,51740,Some Other Race ,484,119,365,171,63,166
2018,Radford city,51750,Some Other Race ,0,0,0,19,19,19
2018,Richmond city,51760,Some Other Race ,640,160,480,147,79,129
2018,Roanoke city,51770,Some Other Race ,482,264,218,191,107,138
2018,Salem city,51775,Some Other Race ,14,0,14,23,22,23
2018,Staunton city,51790,Some Other Race ,26,10,16,32,16,27
2018,Suffolk city,51800,Some Other Race ,331,258,73,137,127,74
2018,Virginia Beach city,51810,Some Other Race ,2754,926,1828,346,201,305
2018,Waynesboro city,51820,Some Other Race ,17,11,6,22,19,13
2018,Williamsburg city,51830,Some Other Race ,23,0,23,28,19,28
2018,Winchester city,51840,Some Other Race ,188,68,120,132,64,113
2019,Accomack County,51001,Some Other Race ,46,28,18,40,23,26
2019,Albemarle County,51003,Some Other Race ,160,78,82,92,54,67
2019,Alleghany County,51005,Some Other Race ,14,0,14,22,19,22
2019,Amelia County,51007,Some Other Race ,0,0,0,19,19,19
2019,Amherst County,51009,Some Other Race ,13,13,0,21,21,26
2019,Appomattox County,51011,Some Other Race ,4,4,0,7,7,19
2019,Arlington County,51013,Some Other Race ,3038,808,2230,372,233,338
2019,Augusta County,51015,Some Other Race ,55,14,41,46,22,40
2019,Bath County,51017,Some Other Race ,0,0,0,12,12,12
2019,Bedford County,51019,Some Other Race ,67,47,20,56,51,25
2019,Bland County,51021,Some Other Race ,0,0,0,17,17,17
2019,Botetourt County,51023,Some Other Race ,8,8,0,13,13,26
2019,Brunswick County,51025,Some Other Race ,67,55,12,57,55,21
2019,Buchanan County,51027,Some Other Race ,21,7,14,30,12,28
2019,Buckingham County,51029,Some Other Race ,46,37,9,27,28,15
2019,Campbell County,51031,Some Other Race ,109,73,36,106,97,43
2019,Caroline County,51033,Some Other Race ,205,65,140,113,59,103
2019,Carroll County,51035,Some Other Race ,0,0,0,23,23,23
2019,Charles City County,51036,Some Other Race ,2,2,0,3,3,17
2019,Charlotte County,51037,Some Other Race ,3,0,3,14,19,14
2019,Chesterfield County,51041,Some Other Race ,2280,1246,1034,383,254,236
2019,Clarke County,51043,Some Other Race ,41,41,0,34,34,19
2019,Craig County,51045,Some Other Race ,0,0,0,17,17,17
2019,Culpeper County,51047,Some Other Race ,439,171,268,176,101,133
2019,Cumberland County,51049,Some Other Race ,0,0,0,17,17,17
2019,Dickenson County,51051,Some Other Race ,0,0,0,19,19,19
2019,Dinwiddie County,51053,Some Other Race ,84,43,41,85,54,65
2019,Essex County,51057,Some Other Race ,42,0,42,40,19,40
2019,Fairfax County,51059,Some Other Race ,12558,4349,8209,858,419,777
2019,Fauquier County,51061,Some Other Race ,148,99,49,73,60,42
2019,Floyd County,51063,Some Other Race ,10,10,0,17,17,19
2019,Fluvanna County,51065,Some Other Race ,37,37,0,51,51,23
2019,Franklin County,51067,Some Other Race ,97,0,97,88,29,88
2019,Frederick County,51069,Some Other Race ,189,108,81,91,71,65
2019,Giles County,51071,Some Other Race ,1,0,1,4,19,4
2019,Gloucester County,51073,Some Other Race ,0,0,0,26,26,26
2019,Goochland County,51075,Some Other Race ,26,0,26,35,23,35
2019,Grayson County,51077,Some Other Race ,9,9,0,14,14,19
2019,Greene County,51079,Some Other Race ,152,152,0,96,96,19
2019,Greensville County,51081,Some Other Race ,0,0,0,19,19,19
2019,Halifax County,51083,Some Other Race ,19,0,19,34,26,34
2019,Hanover County,51085,Some Other Race ,208,75,133,118,45,110
2019,Henrico County,51087,Some Other Race ,1876,458,1418,346,165,292
2019,Henry County,51089,Some Other Race ,258,87,171,152,76,135
2019,Highland County,51091,Some Other Race ,0,0,0,12,12,12
2019,Isle of Wight County,51093,Some Other Race ,83,13,70,83,23,86
2019,James City County,51095,Some Other Race ,114,60,54,77,50,67
2019,King and Queen County,51097,Some Other Race ,5,5,0,8,8,17
2019,King George County,51099,Some Other Race ,5,5,0,9,9,23
2019,King William County,51101,Some Other Race ,2,2,0,4,4,19
2019,Lancaster County,51103,Some Other Race ,0,0,0,19,19,19
2019,Lee County,51105,Some Other Race ,0,0,0,23,23,23
2019,Loudoun County,51107,Some Other Race ,3091,1535,1556,417,298,335
2019,Louisa County,51109,Some Other Race ,112,22,90,69,28,67
2019,Lunenburg County,51111,Some Other Race ,7,7,0,19,19,19
2019,Madison County,51113,Some Other Race ,47,30,17,36,46,19
2019,Mathews County,51115,Some Other Race ,0,0,0,17,17,17
2019,Mecklenburg County,51117,Some Other Race ,21,13,8,27,18,16
2019,Middlesex County,51119,Some Other Race ,53,0,53,71,19,71
2019,Montgomery County,51121,Some Other Race ,348,238,110,166,147,75
2019,Nelson County,51125,Some Other Race ,58,31,27,71,53,44
2019,New Kent County,51127,Some Other Race ,96,96,0,77,77,23
2019,Northampton County,51131,Some Other Race ,29,29,0,36,36,19
2019,Northumberland County,51133,Some Other Race ,0,0,0,19,19,19
2019,Nottoway County,51135,Some Other Race ,40,0,40,60,19,60
2019,Orange County,51137,Some Other Race ,110,110,0,71,71,26
2019,Page County,51139,Some Other Race ,22,0,22,35,23,35
2019,Patrick County,51141,Some Other Race ,23,23,0,27,27,19
2019,Pittsylvania County,51143,Some Other Race ,212,117,95,90,61,71
2019,Powhatan County,51145,Some Other Race ,17,17,0,30,30,23
2019,Prince Edward County,51147,Some Other Race ,43,0,43,49,23,49
2019,Prince George County,51149,Some Other Race ,141,68,73,79,71,42
2019,Prince William County,51153,Some Other Race ,8322,5250,3072,630,545,444
2019,Pulaski County,51155,Some Other Race ,26,0,26,26,26,26
2019,Rappahannock County,51157,Some Other Race ,8,8,0,14,14,17
2019,Richmond County,51159,Some Other Race ,74,5,69,62,9,61
2019,Roanoke County,51161,Some Other Race ,86,71,15,90,92,19
2019,Rockbridge County,51163,Some Other Race ,0,0,0,23,23,23
2019,Rockingham County,51165,Some Other Race ,204,157,47,89,75,45
2019,Russell County,51167,Some Other Race ,0,0,0,23,23,23
2019,Scott County,51169,Some Other Race ,9,9,0,16,16,23
2019,Shenandoah County,51171,Some Other Race ,72,26,46,35,23,35
2019,Smyth County,51173,Some Other Race ,32,28,4,38,37,6
2019,Southampton County,51175,Some Other Race ,18,15,3,25,25,6
2019,Spotsylvania County,51177,Some Other Race ,1519,957,562,237,236,193
2019,Stafford County,51179,Some Other Race ,2330,1372,958,354,306,282
2019,Surry County,51181,Some Other Race ,8,8,0,11,11,17
2019,Sussex County,51183,Some Other Race ,20,0,20,27,19,27
2019,Tazewell County,51185,Some Other Race ,0,0,0,26,26,26
2019,Warren County,51187,Some Other Race ,158,26,132,84,31,82
2019,Washington County,51191,Some Other Race ,41,20,21,36,16,33
2019,Westmoreland County,51193,Some Other Race ,140,92,48,91,93,64
2019,Wise County,51195,Some Other Race ,0,0,0,26,26,26
2019,Wythe County,51197,Some Other Race ,11,11,0,25,25,23
2019,York County,51199,Some Other Race ,342,221,121,136,136,80
2019,Alexandria city,51510,Some Other Race ,1796,240,1556,292,101,274
2019,Bristol city,51520,Some Other Race ,0,0,0,19,19,19
2019,Buena Vista city,51530,Some Other Race ,0,0,0,17,17,17
2019,Charlottesville city,51540,Some Other Race ,31,7,24,27,11,23
2019,Chesapeake city,51550,Some Other Race ,1149,474,675,276,190,214
2019,Colonial Heights city,51570,Some Other Race ,121,22,99,70,25,63
2019,Covington city,51580,Some Other Race ,0,0,0,17,17,17
2019,Danville city,51590,Some Other Race ,64,26,38,50,27,46
2019,Emporia city,51595,Some Other Race ,0,0,0,17,17,17
2019,Fairfax city,51600,Some Other Race ,357,237,120,105,96,85
2019,Falls Church city,51610,Some Other Race ,84,29,55,60,47,44
2019,Franklin city,51620,Some Other Race ,61,17,44,57,26,51
2019,Fredericksburg city,51630,Some Other Race ,199,52,147,73,60,59
2019,Galax city,51640,Some Other Race ,11,0,11,17,17,17
2019,Hampton city,51650,Some Other Race ,681,354,327,179,141,138
2019,Harrisonburg city,51660,Some Other Race ,191,32,159,89,30,81
2019,Hopewell city,51670,Some Other Race ,195,20,175,96,27,95
2019,Lexington city,51678,Some Other Race ,12,12,0,22,22,17
2019,Lynchburg city,51680,Some Other Race ,266,92,174,142,63,130
2019,Manassas city,51683,Some Other Race ,783,433,350,193,149,144
2019,Manassas Park city,51685,Some Other Race ,248,142,106,123,98,79
2019,Martinsville city,51690,Some Other Race ,26,8,18,31,13,27
2019,Newport News city,51700,Some Other Race ,1401,707,694,253,171,218
2019,Norfolk city,51710,Some Other Race ,2032,414,1618,308,156,280
2019,Norton city,51720,Some Other Race ,0,0,0,12,12,12
2019,Petersburg city,51730,Some Other Race ,141,67,74,77,58,46
2019,Poquoson city,51735,Some Other Race ,0,0,0,19,19,19
2019,Portsmouth city,51740,Some Other Race ,429,100,329,144,56,127
2019,Radford city,51750,Some Other Race ,0,0,0,19,19,19
2019,Richmond city,51760,Some Other Race ,966,258,708,222,95,185
2019,Roanoke city,51770,Some Other Race ,194,135,59,116,112,62
2019,Salem city,51775,Some Other Race ,74,0,74,77,23,77
2019,Staunton city,51790,Some Other Race ,17,8,9,18,12,14
2019,Suffolk city,51800,Some Other Race ,258,193,65,121,98,64
2019,Virginia Beach city,51810,Some Other Race ,3054,1303,1751,377,214,329
2019,Waynesboro city,51820,Some Other Race ,2,0,2,8,23,8
2019,Williamsburg city,51830,Some Other Race ,60,0,60,58,19,58
2019,Winchester city,51840,Some Other Race ,92,36,56,60,39,46
2020,Accomack County,51001,Some Other Race ,17,16,1,19,17,3
2020,Albemarle County,51003,Some Other Race ,197,74,123,102,49,80
2020,Alleghany County,51005,Some Other Race ,0,0,0,20,20,20
2020,Amelia County,51007,Some Other Race ,0,0,0,20,20,20
2020,Amherst County,51009,Some Other Race ,11,11,0,20,20,27
2020,Appomattox County,51011,Some Other Race ,2,2,0,4,4,20
2020,Arlington County,51013,Some Other Race ,3746,864,2882,668,254,626
2020,Augusta County,51015,Some Other Race ,114,81,33,75,65,38
2020,Bath County,51017,Some Other Race ,0,0,0,13,13,13
2020,Bedford County,51019,Some Other Race ,182,102,80,102,71,63
2020,Bland County,51021,Some Other Race ,0,0,0,18,18,18
2020,Botetourt County,51023,Some Other Race ,51,16,35,57,23,52
2020,Brunswick County,51025,Some Other Race ,146,121,25,84,86,43
2020,Buchanan County,51027,Some Other Race ,33,8,25,43,14,41
2020,Buckingham County,51029,Some Other Race ,43,26,17,37,35,11
2020,Campbell County,51031,Some Other Race ,105,39,66,97,48,82
2020,Caroline County,51033,Some Other Race ,207,72,135,115,66,100
2020,Carroll County,51035,Some Other Race ,28,28,0,46,46,24
2020,Charles City County,51036,Some Other Race ,3,3,0,4,4,18
2020,Charlotte County,51037,Some Other Race ,6,0,6,15,20,15
2020,Chesterfield County,51041,Some Other Race ,3053,1505,1548,411,270,402
2020,Clarke County,51043,Some Other Race ,102,102,0,110,110,20
2020,Craig County,51045,Some Other Race ,0,0,0,18,18,18
2020,Culpeper County,51047,Some Other Race ,440,169,271,165,104,114
2020,Cumberland County,51049,Some Other Race ,0,0,0,18,18,18
2020,Dickenson County,51051,Some Other Race ,0,0,0,20,20,20
2020,Dinwiddie County,51053,Some Other Race ,44,44,0,63,63,24
2020,Essex County,51057,Some Other Race ,38,0,38,54,20,54
2020,Fairfax County,51059,Some Other Race ,13458,5703,7755,951,655,660
2020,Fauquier County,51061,Some Other Race ,116,77,39,70,56,43
2020,Floyd County,51063,Some Other Race ,16,9,7,21,14,14
2020,Fluvanna County,51065,Some Other Race ,40,36,4,41,41,5
2020,Franklin County,51067,Some Other Race ,82,0,82,81,30,81
2020,Frederick County,51069,Some Other Race ,174,123,51,88,71,44
2020,Giles County,51071,Some Other Race ,0,0,0,20,20,20
2020,Gloucester County,51073,Some Other Race ,62,62,0,97,97,27
2020,Goochland County,51075,Some Other Race ,13,0,13,20,24,20
2020,Grayson County,51077,Some Other Race ,9,9,0,15,15,20
2020,Greene County,51079,Some Other Race ,105,78,27,76,67,34
2020,Greensville County,51081,Some Other Race ,0,0,0,20,20,20
2020,Halifax County,51083,Some Other Race ,23,0,23,32,27,32
2020,Hanover County,51085,Some Other Race ,526,291,235,152,143,136
2020,Henrico County,51087,Some Other Race ,1997,451,1546,328,195,324
2020,Henry County,51089,Some Other Race ,243,105,138,148,92,101
2020,Highland County,51091,Some Other Race ,0,0,0,13,13,13
2020,Isle of Wight County,51093,Some Other Race ,97,14,83,97,22,101
2020,James City County,51095,Some Other Race ,193,132,61,113,93,70
2020,King and Queen County,51097,Some Other Race ,11,11,0,12,12,18
2020,King George County,51099,Some Other Race ,11,11,0,18,18,24
2020,King William County,51101,Some Other Race ,2,2,0,4,4,20
2020,Lancaster County,51103,Some Other Race ,14,14,0,25,25,20
2020,Lee County,51105,Some Other Race ,0,0,0,24,24,24
2020,Loudoun County,51107,Some Other Race ,3485,1925,1560,442,379,273
2020,Louisa County,51109,Some Other Race ,113,29,84,83,37,82
2020,Lunenburg County,51111,Some Other Race ,23,13,10,30,27,11
2020,Madison County,51113,Some Other Race ,0,0,0,20,20,20
2020,Mathews County,51115,Some Other Race ,0,0,0,18,18,18
2020,Mecklenburg County,51117,Some Other Race ,49,15,34,46,17,45
2020,Middlesex County,51119,Some Other Race ,50,0,50,74,20,74
2020,Montgomery County,51121,Some Other Race ,322,149,173,132,105,115
2020,Nelson County,51125,Some Other Race ,56,29,27,54,42,42
2020,New Kent County,51127,Some Other Race ,167,167,0,146,146,24
2020,Northampton County,51131,Some Other Race ,24,23,1,31,30,3
2020,Northumberland County,51133,Some Other Race ,0,0,0,20,20,20
2020,Nottoway County,51135,Some Other Race ,64,0,64,83,20,83
2020,Orange County,51137,Some Other Race ,89,89,0,59,59,27
2020,Page County,51139,Some Other Race ,68,54,14,84,80,24
2020,Patrick County,51141,Some Other Race ,29,29,0,30,30,20
2020,Pittsylvania County,51143,Some Other Race ,192,108,84,86,74,58
2020,Powhatan County,51145,Some Other Race ,16,16,0,31,31,24
2020,Prince Edward County,51147,Some Other Race ,15,0,15,25,24,25
2020,Prince George County,51149,Some Other Race ,160,82,78,81,62,49
2020,Prince William County,51153,Some Other Race ,8391,5640,2751,651,585,429
2020,Pulaski County,51155,Some Other Race ,22,0,22,28,27,28
2020,Rappahannock County,51157,Some Other Race ,22,22,0,25,25,18
2020,Richmond County,51159,Some Other Race ,87,8,79,52,15,56
2020,Roanoke County,51161,Some Other Race ,139,114,25,83,81,24
2020,Rockbridge County,51163,Some Other Race ,0,0,0,24,24,24
2020,Rockingham County,51165,Some Other Race ,158,124,34,83,77,28
2020,Russell County,51167,Some Other Race ,0,0,0,24,24,24
2020,Scott County,51169,Some Other Race ,0,0,0,24,24,24
2020,Shenandoah County,51171,Some Other Race ,97,16,81,58,14,55
2020,Smyth County,51173,Some Other Race ,22,19,3,30,29,6
2020,Southampton County,51175,Some Other Race ,9,6,3,10,9,5
2020,Spotsylvania County,51177,Some Other Race ,1664,1224,440,282,251,170
2020,Stafford County,51179,Some Other Race ,2175,1268,907,347,289,310
2020,Surry County,51181,Some Other Race ,0,0,0,18,18,18
2020,Sussex County,51183,Some Other Race ,21,0,21,30,20,30
2020,Tazewell County,51185,Some Other Race ,24,24,0,41,41,27
2020,Warren County,51187,Some Other Race ,217,88,129,107,66,88
2020,Washington County,51191,Some Other Race ,23,23,0,25,25,30
2020,Westmoreland County,51193,Some Other Race ,179,132,47,117,103,67
2020,Wise County,51195,Some Other Race ,0,0,0,27,27,27
2020,Wythe County,51197,Some Other Race ,14,14,0,24,24,24
2020,York County,51199,Some Other Race ,301,202,99,111,92,77
2020,Alexandria city,51510,Some Other Race ,2102,348,1754,315,175,281
2020,Bristol city,51520,Some Other Race ,0,0,0,20,20,20
2020,Buena Vista city,51530,Some Other Race ,7,0,7,12,18,12
2020,Charlottesville city,51540,Some Other Race ,159,8,151,139,19,136
2020,Chesapeake city,51550,Some Other Race ,1506,699,807,433,316,291
2020,Colonial Heights city,51570,Some Other Race ,153,109,44,93,90,43
2020,Covington city,51580,Some Other Race ,0,0,0,18,18,18
2020,Danville city,51590,Some Other Race ,33,22,11,31,24,17
2020,Emporia city,51595,Some Other Race ,0,0,0,18,18,18
2020,Fairfax city,51600,Some Other Race ,372,255,117,134,100,94
2020,Falls Church city,51610,Some Other Race ,185,12,173,146,23,145
2020,Franklin city,51620,Some Other Race ,34,0,34,42,18,42
2020,Fredericksburg city,51630,Some Other Race ,267,86,181,120,86,81
2020,Galax city,51640,Some Other Race ,0,0,0,18,18,18
2020,Hampton city,51650,Some Other Race ,692,439,253,224,193,119
2020,Harrisonburg city,51660,Some Other Race ,275,36,239,122,35,117
2020,Hopewell city,51670,Some Other Race ,233,40,193,146,38,140
2020,Lexington city,51678,Some Other Race ,15,15,0,27,27,18
2020,Lynchburg city,51680,Some Other Race ,383,117,266,181,84,169
2020,Manassas city,51683,Some Other Race ,826,578,248,227,215,121
2020,Manassas Park city,51685,Some Other Race ,196,78,118,132,67,104
2020,Martinsville city,51690,Some Other Race ,59,10,49,55,15,54
2020,Newport News city,51700,Some Other Race ,1292,597,695,234,171,182
2020,Norfolk city,51710,Some Other Race ,2367,580,1787,346,205,314
2020,Norton city,51720,Some Other Race ,0,0,0,13,13,13
2020,Petersburg city,51730,Some Other Race ,145,43,102,77,47,73
2020,Poquoson city,51735,Some Other Race ,0,0,0,20,20,20
2020,Portsmouth city,51740,Some Other Race ,579,111,468,215,64,198
2020,Radford city,51750,Some Other Race ,0,0,0,20,20,20
2020,Richmond city,51760,Some Other Race ,1155,246,909,213,80,190
2020,Roanoke city,51770,Some Other Race ,154,101,53,113,112,46
2020,Salem city,51775,Some Other Race ,168,83,85,133,103,88
2020,Staunton city,51790,Some Other Race ,28,14,14,33,23,22
2020,Suffolk city,51800,Some Other Race ,395,319,76,162,153,72
2020,Virginia Beach city,51810,Some Other Race ,3201,1312,1889,440,334,353
2020,Waynesboro city,51820,Some Other Race ,11,0,11,18,24,18
2020,Williamsburg city,51830,Some Other Race ,18,0,18,20,20,20
2020,Winchester city,51840,Some Other Race ,94,34,60,67,42,53
2021,Accomack County,51001,Some Other Race ,60,1,59,74,2,74
2021,Albemarle County,51003,Some Other Race ,282,64,218,120,43,115
2021,Alleghany County,51005,Some Other Race ,0,0,0,21,21,21
2021,Amelia County,51007,Some Other Race ,0,0,0,21,21,21
2021,Amherst County,51009,Some Other Race ,44,21,23,48,28,37
2021,Appomattox County,51011,Some Other Race ,16,16,0,20,20,21
2021,Arlington County,51013,Some Other Race ,3605,835,2770,563,259,484
2021,Augusta County,51015,Some Other Race ,151,123,28,101,103,39
2021,Bath County,51017,Some Other Race ,0,0,0,13,13,13
2021,Bedford County,51019,Some Other Race ,237,140,97,125,88,92
2021,Bland County,51021,Some Other Race ,0,0,0,19,19,19
2021,Botetourt County,51023,Some Other Race ,39,9,30,47,17,43
2021,Brunswick County,51025,Some Other Race ,58,58,0,64,64,21
2021,Buchanan County,51027,Some Other Race ,11,8,3,14,12,7
2021,Buckingham County,51029,Some Other Race ,54,32,22,48,47,18
2021,Campbell County,51031,Some Other Race ,230,162,68,162,156,70
2021,Caroline County,51033,Some Other Race ,229,96,133,131,69,118
2021,Carroll County,51035,Some Other Race ,58,39,19,45,39,31
2021,Charles City County,51036,Some Other Race ,5,5,0,7,7,19
2021,Charlotte County,51037,Some Other Race ,14,0,14,17,21,17
2021,Chesterfield County,51041,Some Other Race ,3808,1970,1838,479,364,336
2021,Clarke County,51043,Some Other Race ,73,60,13,69,65,19
2021,Craig County,51045,Some Other Race ,0,0,0,13,13,13
2021,Culpeper County,51047,Some Other Race ,618,299,319,182,127,139
2021,Cumberland County,51049,Some Other Race ,0,0,0,19,19,19
2021,Dickenson County,51051,Some Other Race ,0,0,0,21,21,21
2021,Dinwiddie County,51053,Some Other Race ,41,16,25,45,24,43
2021,Essex County,51057,Some Other Race ,30,0,30,24,21,24
2021,Fairfax County,51059,Some Other Race ,15586,6480,9106,981,648,921
2021,Fauquier County,51061,Some Other Race ,199,141,58,90,80,47
2021,Floyd County,51063,Some Other Race ,44,36,8,36,35,20
2021,Fluvanna County,51065,Some Other Race ,91,87,4,62,63,5
2021,Franklin County,51067,Some Other Race ,43,8,35,43,16,43
2021,Frederick County,51069,Some Other Race ,417,189,228,162,96,123
2021,Giles County,51071,Some Other Race ,0,0,0,21,21,21
2021,Gloucester County,51073,Some Other Race ,179,124,55,138,105,92
2021,Goochland County,51075,Some Other Race ,59,37,22,59,52,35
2021,Grayson County,51077,Some Other Race ,0,0,0,21,21,21
2021,Greene County,51079,Some Other Race ,163,150,13,67,68,19
2021,Greensville County,51081,Some Other Race ,0,0,0,21,21,21
2021,Halifax County,51083,Some Other Race ,17,0,17,35,28,35
2021,Hanover County,51085,Some Other Race ,494,288,206,198,163,126
2021,Henrico County,51087,Some Other Race ,2522,740,1782,403,233,371
2021,Henry County,51089,Some Other Race ,239,146,93,103,97,63
2021,Highland County,51091,Some Other Race ,0,0,0,13,13,13
2021,Isle of Wight County,51093,Some Other Race ,117,35,82,68,31,65
2021,James City County,51095,Some Other Race ,191,183,8,116,117,18
2021,King and Queen County,51097,Some Other Race ,35,35,0,31,31,19
2021,King George County,51099,Some Other Race ,99,91,8,71,70,13
2021,King William County,51101,Some Other Race ,6,6,0,9,9,21
2021,Lancaster County,51103,Some Other Race ,47,47,0,49,49,21
2021,Lee County,51105,Some Other Race ,0,0,0,25,25,25
2021,Loudoun County,51107,Some Other Race ,3609,2015,1594,439,319,334
2021,Louisa County,51109,Some Other Race ,93,79,14,65,65,21
2021,Lunenburg County,51111,Some Other Race ,31,13,18,31,27,17
2021,Madison County,51113,Some Other Race ,12,0,12,18,21,18
2021,Mathews County,51115,Some Other Race ,0,0,0,19,19,19
2021,Mecklenburg County,51117,Some Other Race ,62,12,50,62,14,61
2021,Middlesex County,51119,Some Other Race ,71,0,71,94,21,94
2021,Montgomery County,51121,Some Other Race ,347,178,169,136,112,103
2021,Nelson County,51125,Some Other Race ,76,34,42,68,43,49
2021,New Kent County,51127,Some Other Race ,120,120,0,107,107,25
2021,Northampton County,51131,Some Other Race ,59,35,24,54,35,42
2021,Northumberland County,51133,Some Other Race ,0,0,0,21,21,21
2021,Nottoway County,51135,Some Other Race ,0,0,0,21,21,21
2021,Orange County,51137,Some Other Race ,145,123,22,110,108,32
2021,Page County,51139,Some Other Race ,66,66,0,75,75,25
2021,Patrick County,51141,Some Other Race ,17,17,0,26,26,21
2021,Pittsylvania County,51143,Some Other Race ,235,124,111,110,83,57
2021,Powhatan County,51145,Some Other Race ,46,46,0,54,54,25
2021,Prince Edward County,51147,Some Other Race ,17,0,17,31,25,31
2021,Prince George County,51149,Some Other Race ,282,118,164,147,104,115
2021,Prince William County,51153,Some Other Race ,8478,6110,2368,805,671,381
2021,Pulaski County,51155,Some Other Race ,14,0,14,21,28,21
2021,Rappahannock County,51157,Some Other Race ,30,30,0,34,34,19
2021,Richmond County,51159,Some Other Race ,152,16,136,82,31,84
2021,Roanoke County,51161,Some Other Race ,171,139,32,108,97,38
2021,Rockbridge County,51163,Some Other Race ,27,0,27,30,25,30
2021,Rockingham County,51165,Some Other Race ,211,155,56,111,98,41
2021,Russell County,51167,Some Other Race ,0,0,0,25,25,25
2021,Scott County,51169,Some Other Race ,0,0,0,25,25,25
2021,Shenandoah County,51171,Some Other Race ,100,12,88,58,14,60
2021,Smyth County,51173,Some Other Race ,33,23,10,38,38,16
2021,Southampton County,51175,Some Other Race ,20,5,15,22,9,20
2021,Spotsylvania County,51177,Some Other Race ,1900,1290,610,334,259,226
2021,Stafford County,51179,Some Other Race ,2454,1537,917,463,370,293
2021,Surry County,51181,Some Other Race ,0,0,0,19,19,19
2021,Sussex County,51183,Some Other Race ,3,0,3,10,21,10
2021,Tazewell County,51185,Some Other Race ,29,29,0,30,30,28
2021,Warren County,51187,Some Other Race ,352,161,191,124,89,112
2021,Washington County,51191,Some Other Race ,9,9,0,14,14,31
2021,Westmoreland County,51193,Some Other Race ,283,138,145,148,108,130
2021,Wise County,51195,Some Other Race ,13,13,0,17,17,28
2021,Wythe County,51197,Some Other Race ,56,56,0,74,74,25
2021,York County,51199,Some Other Race ,456,243,213,168,101,126
2021,Alexandria city,51510,Some Other Race ,2083,464,1619,321,205,283
2021,Bristol city,51520,Some Other Race ,0,0,0,21,21,21
2021,Buena Vista city,51530,Some Other Race ,6,0,6,13,19,13
2021,Charlottesville city,51540,Some Other Race ,203,43,160,145,49,131
2021,Chesapeake city,51550,Some Other Race ,1694,981,713,517,415,239
2021,Colonial Heights city,51570,Some Other Race ,159,110,49,112,105,65
2021,Covington city,51580,Some Other Race ,0,0,0,19,19,19
2021,Danville city,51590,Some Other Race ,132,55,77,110,46,103
2021,Emporia city,51595,Some Other Race ,0,0,0,19,19,19
2021,Fairfax city,51600,Some Other Race ,453,210,243,162,95,148
2021,Falls Church city,51610,Some Other Race ,183,9,174,108,16,102
2021,Franklin city,51620,Some Other Race ,26,0,26,34,19,34
2021,Fredericksburg city,51630,Some Other Race ,258,53,205,100,56,95
2021,Galax city,51640,Some Other Race ,31,0,31,28,19,28
2021,Hampton city,51650,Some Other Race ,819,636,183,243,250,116
2021,Harrisonburg city,51660,Some Other Race ,440,119,321,149,85,114
2021,Hopewell city,51670,Some Other Race ,255,98,157,124,77,97
2021,Lexington city,51678,Some Other Race ,42,42,0,61,61,19
2021,Lynchburg city,51680,Some Other Race ,335,60,275,157,59,139
2021,Manassas city,51683,Some Other Race ,787,521,266,218,205,122
2021,Manassas Park city,51685,Some Other Race ,433,220,213,202,98,169
2021,Martinsville city,51690,Some Other Race ,117,61,56,95,56,74
2021,Newport News city,51700,Some Other Race ,1385,684,701,298,213,194
2021,Norfolk city,51710,Some Other Race ,2656,690,1966,380,225,333
2021,Norton city,51720,Some Other Race ,0,0,0,13,13,13
2021,Petersburg city,51730,Some Other Race ,114,45,69,78,58,59
2021,Poquoson city,51735,Some Other Race ,0,0,0,21,21,21
2021,Portsmouth city,51740,Some Other Race ,625,258,367,220,163,165
2021,Radford city,51750,Some Other Race ,7,0,7,12,21,12
2021,Richmond city,51760,Some Other Race ,1807,386,1421,295,145,283
2021,Roanoke city,51770,Some Other Race ,248,99,149,143,104,109
2021,Salem city,51775,Some Other Race ,113,50,63,96,76,65
2021,Staunton city,51790,Some Other Race ,31,21,10,32,23,21
2021,Suffolk city,51800,Some Other Race ,589,502,87,171,163,74
2021,Virginia Beach city,51810,Some Other Race ,3323,1463,1860,546,305,384
2021,Waynesboro city,51820,Some Other Race ,24,18,6,36,33,18
2021,Williamsburg city,51830,Some Other Race ,25,0,25,22,21,22
2021,Winchester city,51840,Some Other Race ,320,56,264,130,45,142
2010,Accomack County,51001,Two or More Races ,157,72,85,94,57,76
2010,Albemarle County,51003,Two or More Races ,383,164,219,140,71,111
2010,Alleghany County,51005,Two or More Races ,7,7,0,12,12,127
2010,Amelia County,51007,Two or More Races ,0,0,0,127,127,127
2010,Amherst County,51009,Two or More Races ,89,56,33,71,61,34
2010,Appomattox County,51011,Two or More Races ,0,0,0,127,127,127
2010,Arlington County,51013,Two or More Races ,2117,732,1385,354,183,315
2010,Augusta County,51015,Two or More Races ,231,231,0,84,84,127
2010,Bath County,51017,Two or More Races ,0,0,0,127,127,127
2010,Bedford County,51019,Two or More Races ,271,263,8,103,102,14
2010,Bland County,51021,Two or More Races ,0,0,0,127,127,127
2010,Botetourt County,51023,Two or More Races ,36,36,0,44,44,127
2010,Brunswick County,51025,Two or More Races ,30,19,11,31,24,18
2010,Buchanan County,51027,Two or More Races ,0,0,0,127,127,127
2010,Buckingham County,51029,Two or More Races ,32,32,0,44,44,127
2010,Campbell County,51031,Two or More Races ,117,53,64,58,45,55
2010,Caroline County,51033,Two or More Races ,120,105,15,84,78,23
2010,Carroll County,51035,Two or More Races ,108,0,108,150,127,150
2010,Charles City County,51036,Two or More Races ,74,49,25,33,25,23
2010,Charlotte County,51037,Two or More Races ,8,3,5,12,7,8
2010,Chesterfield County,51041,Two or More Races ,1111,677,434,233,185,148
2010,Clarke County,51043,Two or More Races ,68,34,34,57,29,47
2010,Craig County,51045,Two or More Races ,19,0,19,32,127,32
2010,Culpeper County,51047,Two or More Races ,228,148,80,105,79,71
2010,Cumberland County,51049,Two or More Races ,44,15,29,45,24,30
2010,Dickenson County,51051,Two or More Races ,39,33,6,19,17,9
2010,Dinwiddie County,51053,Two or More Races ,63,53,10,43,38,16
2010,Essex County,51057,Two or More Races ,68,45,23,51,36,35
2010,Fairfax County,51059,Two or More Races ,6582,3828,2754,509,409,382
2010,Fauquier County,51061,Two or More Races ,246,180,66,154,123,87
2010,Floyd County,51063,Two or More Races ,60,18,42,53,31,46
2010,Fluvanna County,51065,Two or More Races ,108,101,7,71,72,9
2010,Franklin County,51067,Two or More Races ,141,103,38,46,67,37
2010,Frederick County,51069,Two or More Races ,262,182,80,113,96,84
2010,Giles County,51071,Two or More Races ,68,31,37,43,35,30
2010,Gloucester County,51073,Two or More Races ,152,102,50,76,65,43
2010,Goochland County,51075,Two or More Races ,108,78,30,72,59,43
2010,Grayson County,51077,Two or More Races ,6,3,3,8,6,5
2010,Greene County,51079,Two or More Races ,85,85,0,117,117,127
2010,Greensville County,51081,Two or More Races ,6,6,0,10,10,127
2010,Halifax County,51083,Two or More Races ,111,62,49,78,46,57
2010,Hanover County,51085,Two or More Races ,317,170,147,115,87,88
2010,Henrico County,51087,Two or More Races ,1252,424,828,272,131,243
2010,Henry County,51089,Two or More Races ,141,63,78,76,49,66
2010,Highland County,51091,Two or More Races ,34,34,0,51,51,127
2010,Isle of Wight County,51093,Two or More Races ,128,114,14,69,66,19
2010,James City County,51095,Two or More Races ,233,174,59,90,72,50
2010,King and Queen County,51097,Two or More Races ,0,0,0,127,127,127
2010,King George County,51099,Two or More Races ,183,127,56,82,75,47
2010,King William County,51101,Two or More Races ,28,17,11,23,16,19
2010,Lancaster County,51103,Two or More Races ,21,6,15,22,11,19
2010,Lee County,51105,Two or More Races ,9,9,0,15,15,127
2010,Loudoun County,51107,Two or More Races ,1436,1102,334,230,213,116
2010,Louisa County,51109,Two or More Races ,172,111,61,84,59,54
2010,Lunenburg County,51111,Two or More Races ,44,40,4,34,33,6
2010,Madison County,51113,Two or More Races ,31,31,0,44,44,127
2010,Mathews County,51115,Two or More Races ,0,0,0,127,127,127
2010,Mecklenburg County,51117,Two or More Races ,51,51,0,40,40,127
2010,Middlesex County,51119,Two or More Races ,0,0,0,127,127,127
2010,Montgomery County,51121,Two or More Races ,308,108,200,125,63,107
2010,Nelson County,51125,Two or More Races ,67,47,20,53,44,30
2010,New Kent County,51127,Two or More Races ,38,38,0,33,33,127
2010,Northampton County,51131,Two or More Races ,43,18,25,47,29,34
2010,Northumberland County,51133,Two or More Races ,16,16,0,21,21,127
2010,Nottoway County,51135,Two or More Races ,39,32,7,32,32,11
2010,Orange County,51137,Two or More Races ,115,100,15,73,72,24
2010,Page County,51139,Two or More Races ,54,46,8,40,40,11
2010,Patrick County,51141,Two or More Races ,45,45,0,50,50,127
2010,Pittsylvania County,51143,Two or More Races ,164,139,25,71,65,33
2010,Powhatan County,51145,Two or More Races ,78,78,0,56,56,127
2010,Prince Edward County,51147,Two or More Races ,49,25,24,48,32,37
2010,Prince George County,51149,Two or More Races ,75,71,4,43,42,9
2010,Prince William County,51153,Two or More Races ,2605,1828,777,363,302,224
2010,Pulaski County,51155,Two or More Races ,110,57,53,70,58,58
2010,Rappahannock County,51157,Two or More Races ,43,26,17,40,24,32
2010,Richmond County,51159,Two or More Races ,28,28,0,29,29,127
2010,Roanoke County,51161,Two or More Races ,192,97,95,89,63,68
2010,Rockbridge County,51163,Two or More Races ,29,23,6,32,27,16
2010,Rockingham County,51165,Two or More Races ,150,65,85,84,44,70
2010,Russell County,51167,Two or More Races ,14,14,0,26,26,127
2010,Scott County,51169,Two or More Races ,121,80,41,86,70,40
2010,Shenandoah County,51171,Two or More Races ,59,0,59,38,127,38
2010,Smyth County,51173,Two or More Races ,99,16,83,56,16,57
2010,Southampton County,51175,Two or More Races ,57,57,0,33,33,127
2010,Spotsylvania County,51177,Two or More Races ,385,319,66,134,117,53
2010,Stafford County,51179,Two or More Races ,610,456,154,141,128,61
2010,Surry County,51181,Two or More Races ,41,32,9,29,27,15
2010,Sussex County,51183,Two or More Races ,2,2,0,4,4,127
2010,Tazewell County,51185,Two or More Races ,125,117,8,86,87,13
2010,Warren County,51187,Two or More Races ,115,98,17,68,65,19
2010,Washington County,51191,Two or More Races ,132,80,52,51,51,49
2010,Westmoreland County,51193,Two or More Races ,103,103,0,75,75,127
2010,Wise County,51195,Two or More Races ,73,28,45,74,43,55
2010,Wythe County,51197,Two or More Races ,16,16,0,28,28,127
2010,York County,51199,Two or More Races ,351,218,133,157,108,99
2010,Alexandria city,51510,Two or More Races ,1471,420,1051,287,140,258
2010,Bedford County,51019,Two or More Races ,37,37,0,52,52,127
2010,Bristol city,51520,Two or More Races ,38,22,16,34,25,23
2010,Buena Vista city,51530,Two or More Races ,74,42,32,68,49,41
2010,Charlottesville city,51540,Two or More Races ,253,35,218,113,41,108
2010,Chesapeake city,51550,Two or More Races ,1184,864,320,239,197,130
2010,Colonial Heights city,51570,Two or More Races ,49,20,29,39,22,29
2010,Covington city,51580,Two or More Races ,38,9,29,34,16,31
2010,Danville city,51590,Two or More Races ,117,53,64,60,43,54
2010,Emporia city,51595,Two or More Races ,16,6,10,20,12,16
2010,Fairfax city,51600,Two or More Races ,199,105,94,89,63,66
2010,Falls Church city,51610,Two or More Races ,50,50,0,44,44,127
2010,Franklin city,51620,Two or More Races ,8,8,0,12,12,127
2010,Fredericksburg city,51630,Two or More Races ,108,47,61,50,31,46
2010,Galax city,51640,Two or More Races ,0,0,0,127,127,127
2010,Hampton city,51650,Two or More Races ,597,332,265,128,98,95
2010,Harrisonburg city,51660,Two or More Races ,178,69,109,142,60,117
2010,Hopewell city,51670,Two or More Races ,77,30,47,56,32,43
2010,Lexington city,51678,Two or More Races ,68,0,68,58,127,58
2010,Lynchburg city,51680,Two or More Races ,256,111,145,94,62,86
2010,Manassas city,51683,Two or More Races ,180,133,47,96,87,50
2010,Manassas Park city,51685,Two or More Races ,96,87,9,69,68,13
2010,Martinsville city,51690,Two or More Races ,70,27,43,96,40,78
2010,Newport News city,51700,Two or More Races ,1260,666,594,285,178,194
2010,Norfolk city,51710,Two or More Races ,1241,587,654,195,142,136
2010,Norton city,51720,Two or More Races ,40,21,19,39,25,30
2010,Petersburg city,51730,Two or More Races ,75,37,38,50,42,30
2010,Poquoson city,51735,Two or More Races ,57,57,0,48,48,127
2010,Portsmouth city,51740,Two or More Races ,585,333,252,164,118,119
2010,Radford city,51750,Two or More Races ,37,12,25,41,21,35
2010,Richmond city,51760,Two or More Races ,1741,555,1186,325,171,271
2010,Roanoke city,51770,Two or More Races ,461,216,245,164,99,138
2010,Salem city,51775,Two or More Races ,179,40,139,106,37,98
2010,Staunton city,51790,Two or More Races ,72,44,28,70,53,38
2010,Suffolk city,51800,Two or More Races ,290,258,32,100,97,34
2010,Virginia Beach city,51810,Two or More Races ,3484,1978,1506,424,264,298
2010,Waynesboro city,51820,Two or More Races ,103,93,10,82,82,17
2010,Williamsburg city,51830,Two or More Races ,59,15,44,48,24,41
2010,Winchester city,51840,Two or More Races ,101,5,96,91,17,86
2011,Accomack County,51001,Two or More Races ,117,47,70,84,51,68
2011,Albemarle County,51003,Two or More Races ,404,129,275,142,75,111
2011,Alleghany County,51005,Two or More Races ,5,5,0,10,10,95
2011,Amelia County,51007,Two or More Races ,0,0,0,95,95,95
2011,Amherst County,51009,Two or More Races ,81,50,31,63,52,36
2011,Appomattox County,51011,Two or More Races ,6,6,0,13,13,95
2011,Arlington County,51013,Two or More Races ,2150,813,1337,310,196,255
2011,Augusta County,51015,Two or More Races ,126,126,0,100,100,95
2011,Bath County,51017,Two or More Races ,0,0,0,95,95,95
2011,Bedford County,51019,Two or More Races ,222,215,7,73,74,13
2011,Bland County,51021,Two or More Races ,0,0,0,95,95,95
2011,Botetourt County,51023,Two or More Races ,60,60,0,51,51,95
2011,Brunswick County,51025,Two or More Races ,25,10,15,31,24,20
2011,Buchanan County,51027,Two or More Races ,0,0,0,95,95,95
2011,Buckingham County,51029,Two or More Races ,23,23,0,36,36,95
2011,Campbell County,51031,Two or More Races ,64,28,36,53,29,40
2011,Caroline County,51033,Two or More Races ,150,147,3,75,74,7
2011,Carroll County,51035,Two or More Races ,70,0,70,77,95,77
2011,Charles City County,51036,Two or More Races ,52,32,20,25,18,20
2011,Charlotte County,51037,Two or More Races ,17,6,11,14,8,11
2011,Chesterfield County,51041,Two or More Races ,1191,755,436,254,184,188
2011,Clarke County,51043,Two or More Races ,48,33,15,41,33,23
2011,Craig County,51045,Two or More Races ,0,0,0,95,95,95
2011,Culpeper County,51047,Two or More Races ,274,173,101,86,77,79
2011,Cumberland County,51049,Two or More Races ,55,17,38,50,23,47
2011,Dickenson County,51051,Two or More Races ,25,21,4,13,12,7
2011,Dinwiddie County,51053,Two or More Races ,61,52,9,52,48,16
2011,Essex County,51057,Two or More Races ,58,41,17,46,32,27
2011,Fairfax County,51059,Two or More Races ,7976,4684,3292,650,475,459
2011,Fauquier County,51061,Two or More Races ,254,168,86,123,86,81
2011,Floyd County,51063,Two or More Races ,42,18,24,57,30,39
2011,Fluvanna County,51065,Two or More Races ,98,91,7,58,59,10
2011,Franklin County,51067,Two or More Races ,99,89,10,59,62,15
2011,Frederick County,51069,Two or More Races ,288,179,109,87,90,72
2011,Giles County,51071,Two or More Races ,54,31,23,34,30,26
2011,Gloucester County,51073,Two or More Races ,140,103,37,82,64,49
2011,Goochland County,51075,Two or More Races ,81,69,12,54,49,19
2011,Grayson County,51077,Two or More Races ,8,3,5,14,7,11
2011,Greene County,51079,Two or More Races ,55,55,0,78,78,95
2011,Greensville County,51081,Two or More Races ,8,8,0,13,13,95
2011,Halifax County,51083,Two or More Races ,65,65,0,54,54,95
2011,Hanover County,51085,Two or More Races ,349,196,153,106,93,70
2011,Henrico County,51087,Two or More Races ,1316,433,883,222,131,215
2011,Henry County,51089,Two or More Races ,168,117,51,77,71,35
2011,Highland County,51091,Two or More Races ,34,34,0,48,48,95
2011,Isle of Wight County,51093,Two or More Races ,106,82,24,61,62,39
2011,James City County,51095,Two or More Races ,180,142,38,96,87,43
2011,King and Queen County,51097,Two or More Races ,0,0,0,95,95,95
2011,King George County,51099,Two or More Races ,158,106,52,75,77,34
2011,King William County,51101,Two or More Races ,36,14,22,27,14,26
2011,Lancaster County,51103,Two or More Races ,43,30,13,37,30,20
2011,Lee County,51105,Two or More Races ,95,95,0,159,159,95
2011,Loudoun County,51107,Two or More Races ,1740,1344,396,367,324,142
2011,Louisa County,51109,Two or More Races ,150,57,93,96,48,77
2011,Lunenburg County,51111,Two or More Races ,71,67,4,51,51,6
2011,Madison County,51113,Two or More Races ,52,24,28,49,39,26
2011,Mathews County,51115,Two or More Races ,7,0,7,19,95,19
2011,Mecklenburg County,51117,Two or More Races ,44,32,12,30,26,17
2011,Middlesex County,51119,Two or More Races ,9,9,0,15,15,95
2011,Montgomery County,51121,Two or More Races ,541,187,354,190,108,172
2011,Nelson County,51125,Two or More Races ,57,57,0,56,56,95
2011,New Kent County,51127,Two or More Races ,53,53,0,41,41,95
2011,Northampton County,51131,Two or More Races ,20,15,5,34,33,7
2011,Northumberland County,51133,Two or More Races ,11,11,0,19,19,95
2011,Nottoway County,51135,Two or More Races ,15,8,7,17,15,10
2011,Orange County,51137,Two or More Races ,97,82,15,66,61,27
2011,Page County,51139,Two or More Races ,57,54,3,48,48,6
2011,Patrick County,51141,Two or More Races ,38,38,0,39,39,95
2011,Pittsylvania County,51143,Two or More Races ,178,135,43,65,67,33
2011,Powhatan County,51145,Two or More Races ,83,83,0,46,46,95
2011,Prince Edward County,51147,Two or More Races ,33,9,24,39,16,36
2011,Prince George County,51149,Two or More Races ,84,74,10,53,46,18
2011,Prince William County,51153,Two or More Races ,3070,2038,1032,394,303,246
2011,Pulaski County,51155,Two or More Races ,116,58,58,67,48,52
2011,Rappahannock County,51157,Two or More Races ,43,10,33,59,15,56
2011,Richmond County,51159,Two or More Races ,39,39,0,37,37,95
2011,Roanoke County,51161,Two or More Races ,185,71,114,85,51,58
2011,Rockbridge County,51163,Two or More Races ,59,40,19,48,39,30
2011,Rockingham County,51165,Two or More Races ,136,102,34,66,56,31
2011,Russell County,51167,Two or More Races ,16,16,0,28,28,95
2011,Scott County,51169,Two or More Races ,65,40,25,34,30,22
2011,Shenandoah County,51171,Two or More Races ,83,8,75,46,14,46
2011,Smyth County,51173,Two or More Races ,55,7,48,36,11,33
2011,Southampton County,51175,Two or More Races ,43,43,0,25,25,95
2011,Spotsylvania County,51177,Two or More Races ,365,304,61,145,135,53
2011,Stafford County,51179,Two or More Races ,588,426,162,152,128,71
2011,Surry County,51181,Two or More Races ,31,21,10,28,24,17
2011,Sussex County,51183,Two or More Races ,3,3,0,5,5,95
2011,Tazewell County,51185,Two or More Races ,101,94,7,68,66,11
2011,Warren County,51187,Two or More Races ,119,100,19,51,48,22
2011,Washington County,51191,Two or More Races ,114,62,52,45,51,56
2011,Westmoreland County,51193,Two or More Races ,64,64,0,51,51,95
2011,Wise County,51195,Two or More Races ,112,44,68,53,38,50
2011,Wythe County,51197,Two or More Races ,3,3,0,11,11,95
2011,York County,51199,Two or More Races ,445,307,138,134,112,88
2011,Alexandria city,51510,Two or More Races ,1576,587,989,346,154,278
2011,Bedford County,51019,Two or More Races ,18,18,0,34,34,95
2011,Bristol city,51520,Two or More Races ,29,11,18,37,17,34
2011,Buena Vista city,51530,Two or More Races ,72,37,35,72,52,50
2011,Charlottesville city,51540,Two or More Races ,250,36,214,97,45,88
2011,Chesapeake city,51550,Two or More Races ,1242,860,382,230,190,165
2011,Colonial Heights city,51570,Two or More Races ,43,7,36,36,11,33
2011,Covington city,51580,Two or More Races ,53,29,24,45,33,32
2011,Danville city,51590,Two or More Races ,150,62,88,40,40,36
2011,Emporia city,51595,Two or More Races ,23,12,11,39,36,17
2011,Fairfax city,51600,Two or More Races ,166,90,76,72,49,56
2011,Falls Church city,51610,Two or More Races ,61,51,10,48,44,16
2011,Franklin city,51620,Two or More Races ,9,9,0,15,15,95
2011,Fredericksburg city,51630,Two or More Races ,152,81,71,85,55,67
2011,Galax city,51640,Two or More Races ,0,0,0,95,95,95
2011,Hampton city,51650,Two or More Races ,721,411,310,153,119,107
2011,Harrisonburg city,51660,Two or More Races ,159,47,112,107,54,90
2011,Hopewell city,51670,Two or More Races ,37,37,0,46,46,95
2011,Lexington city,51678,Two or More Races ,50,8,42,58,12,56
2011,Lynchburg city,51680,Two or More Races ,258,121,137,103,60,84
2011,Manassas city,51683,Two or More Races ,215,125,90,111,89,64
2011,Manassas Park city,51685,Two or More Races ,123,104,19,65,55,27
2011,Martinsville city,51690,Two or More Races ,87,43,44,106,48,87
2011,Newport News city,51700,Two or More Races ,1347,766,581,246,206,146
2011,Norfolk city,51710,Two or More Races ,1331,569,762,218,135,174
2011,Norton city,51720,Two or More Races ,60,31,29,76,64,48
2011,Petersburg city,51730,Two or More Races ,74,36,38,53,43,28
2011,Poquoson city,51735,Two or More Races ,70,70,0,58,58,95
2011,Portsmouth city,51740,Two or More Races ,723,421,302,201,150,139
2011,Radford city,51750,Two or More Races ,64,9,55,66,15,64
2011,Richmond city,51760,Two or More Races ,1800,447,1353,259,149,285
2011,Roanoke city,51770,Two or More Races ,588,259,329,213,136,156
2011,Salem city,51775,Two or More Races ,143,10,133,91,16,89
2011,Staunton city,51790,Two or More Races ,56,20,36,45,23,33
2011,Suffolk city,51800,Two or More Races ,564,366,198,183,110,153
2011,Virginia Beach city,51810,Two or More Races ,3350,1826,1524,443,312,333
2011,Waynesboro city,51820,Two or More Races ,106,101,5,73,72,9
2011,Williamsburg city,51830,Two or More Races ,24,0,24,33,95,33
2011,Winchester city,51840,Two or More Races ,107,26,81,66,23,68
2012,Accomack County,51001,Two or More Races ,160,71,89,119,58,104
2012,Albemarle County,51003,Two or More Races ,426,181,245,120,80,102
2012,Alleghany County,51005,Two or More Races ,9,9,0,12,12,19
2012,Amelia County,51007,Two or More Races ,0,0,0,19,19,19
2012,Amherst County,51009,Two or More Races ,98,75,23,72,64,29
2012,Appomattox County,51011,Two or More Races ,9,9,0,13,13,19
2012,Arlington County,51013,Two or More Races ,1937,727,1210,305,208,254
2012,Augusta County,51015,Two or More Races ,110,101,9,87,86,14
2012,Bath County,51017,Two or More Races ,0,0,0,12,12,12
2012,Bedford County,51019,Two or More Races ,268,241,27,96,95,35
2012,Bland County,51021,Two or More Races ,0,0,0,17,17,17
2012,Botetourt County,51023,Two or More Races ,68,68,0,45,45,26
2012,Brunswick County,51025,Two or More Races ,22,10,12,25,19,17
2012,Buchanan County,51027,Two or More Races ,4,4,0,8,8,23
2012,Buckingham County,51029,Two or More Races ,44,18,26,53,27,47
2012,Campbell County,51031,Two or More Races ,69,52,17,52,48,23
2012,Caroline County,51033,Two or More Races ,167,137,30,81,77,25
2012,Carroll County,51035,Two or More Races ,1,1,0,4,4,23
2012,Charles City County,51036,Two or More Races ,47,32,15,23,17,17
2012,Charlotte County,51037,Two or More Races ,24,12,12,20,15,15
2012,Chesterfield County,51041,Two or More Races ,1337,820,517,287,191,190
2012,Clarke County,51043,Two or More Races ,34,25,9,32,28,16
2012,Craig County,51045,Two or More Races ,14,14,0,18,18,17
2012,Culpeper County,51047,Two or More Races ,276,165,111,122,103,77
2012,Cumberland County,51049,Two or More Races ,73,20,53,64,31,57
2012,Dickenson County,51051,Two or More Races ,44,35,9,33,30,15
2012,Dinwiddie County,51053,Two or More Races ,67,38,29,51,35,33
2012,Essex County,51057,Two or More Races ,59,42,17,48,34,28
2012,Fairfax County,51059,Two or More Races ,9178,5187,3991,672,497,459
2012,Fauquier County,51061,Two or More Races ,201,106,95,110,63,78
2012,Floyd County,51063,Two or More Races ,40,18,22,46,31,36
2012,Fluvanna County,51065,Two or More Races ,94,82,12,60,61,19
2012,Franklin County,51067,Two or More Races ,152,105,47,69,64,42
2012,Frederick County,51069,Two or More Races ,385,250,135,169,158,70
2012,Giles County,51071,Two or More Races ,47,30,17,35,31,20
2012,Gloucester County,51073,Two or More Races ,130,78,52,65,41,50
2012,Goochland County,51075,Two or More Races ,81,68,13,64,59,20
2012,Grayson County,51077,Two or More Races ,11,6,5,16,13,10
2012,Greene County,51079,Two or More Races ,90,90,0,108,108,19
2012,Greensville County,51081,Two or More Races ,15,15,0,16,16,19
2012,Halifax County,51083,Two or More Races ,24,24,0,25,25,26
2012,Hanover County,51085,Two or More Races ,313,137,176,96,72,87
2012,Henrico County,51087,Two or More Races ,1517,534,983,268,151,230
2012,Henry County,51089,Two or More Races ,194,140,54,85,72,39
2012,Highland County,51091,Two or More Races ,17,17,0,24,24,12
2012,Isle of Wight County,51093,Two or More Races ,103,78,25,52,40,37
2012,James City County,51095,Two or More Races ,121,76,45,70,55,38
2012,King and Queen County,51097,Two or More Races ,0,0,0,17,17,17
2012,King George County,51099,Two or More Races ,146,105,41,82,83,21
2012,King William County,51101,Two or More Races ,55,11,44,36,13,35
2012,Lancaster County,51103,Two or More Races ,47,30,17,30,26,17
2012,Lee County,51105,Two or More Races ,94,94,0,147,147,23
2012,Loudoun County,51107,Two or More Races ,1894,1404,490,287,234,153
2012,Louisa County,51109,Two or More Races ,132,33,99,74,34,69
2012,Lunenburg County,51111,Two or More Races ,77,72,5,44,42,8
2012,Madison County,51113,Two or More Races ,64,0,64,60,19,60
2012,Mathews County,51115,Two or More Races ,17,0,17,30,17,30
2012,Mecklenburg County,51117,Two or More Races ,49,31,18,31,24,22
2012,Middlesex County,51119,Two or More Races ,6,6,0,10,10,19
2012,Montgomery County,51121,Two or More Races ,566,167,399,182,89,155
2012,Nelson County,51125,Two or More Races ,54,54,0,58,58,19
2012,New Kent County,51127,Two or More Races ,71,71,0,58,58,19
2012,Northampton County,51131,Two or More Races ,5,0,5,7,19,7
2012,Northumberland County,51133,Two or More Races ,9,9,0,16,16,19
2012,Nottoway County,51135,Two or More Races ,42,32,10,29,28,12
2012,Orange County,51137,Two or More Races ,154,141,13,85,82,24
2012,Page County,51139,Two or More Races ,79,61,18,55,51,27
2012,Patrick County,51141,Two or More Races ,14,14,0,16,16,19
2012,Pittsylvania County,51143,Two or More Races ,256,144,112,103,65,79
2012,Powhatan County,51145,Two or More Races ,77,59,18,47,33,26
2012,Prince Edward County,51147,Two or More Races ,40,8,32,38,14,36
2012,Prince George County,51149,Two or More Races ,68,51,17,43,41,14
2012,Prince William County,51153,Two or More Races ,3411,2121,1290,416,290,249
2012,Pulaski County,51155,Two or More Races ,145,68,77,87,60,75
2012,Rappahannock County,51157,Two or More Races ,29,12,17,38,20,30
2012,Richmond County,51159,Two or More Races ,46,46,0,45,45,17
2012,Roanoke County,51161,Two or More Races ,239,110,129,100,61,85
2012,Rockbridge County,51163,Two or More Races ,66,45,21,42,37,25
2012,Rockingham County,51165,Two or More Races ,171,127,44,80,80,33
2012,Russell County,51167,Two or More Races ,6,6,0,12,12,23
2012,Scott County,51169,Two or More Races ,83,62,21,58,48,25
2012,Shenandoah County,51171,Two or More Races ,106,21,85,46,19,46
2012,Smyth County,51173,Two or More Races ,40,13,27,38,15,34
2012,Southampton County,51175,Two or More Races ,48,45,3,29,30,7
2012,Spotsylvania County,51177,Two or More Races ,371,295,76,144,123,74
2012,Stafford County,51179,Two or More Races ,642,484,158,143,123,80
2012,Surry County,51181,Two or More Races ,24,24,0,26,26,17
2012,Sussex County,51183,Two or More Races ,5,4,1,7,6,4
2012,Tazewell County,51185,Two or More Races ,159,151,8,77,74,16
2012,Warren County,51187,Two or More Races ,128,81,47,66,48,48
2012,Washington County,51191,Two or More Races ,149,72,77,74,56,69
2012,Westmoreland County,51193,Two or More Races ,54,54,0,51,51,19
2012,Wise County,51195,Two or More Races ,69,47,22,41,36,23
2012,Wythe County,51197,Two or More Races ,3,3,0,8,8,23
2012,York County,51199,Two or More Races ,521,365,156,130,111,82
2012,Alexandria city,51510,Two or More Races ,1849,680,1169,348,180,279
2012,Bedford County,51019,Two or More Races ,8,8,0,13,13,17
2012,Bristol city,51520,Two or More Races ,26,10,16,31,17,25
2012,Buena Vista city,51530,Two or More Races ,31,0,31,44,17,44
2012,Charlottesville city,51540,Two or More Races ,229,16,213,92,23,90
2012,Chesapeake city,51550,Two or More Races ,1309,880,429,288,211,161
2012,Colonial Heights city,51570,Two or More Races ,44,14,30,32,16,32
2012,Covington city,51580,Two or More Races ,74,43,31,42,37,29
2012,Danville city,51590,Two or More Races ,158,83,75,52,46,32
2012,Emporia city,51595,Two or More Races ,6,6,0,11,11,17
2012,Fairfax city,51600,Two or More Races ,110,72,38,62,46,37
2012,Falls Church city,51610,Two or More Races ,55,38,17,45,40,21
2012,Franklin city,51620,Two or More Races ,8,8,0,12,12,17
2012,Fredericksburg city,51630,Two or More Races ,201,113,88,105,74,80
2012,Galax city,51640,Two or More Races ,42,42,0,40,40,17
2012,Hampton city,51650,Two or More Races ,807,500,307,212,158,124
2012,Harrisonburg city,51660,Two or More Races ,146,26,120,75,29,68
2012,Hopewell city,51670,Two or More Races ,48,48,0,47,47,23
2012,Lexington city,51678,Two or More Races ,46,7,39,38,13,33
2012,Lynchburg city,51680,Two or More Races ,260,57,203,102,40,99
2012,Manassas city,51683,Two or More Races ,206,111,95,96,71,66
2012,Manassas Park city,51685,Two or More Races ,163,113,50,77,70,50
2012,Martinsville city,51690,Two or More Races ,159,60,99,152,68,128
2012,Newport News city,51700,Two or More Races ,1522,641,881,279,184,231
2012,Norfolk city,51710,Two or More Races ,1559,726,833,237,175,182
2012,Norton city,51720,Two or More Races ,34,24,10,35,31,17
2012,Petersburg city,51730,Two or More Races ,61,35,26,45,38,23
2012,Poquoson city,51735,Two or More Races ,62,51,11,47,45,17
2012,Portsmouth city,51740,Two or More Races ,676,347,329,180,127,125
2012,Radford city,51750,Two or More Races ,69,10,59,60,17,52
2012,Richmond city,51760,Two or More Races ,1784,482,1302,296,114,286
2012,Roanoke city,51770,Two or More Races ,756,299,457,212,104,190
2012,Salem city,51775,Two or More Races ,127,20,107,92,25,89
2012,Staunton city,51790,Two or More Races ,111,64,47,65,56,35
2012,Suffolk city,51800,Two or More Races ,544,374,170,147,111,100
2012,Virginia Beach city,51810,Two or More Races ,3662,1897,1765,469,323,343
2012,Waynesboro city,51820,Two or More Races ,94,79,15,73,70,20
2012,Williamsburg city,51830,Two or More Races ,29,0,29,28,19,28
2012,Winchester city,51840,Two or More Races ,105,28,77,67,22,69
2013,Accomack County,51001,Two or More Races ,125,105,20,60,56,17
2013,Albemarle County,51003,Two or More Races ,581,197,384,181,87,141
2013,Alleghany County,51005,Two or More Races ,10,10,0,13,13,19
2013,Amelia County,51007,Two or More Races ,39,39,0,45,45,19
2013,Amherst County,51009,Two or More Races ,73,65,8,54,53,13
2013,Appomattox County,51011,Two or More Races ,14,14,0,16,16,19
2013,Arlington County,51013,Two or More Races ,2081,833,1248,316,191,238
2013,Augusta County,51015,Two or More Races ,93,77,16,84,81,21
2013,Bath County,51017,Two or More Races ,20,0,20,31,12,31
2013,Bedford County,51019,Two or More Races ,274,212,62,118,96,69
2013,Bland County,51021,Two or More Races ,0,0,0,17,17,17
2013,Botetourt County,51023,Two or More Races ,67,67,0,37,37,26
2013,Brunswick County,51025,Two or More Races ,17,9,8,16,15,10
2013,Buchanan County,51027,Two or More Races ,11,11,0,16,16,23
2013,Buckingham County,51029,Two or More Races ,37,20,17,40,31,27
2013,Campbell County,51031,Two or More Races ,184,151,33,76,73,44
2013,Caroline County,51033,Two or More Races ,182,124,58,87,77,37
2013,Carroll County,51035,Two or More Races ,1,1,0,3,3,23
2013,Charles City County,51036,Two or More Races ,47,44,3,20,20,4
2013,Charlotte County,51037,Two or More Races ,33,21,12,30,27,13
2013,Chesterfield County,51041,Two or More Races ,1520,933,587,266,194,191
2013,Clarke County,51043,Two or More Races ,45,43,2,35,36,4
2013,Craig County,51045,Two or More Races ,29,29,0,20,20,17
2013,Culpeper County,51047,Two or More Races ,261,149,112,95,88,74
2013,Cumberland County,51049,Two or More Races ,32,24,8,40,35,13
2013,Dickenson County,51051,Two or More Races ,45,34,11,21,21,19
2013,Dinwiddie County,51053,Two or More Races ,88,49,39,55,41,40
2013,Essex County,51057,Two or More Races ,50,50,0,36,36,19
2013,Fairfax County,51059,Two or More Races ,9366,5416,3950,574,459,433
2013,Fauquier County,51061,Two or More Races ,348,261,87,118,84,71
2013,Floyd County,51063,Two or More Races ,95,79,16,78,78,26
2013,Fluvanna County,51065,Two or More Races ,126,92,34,66,53,42
2013,Franklin County,51067,Two or More Races ,152,102,50,65,60,40
2013,Frederick County,51069,Two or More Races ,272,194,78,120,122,48
2013,Giles County,51071,Two or More Races ,35,14,21,35,23,27
2013,Gloucester County,51073,Two or More Races ,102,76,26,56,48,25
2013,Goochland County,51075,Two or More Races ,32,32,0,36,36,23
2013,Grayson County,51077,Two or More Races ,15,7,8,22,18,13
2013,Greene County,51079,Two or More Races ,107,107,0,84,84,19
2013,Greensville County,51081,Two or More Races ,11,11,0,16,16,19
2013,Halifax County,51083,Two or More Races ,28,28,0,30,30,26
2013,Hanover County,51085,Two or More Races ,362,177,185,109,74,77
2013,Henrico County,51087,Two or More Races ,1785,597,1188,322,151,285
2013,Henry County,51089,Two or More Races ,209,132,77,88,68,51
2013,Highland County,51091,Two or More Races ,3,3,0,5,5,12
2013,Isle of Wight County,51093,Two or More Races ,174,145,29,64,58,44
2013,James City County,51095,Two or More Races ,164,125,39,76,67,32
2013,King and Queen County,51097,Two or More Races ,0,0,0,17,17,17
2013,King George County,51099,Two or More Races ,164,139,25,80,84,17
2013,King William County,51101,Two or More Races ,49,12,37,31,14,31
2013,Lancaster County,51103,Two or More Races ,54,38,16,36,32,16
2013,Lee County,51105,Two or More Races ,46,46,0,68,68,23
2013,Loudoun County,51107,Two or More Races ,2330,1766,564,286,246,152
2013,Louisa County,51109,Two or More Races ,108,53,55,69,49,51
2013,Lunenburg County,51111,Two or More Races ,80,69,11,43,42,12
2013,Madison County,51113,Two or More Races ,66,12,54,48,19,48
2013,Mathews County,51115,Two or More Races ,33,11,22,43,21,38
2013,Mecklenburg County,51117,Two or More Races ,56,39,17,36,27,22
2013,Middlesex County,51119,Two or More Races ,13,13,0,15,15,19
2013,Montgomery County,51121,Two or More Races ,573,176,397,184,98,148
2013,Nelson County,51125,Two or More Races ,48,48,0,49,49,19
2013,New Kent County,51127,Two or More Races ,73,73,0,47,47,19
2013,Northampton County,51131,Two or More Races ,0,0,0,19,19,19
2013,Northumberland County,51133,Two or More Races ,9,9,0,14,14,19
2013,Nottoway County,51135,Two or More Races ,74,35,39,55,33,43
2013,Orange County,51137,Two or More Races ,133,92,41,88,70,41
2013,Page County,51139,Two or More Races ,110,29,81,69,28,65
2013,Patrick County,51141,Two or More Races ,63,51,12,47,42,20
2013,Pittsylvania County,51143,Two or More Races ,204,112,92,94,66,77
2013,Powhatan County,51145,Two or More Races ,91,56,35,55,31,45
2013,Prince Edward County,51147,Two or More Races ,58,11,47,50,16,47
2013,Prince George County,51149,Two or More Races ,110,94,16,68,69,16
2013,Prince William County,51153,Two or More Races ,3461,2062,1399,479,334,319
2013,Pulaski County,51155,Two or More Races ,130,78,52,74,57,63
2013,Rappahannock County,51157,Two or More Races ,60,9,51,55,14,53
2013,Richmond County,51159,Two or More Races ,36,36,0,55,55,17
2013,Roanoke County,51161,Two or More Races ,383,190,193,138,94,102
2013,Rockbridge County,51163,Two or More Races ,138,111,27,68,67,40
2013,Rockingham County,51165,Two or More Races ,212,153,59,74,69,32
2013,Russell County,51167,Two or More Races ,9,9,0,22,22,23
2013,Scott County,51169,Two or More Races ,86,68,18,61,57,22
2013,Shenandoah County,51171,Two or More Races ,134,54,80,58,43,46
2013,Smyth County,51173,Two or More Races ,75,19,56,54,27,46
2013,Southampton County,51175,Two or More Races ,46,38,8,29,26,12
2013,Spotsylvania County,51177,Two or More Races ,445,348,97,146,114,68
2013,Stafford County,51179,Two or More Races ,696,502,194,165,131,82
2013,Surry County,51181,Two or More Races ,10,10,0,15,15,17
2013,Sussex County,51183,Two or More Races ,4,3,1,5,4,2
2013,Tazewell County,51185,Two or More Races ,207,201,6,98,95,12
2013,Warren County,51187,Two or More Races ,194,137,57,78,64,47
2013,Washington County,51191,Two or More Races ,137,66,71,74,46,66
2013,Westmoreland County,51193,Two or More Races ,37,37,0,30,30,19
2013,Wise County,51195,Two or More Races ,63,45,18,38,33,19
2013,Wythe County,51197,Two or More Races ,7,7,0,12,12,23
2013,York County,51199,Two or More Races ,535,306,229,151,108,101
2013,Alexandria city,51510,Two or More Races ,1951,626,1325,357,158,308
2013,Bedford County,51019,Two or More Races ,9,9,0,14,14,17
2013,Bristol city,51520,Two or More Races ,21,6,15,27,10,24
2013,Buena Vista city,51530,Two or More Races ,87,43,44,85,54,65
2013,Charlottesville city,51540,Two or More Races ,184,17,167,96,23,92
2013,Chesapeake city,51550,Two or More Races ,1426,1011,415,224,185,121
2013,Colonial Heights city,51570,Two or More Races ,45,26,19,31,24,24
2013,Covington city,51580,Two or More Races ,71,28,43,56,29,48
2013,Danville city,51590,Two or More Races ,147,88,59,49,45,37
2013,Emporia city,51595,Two or More Races ,1,1,0,4,4,17
2013,Fairfax city,51600,Two or More Races ,118,73,45,55,39,35
2013,Falls Church city,51610,Two or More Races ,156,43,113,87,44,75
2013,Franklin city,51620,Two or More Races ,14,14,0,19,19,17
2013,Fredericksburg city,51630,Two or More Races ,190,105,85,80,70,57
2013,Galax city,51640,Two or More Races ,35,35,0,36,36,17
2013,Hampton city,51650,Two or More Races ,937,630,307,165,136,102
2013,Harrisonburg city,51660,Two or More Races ,249,54,195,116,61,100
2013,Hopewell city,51670,Two or More Races ,64,64,0,53,53,23
2013,Lexington city,51678,Two or More Races ,39,5,34,36,10,32
2013,Lynchburg city,51680,Two or More Races ,321,70,251,129,43,122
2013,Manassas city,51683,Two or More Races ,199,97,102,81,59,63
2013,Manassas Park city,51685,Two or More Races ,146,104,42,82,72,40
2013,Martinsville city,51690,Two or More Races ,56,56,0,44,44,19
2013,Newport News city,51700,Two or More Races ,1826,699,1127,329,202,263
2013,Norfolk city,51710,Two or More Races ,1818,813,1005,271,186,176
2013,Norton city,51720,Two or More Races ,7,7,0,17,17,12
2013,Petersburg city,51730,Two or More Races ,149,45,104,90,40,79
2013,Poquoson city,51735,Two or More Races ,42,38,4,37,33,9
2013,Portsmouth city,51740,Two or More Races ,683,353,330,180,142,103
2013,Radford city,51750,Two or More Races ,79,8,71,59,14,59
2013,Richmond city,51760,Two or More Races ,2156,588,1568,320,149,303
2013,Roanoke city,51770,Two or More Races ,798,245,553,221,100,205
2013,Salem city,51775,Two or More Races ,69,41,28,63,42,48
2013,Staunton city,51790,Two or More Races ,119,59,60,80,60,46
2013,Suffolk city,51800,Two or More Races ,643,374,269,177,123,129
2013,Virginia Beach city,51810,Two or More Races ,3555,1773,1782,425,281,292
2013,Waynesboro city,51820,Two or More Races ,119,99,20,61,63,28
2013,Williamsburg city,51830,Two or More Races ,22,0,22,24,19,24
2013,Winchester city,51840,Two or More Races ,169,49,120,87,38,77
2014,Accomack County,51001,Two or More Races ,170,109,61,68,51,47
2014,Albemarle County,51003,Two or More Races ,525,221,304,152,93,132
2014,Alleghany County,51005,Two or More Races ,9,9,0,11,11,19
2014,Amelia County,51007,Two or More Races ,41,41,0,50,50,19
2014,Amherst County,51009,Two or More Races ,64,59,5,39,36,10
2014,Appomattox County,51011,Two or More Races ,16,16,0,16,16,19
2014,Arlington County,51013,Two or More Races ,1964,865,1099,327,201,255
2014,Augusta County,51015,Two or More Races ,106,71,35,76,62,36
2014,Bath County,51017,Two or More Races ,13,0,13,22,12,22
2014,Bedford County,51019,Two or More Races ,231,182,49,104,84,58
2014,Bland County,51021,Two or More Races ,0,0,0,17,17,17
2014,Botetourt County,51023,Two or More Races ,42,42,0,35,35,25
2014,Brunswick County,51025,Two or More Races ,41,36,5,47,46,7
2014,Buchanan County,51027,Two or More Races ,18,8,10,25,15,16
2014,Buckingham County,51029,Two or More Races ,27,16,11,29,24,19
2014,Campbell County,51031,Two or More Races ,219,134,85,73,70,71
2014,Caroline County,51033,Two or More Races ,219,151,68,101,81,48
2014,Carroll County,51035,Two or More Races ,29,29,0,34,34,22
2014,Charles City County,51036,Two or More Races ,57,54,3,20,20,4
2014,Charlotte County,51037,Two or More Races ,36,24,12,32,29,10
2014,Chesterfield County,51041,Two or More Races ,1800,1057,743,353,227,232
2014,Clarke County,51043,Two or More Races ,35,34,1,24,23,3
2014,Craig County,51045,Two or More Races ,37,37,0,21,21,17
2014,Culpeper County,51047,Two or More Races ,354,205,149,136,110,87
2014,Cumberland County,51049,Two or More Races ,15,5,10,18,9,16
2014,Dickenson County,51051,Two or More Races ,14,13,1,17,17,2
2014,Dinwiddie County,51053,Two or More Races ,67,31,36,40,31,35
2014,Essex County,51057,Two or More Races ,43,43,0,32,32,19
2014,Fairfax County,51059,Two or More Races ,10150,5664,4486,678,432,493
2014,Fauquier County,51061,Two or More Races ,365,280,85,97,79,59
2014,Floyd County,51063,Two or More Races ,67,67,0,56,56,19
2014,Fluvanna County,51065,Two or More Races ,209,136,73,94,79,70
2014,Franklin County,51067,Two or More Races ,137,84,53,58,49,45
2014,Frederick County,51069,Two or More Races ,259,189,70,108,93,52
2014,Giles County,51071,Two or More Races ,11,11,0,17,17,19
2014,Gloucester County,51073,Two or More Races ,131,104,27,74,63,27
2014,Goochland County,51075,Two or More Races ,24,24,0,26,26,22
2014,Grayson County,51077,Two or More Races ,64,29,35,48,33,44
2014,Greene County,51079,Two or More Races ,61,61,0,43,43,19
2014,Greensville County,51081,Two or More Races ,12,12,0,20,20,19
2014,Halifax County,51083,Two or More Races ,39,28,11,33,28,17
2014,Hanover County,51085,Two or More Races ,396,230,166,92,83,68
2014,Henrico County,51087,Two or More Races ,1964,837,1127,295,194,238
2014,Henry County,51089,Two or More Races ,196,120,76,69,62,54
2014,Highland County,51091,Two or More Races ,4,4,0,7,7,12
2014,Isle of Wight County,51093,Two or More Races ,188,116,72,79,56,60
2014,James City County,51095,Two or More Races ,202,160,42,106,101,40
2014,King and Queen County,51097,Two or More Races ,21,21,0,28,28,17
2014,King George County,51099,Two or More Races ,223,170,53,116,108,38
2014,King William County,51101,Two or More Races ,78,43,35,41,32,28
2014,Lancaster County,51103,Two or More Races ,39,20,19,24,19,17
2014,Lee County,51105,Two or More Races ,121,121,0,189,189,22
2014,Loudoun County,51107,Two or More Races ,2649,1938,711,350,309,139
2014,Louisa County,51109,Two or More Races ,103,61,42,56,43,42
2014,Lunenburg County,51111,Two or More Races ,58,54,4,39,38,7
2014,Madison County,51113,Two or More Races ,101,49,52,62,44,49
2014,Mathews County,51115,Two or More Races ,28,11,17,36,18,32
2014,Mecklenburg County,51117,Two or More Races ,80,24,56,55,19,51
2014,Middlesex County,51119,Two or More Races ,11,11,0,13,13,19
2014,Montgomery County,51121,Two or More Races ,556,137,419,199,75,185
2014,Nelson County,51125,Two or More Races ,45,45,0,49,49,19
2014,New Kent County,51127,Two or More Races ,141,137,4,65,64,7
2014,Northampton County,51131,Two or More Races ,24,24,0,31,31,19
2014,Northumberland County,51133,Two or More Races ,0,0,0,19,19,19
2014,Nottoway County,51135,Two or More Races ,93,39,54,68,34,54
2014,Orange County,51137,Two or More Races ,120,43,77,75,54,53
2014,Page County,51139,Two or More Races ,96,22,74,61,25,58
2014,Patrick County,51141,Two or More Races ,48,34,14,39,22,30
2014,Pittsylvania County,51143,Two or More Races ,204,106,98,87,55,73
2014,Powhatan County,51145,Two or More Races ,67,50,17,49,27,39
2014,Prince Edward County,51147,Two or More Races ,45,22,23,39,25,28
2014,Prince George County,51149,Two or More Races ,168,136,32,89,84,21
2014,Prince William County,51153,Two or More Races ,4433,2529,1904,451,334,365
2014,Pulaski County,51155,Two or More Races ,87,37,50,64,34,56
2014,Rappahannock County,51157,Two or More Races ,62,12,50,57,18,52
2014,Richmond County,51159,Two or More Races ,48,48,0,57,57,17
2014,Roanoke County,51161,Two or More Races ,398,209,189,128,80,91
2014,Rockbridge County,51163,Two or More Races ,127,91,36,50,57,29
2014,Rockingham County,51165,Two or More Races ,226,147,79,92,83,49
2014,Russell County,51167,Two or More Races ,22,4,18,16,9,13
2014,Scott County,51169,Two or More Races ,66,56,10,45,44,19
2014,Shenandoah County,51171,Two or More Races ,109,39,70,47,23,47
2014,Smyth County,51173,Two or More Races ,37,17,20,31,19,26
2014,Southampton County,51175,Two or More Races ,74,38,36,38,24,33
2014,Spotsylvania County,51177,Two or More Races ,540,445,95,152,124,72
2014,Stafford County,51179,Two or More Races ,726,567,159,173,150,83
2014,Surry County,51181,Two or More Races ,26,26,0,29,29,17
2014,Sussex County,51183,Two or More Races ,2,1,1,3,2,2
2014,Tazewell County,51185,Two or More Races ,220,210,10,109,110,17
2014,Warren County,51187,Two or More Races ,258,163,95,107,76,90
2014,Washington County,51191,Two or More Races ,112,77,35,61,44,49
2014,Westmoreland County,51193,Two or More Races ,40,40,0,35,35,19
2014,Wise County,51195,Two or More Races ,48,36,12,27,23,14
2014,Wythe County,51197,Two or More Races ,6,6,0,10,10,22
2014,York County,51199,Two or More Races ,469,218,251,135,81,115
2014,Alexandria city,51510,Two or More Races ,2081,735,1346,326,181,301
2014,Bristol city,51520,Two or More Races ,54,28,26,51,31,36
2014,Buena Vista city,51530,Two or More Races ,42,42,0,68,68,17
2014,Charlottesville city,51540,Two or More Races ,209,41,168,82,30,80
2014,Chesapeake city,51550,Two or More Races ,1374,935,439,266,201,153
2014,Colonial Heights city,51570,Two or More Races ,56,34,22,40,26,26
2014,Covington city,51580,Two or More Races ,95,71,24,58,56,27
2014,Danville city,51590,Two or More Races ,156,77,79,49,41,41
2014,Emporia city,51595,Two or More Races ,4,4,0,8,8,17
2014,Fairfax city,51600,Two or More Races ,160,118,42,60,51,41
2014,Falls Church city,51610,Two or More Races ,100,7,93,66,11,67
2014,Franklin city,51620,Two or More Races ,18,18,0,23,23,17
2014,Fredericksburg city,51630,Two or More Races ,234,132,102,111,84,67
2014,Galax city,51640,Two or More Races ,48,40,8,37,33,15
2014,Hampton city,51650,Two or More Races ,959,646,313,183,165,120
2014,Harrisonburg city,51660,Two or More Races ,282,50,232,131,56,122
2014,Hopewell city,51670,Two or More Races ,43,37,6,39,37,10
2014,Lexington city,51678,Two or More Races ,19,6,13,21,12,21
2014,Lynchburg city,51680,Two or More Races ,386,101,285,128,58,129
2014,Manassas city,51683,Two or More Races ,249,100,149,95,59,85
2014,Manassas Park city,51685,Two or More Races ,159,121,38,61,53,36
2014,Martinsville city,51690,Two or More Races ,80,80,0,53,53,19
2014,Newport News city,51700,Two or More Races ,1946,670,1276,302,184,231
2014,Norfolk city,51710,Two or More Races ,2130,778,1352,242,177,226
2014,Norton city,51720,Two or More Races ,0,0,0,12,12,12
2014,Petersburg city,51730,Two or More Races ,200,80,120,81,48,71
2014,Poquoson city,51735,Two or More Races ,26,22,4,23,21,7
2014,Portsmouth city,51740,Two or More Races ,646,330,316,155,120,87
2014,Radford city,51750,Two or More Races ,97,14,83,75,23,66
2014,Richmond city,51760,Two or More Races ,2150,532,1618,300,138,289
2014,Roanoke city,51770,Two or More Races ,714,231,483,187,79,187
2014,Salem city,51775,Two or More Races ,43,43,0,43,43,22
2014,Staunton city,51790,Two or More Races ,179,73,106,89,67,66
2014,Suffolk city,51800,Two or More Races ,719,471,248,190,143,114
2014,Virginia Beach city,51810,Two or More Races ,3637,1905,1732,422,282,312
2014,Waynesboro city,51820,Two or More Races ,120,103,17,93,89,23
2014,Williamsburg city,51830,Two or More Races ,35,11,24,27,15,25
2014,Winchester city,51840,Two or More Races ,240,69,171,126,53,117
2015,Accomack County,51001,Two or More Races ,138,65,73,69,38,52
2015,Albemarle County,51003,Two or More Races ,536,219,317,145,71,132
2015,Alleghany County,51005,Two or More Races ,5,5,0,7,7,19
2015,Amelia County,51007,Two or More Races ,46,46,0,48,48,19
2015,Amherst County,51009,Two or More Races ,155,135,20,74,75,20
2015,Appomattox County,51011,Two or More Races ,26,17,9,22,18,16
2015,Arlington County,51013,Two or More Races ,2113,960,1153,336,229,242
2015,Augusta County,51015,Two or More Races ,133,78,55,81,59,49
2015,Bath County,51017,Two or More Races ,12,0,12,19,12,19
2015,Bedford County,51019,Two or More Races ,228,178,50,78,70,59
2015,Bland County,51021,Two or More Races ,0,0,0,17,17,17
2015,Botetourt County,51023,Two or More Races ,24,24,0,21,21,25
2015,Brunswick County,51025,Two or More Races ,38,33,5,46,44,9
2015,Buchanan County,51027,Two or More Races ,45,38,7,38,36,12
2015,Buckingham County,51029,Two or More Races ,17,10,7,18,12,13
2015,Campbell County,51031,Two or More Races ,226,140,86,91,69,62
2015,Caroline County,51033,Two or More Races ,223,127,96,83,62,55
2015,Carroll County,51035,Two or More Races ,51,28,23,47,31,37
2015,Charles City County,51036,Two or More Races ,53,48,5,24,23,5
2015,Charlotte County,51037,Two or More Races ,36,27,9,33,32,12
2015,Chesterfield County,51041,Two or More Races ,2055,1269,786,296,215,233
2015,Clarke County,51043,Two or More Races ,26,22,4,19,18,7
2015,Craig County,51045,Two or More Races ,30,30,0,17,17,17
2015,Culpeper County,51047,Two or More Races ,385,206,179,141,107,98
2015,Cumberland County,51049,Two or More Races ,19,7,12,21,14,20
2015,Dickenson County,51051,Two or More Races ,10,8,2,14,13,4
2015,Dinwiddie County,51053,Two or More Races ,52,31,21,41,32,28
2015,Essex County,51057,Two or More Races ,19,19,0,24,24,19
2015,Fairfax County,51059,Two or More Races ,10778,6109,4669,645,460,461
2015,Fauquier County,51061,Two or More Races ,382,262,120,109,82,76
2015,Floyd County,51063,Two or More Races ,94,94,0,73,73,19
2015,Fluvanna County,51065,Two or More Races ,148,80,68,92,66,63
2015,Franklin County,51067,Two or More Races ,148,88,60,71,47,45
2015,Frederick County,51069,Two or More Races ,263,211,52,121,113,33
2015,Giles County,51071,Two or More Races ,10,10,0,16,16,19
2015,Gloucester County,51073,Two or More Races ,222,136,86,74,71,48
2015,Goochland County,51075,Two or More Races ,23,23,0,26,26,22
2015,Grayson County,51077,Two or More Races ,117,52,65,105,51,95
2015,Greene County,51079,Two or More Races ,89,89,0,65,65,19
2015,Greensville County,51081,Two or More Races ,18,16,2,20,20,4
2015,Halifax County,51083,Two or More Races ,43,30,13,39,34,21
2015,Hanover County,51085,Two or More Races ,421,294,127,122,106,77
2015,Henrico County,51087,Two or More Races ,1990,1042,948,285,211,197
2015,Henry County,51089,Two or More Races ,208,158,50,86,87,38
2015,Highland County,51091,Two or More Races ,3,3,0,5,5,12
2015,Isle of Wight County,51093,Two or More Races ,173,108,65,81,53,62
2015,James City County,51095,Two or More Races ,298,165,133,123,77,102
2015,King and Queen County,51097,Two or More Races ,33,33,0,30,30,17
2015,King George County,51099,Two or More Races ,210,156,54,107,105,40
2015,King William County,51101,Two or More Races ,76,43,33,49,39,29
2015,Lancaster County,51103,Two or More Races ,46,22,24,32,18,23
2015,Lee County,51105,Two or More Races ,98,98,0,158,158,22
2015,Loudoun County,51107,Two or More Races ,2870,1947,923,393,314,228
2015,Louisa County,51109,Two or More Races ,103,64,39,68,52,40
2015,Lunenburg County,51111,Two or More Races ,72,68,4,41,40,7
2015,Madison County,51113,Two or More Races ,110,66,44,50,49,48
2015,Mathews County,51115,Two or More Races ,35,20,15,45,35,26
2015,Mecklenburg County,51117,Two or More Races ,83,33,50,45,23,39
2015,Middlesex County,51119,Two or More Races ,11,11,0,14,14,19
2015,Montgomery County,51121,Two or More Races ,522,94,428,168,61,154
2015,Nelson County,51125,Two or More Races ,21,21,0,33,33,19
2015,New Kent County,51127,Two or More Races ,129,124,5,70,70,9
2015,Northampton County,51131,Two or More Races ,27,20,7,23,21,8
2015,Northumberland County,51133,Two or More Races ,0,0,0,19,19,19
2015,Nottoway County,51135,Two or More Races ,86,59,27,58,50,30
2015,Orange County,51137,Two or More Races ,120,8,112,69,12,69
2015,Page County,51139,Two or More Races ,63,3,60,61,5,60
2015,Patrick County,51141,Two or More Races ,83,44,39,76,23,76
2015,Pittsylvania County,51143,Two or More Races ,199,90,109,103,62,79
2015,Powhatan County,51145,Two or More Races ,77,54,23,49,32,39
2015,Prince Edward County,51147,Two or More Races ,39,19,20,40,21,25
2015,Prince George County,51149,Two or More Races ,198,145,53,75,62,37
2015,Prince William County,51153,Two or More Races ,4800,2759,2041,490,363,371
2015,Pulaski County,51155,Two or More Races ,86,57,29,60,41,39
2015,Rappahannock County,51157,Two or More Races ,44,0,44,48,17,48
2015,Richmond County,51159,Two or More Races ,35,35,0,34,34,17
2015,Roanoke County,51161,Two or More Races ,411,233,178,144,98,95
2015,Rockbridge County,51163,Two or More Races ,156,82,74,58,57,37
2015,Rockingham County,51165,Two or More Races ,171,119,52,82,72,39
2015,Russell County,51167,Two or More Races ,26,7,19,15,16,11
2015,Scott County,51169,Two or More Races ,63,63,0,57,57,22
2015,Shenandoah County,51171,Two or More Races ,134,59,75,52,31,50
2015,Smyth County,51173,Two or More Races ,51,18,33,42,19,34
2015,Southampton County,51175,Two or More Races ,113,58,55,71,31,68
2015,Spotsylvania County,51177,Two or More Races ,645,541,104,160,142,71
2015,Stafford County,51179,Two or More Races ,814,582,232,175,151,85
2015,Surry County,51181,Two or More Races ,24,24,0,23,23,17
2015,Sussex County,51183,Two or More Races ,2,1,1,3,2,1
2015,Tazewell County,51185,Two or More Races ,139,139,0,91,91,25
2015,Warren County,51187,Two or More Races ,272,153,119,115,69,94
2015,Washington County,51191,Two or More Races ,124,98,26,64,56,39
2015,Westmoreland County,51193,Two or More Races ,65,65,0,30,30,19
2015,Wise County,51195,Two or More Races ,61,41,20,35,32,20
2015,Wythe County,51197,Two or More Races ,15,10,5,17,12,10
2015,York County,51199,Two or More Races ,499,204,295,112,68,112
2015,Alexandria city,51510,Two or More Races ,2452,675,1777,413,160,383
2015,Bristol city,51520,Two or More Races ,61,48,13,64,59,20
2015,Buena Vista city,51530,Two or More Races ,60,60,0,91,91,17
2015,Charlottesville city,51540,Two or More Races ,253,89,164,94,57,78
2015,Chesapeake city,51550,Two or More Races ,1462,936,526,283,212,189
2015,Colonial Heights city,51570,Two or More Races ,69,44,25,43,37,25
2015,Covington city,51580,Two or More Races ,89,53,36,62,46,46
2015,Danville city,51590,Two or More Races ,164,63,101,64,42,49
2015,Emporia city,51595,Two or More Races ,0,0,0,17,17,17
2015,Fairfax city,51600,Two or More Races ,145,111,34,67,56,33
2015,Falls Church city,51610,Two or More Races ,116,8,108,85,12,85
2015,Franklin city,51620,Two or More Races ,13,13,0,15,15,17
2015,Fredericksburg city,51630,Two or More Races ,190,92,98,90,72,60
2015,Galax city,51640,Two or More Races ,60,39,21,44,40,26
2015,Hampton city,51650,Two or More Races ,1082,663,419,187,140,137
2015,Harrisonburg city,51660,Two or More Races ,314,39,275,120,40,113
2015,Hopewell city,51670,Two or More Races ,36,22,14,31,25,17
2015,Lexington city,51678,Two or More Races ,12,4,8,22,11,16
2015,Lynchburg city,51680,Two or More Races ,321,93,228,123,50,113
2015,Manassas city,51683,Two or More Races ,289,92,197,110,54,95
2015,Manassas Park city,51685,Two or More Races ,178,126,52,84,70,46
2015,Martinsville city,51690,Two or More Races ,60,44,16,38,30,23
2015,Newport News city,51700,Two or More Races ,1924,655,1269,304,200,253
2015,Norfolk city,51710,Two or More Races ,2240,815,1425,303,195,257
2015,Norton city,51720,Two or More Races ,21,0,21,36,12,36
2015,Petersburg city,51730,Two or More Races ,216,73,143,92,52,74
2015,Poquoson city,51735,Two or More Races ,31,18,13,25,17,18
2015,Portsmouth city,51740,Two or More Races ,661,316,345,143,108,109
2015,Radford city,51750,Two or More Races ,50,0,50,50,19,50
2015,Richmond city,51760,Two or More Races ,2319,545,1774,347,134,306
2015,Roanoke city,51770,Two or More Races ,871,282,589,208,90,183
2015,Salem city,51775,Two or More Races ,32,32,0,38,38,22
2015,Staunton city,51790,Two or More Races ,167,71,96,97,53,75
2015,Suffolk city,51800,Two or More Races ,714,510,204,177,171,99
2015,Virginia Beach city,51810,Two or More Races ,3980,2227,1753,439,296,339
2015,Waynesboro city,51820,Two or More Races ,144,77,67,93,66,79
2015,Williamsburg city,51830,Two or More Races ,36,10,26,30,17,30
2015,Winchester city,51840,Two or More Races ,162,46,116,73,34,71
2016,Accomack County,51001,Two or More Races ,138,71,67,67,44,58
2016,Albemarle County,51003,Two or More Races ,649,300,349,177,108,136
2016,Alleghany County,51005,Two or More Races ,28,28,0,26,26,19
2016,Amelia County,51007,Two or More Races ,94,94,0,94,94,19
2016,Amherst County,51009,Two or More Races ,212,181,31,75,74,25
2016,Appomattox County,51011,Two or More Races ,31,22,9,27,22,15
2016,Arlington County,51013,Two or More Races ,2121,836,1285,318,208,236
2016,Augusta County,51015,Two or More Races ,170,82,88,72,47,55
2016,Bath County,51017,Two or More Races ,23,9,14,25,10,22
2016,Bedford County,51019,Two or More Races ,204,155,49,85,61,60
2016,Bland County,51021,Two or More Races ,5,0,5,17,17,17
2016,Botetourt County,51023,Two or More Races ,10,10,0,13,13,25
2016,Brunswick County,51025,Two or More Races ,43,43,0,49,49,19
2016,Buchanan County,51027,Two or More Races ,46,38,8,34,31,13
2016,Buckingham County,51029,Two or More Races ,32,18,14,27,21,18
2016,Campbell County,51031,Two or More Races ,262,166,96,85,65,57
2016,Caroline County,51033,Two or More Races ,178,66,112,98,41,85
2016,Carroll County,51035,Two or More Races ,82,30,52,70,37,60
2016,Charles City County,51036,Two or More Races ,68,54,14,29,24,12
2016,Charlotte County,51037,Two or More Races ,45,44,1,56,56,3
2016,Chesterfield County,51041,Two or More Races ,2080,1323,757,324,230,192
2016,Clarke County,51043,Two or More Races ,42,22,20,38,20,29
2016,Craig County,51045,Two or More Races ,17,17,0,15,15,17
2016,Culpeper County,51047,Two or More Races ,305,167,138,119,79,79
2016,Cumberland County,51049,Two or More Races ,26,11,15,29,18,23
2016,Dickenson County,51051,Two or More Races ,15,13,2,15,14,3
2016,Dinwiddie County,51053,Two or More Races ,81,52,29,64,48,34
2016,Essex County,51057,Two or More Races ,27,27,0,28,28,19
2016,Fairfax County,51059,Two or More Races ,10746,6034,4712,698,487,502
2016,Fauquier County,51061,Two or More Races ,362,248,114,108,90,55
2016,Floyd County,51063,Two or More Races ,91,91,0,68,68,19
2016,Fluvanna County,51065,Two or More Races ,145,89,56,71,56,43
2016,Franklin County,51067,Two or More Races ,150,101,49,77,61,46
2016,Frederick County,51069,Two or More Races ,301,248,53,157,146,47
2016,Giles County,51071,Two or More Races ,0,0,0,19,19,19
2016,Gloucester County,51073,Two or More Races ,226,139,87,72,72,50
2016,Goochland County,51075,Two or More Races ,52,41,11,53,52,18
2016,Grayson County,51077,Two or More Races ,70,24,46,49,22,50
2016,Greene County,51079,Two or More Races ,122,120,2,92,91,3
2016,Greensville County,51081,Two or More Races ,23,15,8,24,20,11
2016,Halifax County,51083,Two or More Races ,97,40,57,69,42,56
2016,Hanover County,51085,Two or More Races ,439,300,139,105,97,67
2016,Henrico County,51087,Two or More Races ,2314,1189,1125,309,232,232
2016,Henry County,51089,Two or More Races ,269,236,33,132,123,31
2016,Highland County,51091,Two or More Races ,4,4,0,6,6,12
2016,Isle of Wight County,51093,Two or More Races ,177,129,48,84,78,44
2016,James City County,51095,Two or More Races ,391,221,170,130,84,101
2016,King and Queen County,51097,Two or More Races ,24,24,0,23,23,17
2016,King George County,51099,Two or More Races ,247,178,69,109,103,57
2016,King William County,51101,Two or More Races ,108,77,31,61,45,37
2016,Lancaster County,51103,Two or More Races ,38,11,27,28,12,26
2016,Lee County,51105,Two or More Races ,0,0,0,22,22,22
2016,Loudoun County,51107,Two or More Races ,3350,2298,1052,354,279,234
2016,Louisa County,51109,Two or More Races ,165,124,41,86,75,39
2016,Lunenburg County,51111,Two or More Races ,69,59,10,37,35,13
2016,Madison County,51113,Two or More Races ,85,72,13,65,59,25
2016,Mathews County,51115,Two or More Races ,54,30,24,59,40,43
2016,Mecklenburg County,51117,Two or More Races ,35,16,19,22,13,20
2016,Middlesex County,51119,Two or More Races ,45,15,30,36,16,29
2016,Montgomery County,51121,Two or More Races ,562,85,477,158,59,152
2016,Nelson County,51125,Two or More Races ,19,19,0,30,30,19
2016,New Kent County,51127,Two or More Races ,120,112,8,62,59,14
2016,Northampton County,51131,Two or More Races ,32,25,7,22,23,8
2016,Northumberland County,51133,Two or More Races ,0,0,0,19,19,19
2016,Nottoway County,51135,Two or More Races ,97,60,37,77,57,43
2016,Orange County,51137,Two or More Races ,121,27,94,88,34,84
2016,Page County,51139,Two or More Races ,50,11,39,41,13,35
2016,Patrick County,51141,Two or More Races ,66,45,21,38,24,35
2016,Pittsylvania County,51143,Two or More Races ,242,103,139,103,54,88
2016,Powhatan County,51145,Two or More Races ,73,56,17,41,32,28
2016,Prince Edward County,51147,Two or More Races ,44,23,21,42,28,27
2016,Prince George County,51149,Two or More Races ,240,171,69,98,87,42
2016,Prince William County,51153,Two or More Races ,4887,2914,1973,468,352,348
2016,Pulaski County,51155,Two or More Races ,81,71,10,56,53,16
2016,Rappahannock County,51157,Two or More Races ,43,0,43,41,17,41
2016,Richmond County,51159,Two or More Races ,10,6,4,13,11,6
2016,Roanoke County,51161,Two or More Races ,393,182,211,133,91,112
2016,Rockbridge County,51163,Two or More Races ,127,80,47,53,58,34
2016,Rockingham County,51165,Two or More Races ,213,99,114,109,70,78
2016,Russell County,51167,Two or More Races ,30,11,19,20,17,14
2016,Scott County,51169,Two or More Races ,74,74,0,77,77,22
2016,Shenandoah County,51171,Two or More Races ,233,153,80,106,98,67
2016,Smyth County,51173,Two or More Races ,77,49,28,45,36,31
2016,Southampton County,51175,Two or More Races ,106,52,54,59,32,51
2016,Spotsylvania County,51177,Two or More Races ,694,552,142,169,137,72
2016,Stafford County,51179,Two or More Races ,902,662,240,173,136,112
2016,Surry County,51181,Two or More Races ,23,21,2,24,23,6
2016,Sussex County,51183,Two or More Races ,4,3,1,16,12,6
2016,Tazewell County,51185,Two or More Races ,120,109,11,65,61,18
2016,Warren County,51187,Two or More Races ,276,129,147,104,60,93
2016,Washington County,51191,Two or More Races ,171,132,39,90,72,48
2016,Westmoreland County,51193,Two or More Races ,49,49,0,33,33,19
2016,Wise County,51195,Two or More Races ,44,44,0,35,35,25
2016,Wythe County,51197,Two or More Races ,24,11,13,28,19,20
2016,York County,51199,Two or More Races ,563,239,324,121,80,104
2016,Alexandria city,51510,Two or More Races ,2617,589,2028,320,149,310
2016,Bristol city,51520,Two or More Races ,80,58,22,49,42,29
2016,Buena Vista city,51530,Two or More Races ,41,41,0,71,71,17
2016,Charlottesville city,51540,Two or More Races ,281,90,191,106,52,91
2016,Chesapeake city,51550,Two or More Races ,1495,978,517,234,183,166
2016,Colonial Heights city,51570,Two or More Races ,131,55,76,63,39,49
2016,Covington city,51580,Two or More Races ,80,46,34,59,38,43
2016,Danville city,51590,Two or More Races ,184,65,119,68,43,53
2016,Emporia city,51595,Two or More Races ,0,0,0,17,17,17
2016,Fairfax city,51600,Two or More Races ,170,132,38,71,57,37
2016,Falls Church city,51610,Two or More Races ,78,11,67,50,17,47
2016,Franklin city,51620,Two or More Races ,15,15,0,20,20,17
2016,Fredericksburg city,51630,Two or More Races ,198,60,138,100,46,84
2016,Galax city,51640,Two or More Races ,49,32,17,42,34,22
2016,Hampton city,51650,Two or More Races ,1100,707,393,209,165,141
2016,Harrisonburg city,51660,Two or More Races ,381,34,347,155,33,153
2016,Hopewell city,51670,Two or More Races ,35,20,15,26,23,14
2016,Lexington city,51678,Two or More Races ,4,0,4,9,17,9
2016,Lynchburg city,51680,Two or More Races ,396,70,326,210,58,197
2016,Manassas city,51683,Two or More Races ,278,112,166,102,52,90
2016,Manassas Park city,51685,Two or More Races ,177,139,38,97,86,40
2016,Martinsville city,51690,Two or More Races ,40,28,12,30,26,17
2016,Newport News city,51700,Two or More Races ,2199,662,1537,318,177,264
2016,Norfolk city,51710,Two or More Races ,2121,756,1365,325,169,271
2016,Norton city,51720,Two or More Races ,32,0,32,50,12,50
2016,Petersburg city,51730,Two or More Races ,261,99,162,137,71,108
2016,Poquoson city,51735,Two or More Races ,46,30,16,31,26,22
2016,Portsmouth city,51740,Two or More Races ,581,251,330,130,84,111
2016,Radford city,51750,Two or More Races ,53,5,48,45,5,44
2016,Richmond city,51760,Two or More Races ,2445,594,1851,350,148,334
2016,Roanoke city,51770,Two or More Races ,794,229,565,221,89,199
2016,Salem city,51775,Two or More Races ,37,37,0,37,37,22
2016,Staunton city,51790,Two or More Races ,222,86,136,90,58,83
2016,Suffolk city,51800,Two or More Races ,498,369,129,138,125,70
2016,Virginia Beach city,51810,Two or More Races ,4288,2438,1850,387,293,263
2016,Waynesboro city,51820,Two or More Races ,134,80,54,97,68,71
2016,Williamsburg city,51830,Two or More Races ,56,12,44,50,18,44
2016,Winchester city,51840,Two or More Races ,245,62,183,108,49,97
2017,Accomack County,51001,Two or More Races ,126,66,60,69,51,53
2017,Albemarle County,51003,Two or More Races ,652,264,388,148,113,114
2017,Alleghany County,51005,Two or More Races ,29,29,0,28,28,19
2017,Amelia County,51007,Two or More Races ,91,91,0,85,85,19
2017,Amherst County,51009,Two or More Races ,276,250,26,120,117,23
2017,Appomattox County,51011,Two or More Races ,34,17,17,29,21,21
2017,Arlington County,51013,Two or More Races ,2398,1047,1351,405,245,310
2017,Augusta County,51015,Two or More Races ,228,109,119,98,55,74
2017,Bath County,51017,Two or More Races ,35,19,16,33,20,26
2017,Bedford County,51019,Two or More Races ,233,183,50,91,83,49
2017,Bland County,51021,Two or More Races ,4,0,4,33,17,33
2017,Botetourt County,51023,Two or More Races ,6,6,0,9,9,25
2017,Brunswick County,51025,Two or More Races ,98,85,13,68,66,15
2017,Buchanan County,51027,Two or More Races ,31,21,10,30,25,18
2017,Buckingham County,51029,Two or More Races ,26,17,9,22,16,17
2017,Campbell County,51031,Two or More Races ,233,130,103,78,56,64
2017,Caroline County,51033,Two or More Races ,150,78,72,81,49,65
2017,Carroll County,51035,Two or More Races ,74,32,42,65,39,52
2017,Charles City County,51036,Two or More Races ,54,41,13,25,21,14
2017,Charlotte County,51037,Two or More Races ,10,8,2,13,12,3
2017,Chesterfield County,51041,Two or More Races ,2321,1541,780,341,271,192
2017,Clarke County,51043,Two or More Races ,50,22,28,38,16,36
2017,Craig County,51045,Two or More Races ,9,9,0,16,16,17
2017,Culpeper County,51047,Two or More Races ,263,134,129,122,69,86
2017,Cumberland County,51049,Two or More Races ,22,22,0,29,29,17
2017,Dickenson County,51051,Two or More Races ,16,12,4,15,12,6
2017,Dinwiddie County,51053,Two or More Races ,91,35,56,59,36,45
2017,Essex County,51057,Two or More Races ,86,86,0,74,74,19
2017,Fairfax County,51059,Two or More Races ,10917,6084,4833,696,506,494
2017,Fauquier County,51061,Two or More Races ,398,287,111,109,80,65
2017,Floyd County,51063,Two or More Races ,104,104,0,63,63,19
2017,Fluvanna County,51065,Two or More Races ,168,114,54,88,71,54
2017,Franklin County,51067,Two or More Races ,129,111,18,79,79,16
2017,Frederick County,51069,Two or More Races ,247,207,40,151,143,41
2017,Giles County,51071,Two or More Races ,14,14,0,28,28,19
2017,Gloucester County,51073,Two or More Races ,331,235,96,90,104,67
2017,Goochland County,51075,Two or More Races ,105,94,11,70,67,17
2017,Grayson County,51077,Two or More Races ,138,39,99,108,44,102
2017,Greene County,51079,Two or More Races ,124,123,1,95,95,2
2017,Greensville County,51081,Two or More Races ,17,4,13,24,6,23
2017,Halifax County,51083,Two or More Races ,146,81,65,99,78,58
2017,Hanover County,51085,Two or More Races ,428,323,105,123,111,72
2017,Henrico County,51087,Two or More Races ,2425,1202,1223,383,264,267
2017,Henry County,51089,Two or More Races ,392,301,91,137,104,79
2017,Highland County,51091,Two or More Races ,2,2,0,5,5,12
2017,Isle of Wight County,51093,Two or More Races ,187,126,61,90,74,54
2017,James City County,51095,Two or More Races ,408,233,175,159,128,99
2017,King and Queen County,51097,Two or More Races ,29,29,0,24,24,17
2017,King George County,51099,Two or More Races ,214,167,47,85,74,37
2017,King William County,51101,Two or More Races ,128,103,25,64,58,34
2017,Lancaster County,51103,Two or More Races ,13,0,13,16,19,16
2017,Lee County,51105,Two or More Races ,7,0,7,15,22,15
2017,Loudoun County,51107,Two or More Races ,3563,2484,1079,418,336,229
2017,Louisa County,51109,Two or More Races ,220,173,47,106,92,42
2017,Lunenburg County,51111,Two or More Races ,53,40,13,28,26,13
2017,Madison County,51113,Two or More Races ,128,128,0,67,67,19
2017,Mathews County,51115,Two or More Races ,67,53,14,73,68,26
2017,Mecklenburg County,51117,Two or More Races ,74,42,32,43,30,30
2017,Middlesex County,51119,Two or More Races ,77,29,48,51,29,44
2017,Montgomery County,51121,Two or More Races ,502,104,398,152,62,141
2017,Nelson County,51125,Two or More Races ,48,20,28,40,33,39
2017,New Kent County,51127,Two or More Races ,136,126,10,60,58,16
2017,Northampton County,51131,Two or More Races ,42,35,7,31,31,7
2017,Northumberland County,51133,Two or More Races ,8,8,0,14,14,19
2017,Nottoway County,51135,Two or More Races ,54,12,42,60,15,57
2017,Orange County,51137,Two or More Races ,217,53,164,165,53,151
2017,Page County,51139,Two or More Races ,53,7,46,42,12,43
2017,Patrick County,51141,Two or More Races ,56,38,18,38,19,30
2017,Pittsylvania County,51143,Two or More Races ,266,143,123,63,50,52
2017,Powhatan County,51145,Two or More Races ,87,87,0,47,47,22
2017,Prince Edward County,51147,Two or More Races ,80,8,72,95,14,94
2017,Prince George County,51149,Two or More Races ,314,216,98,122,104,61
2017,Prince William County,51153,Two or More Races ,4758,3017,1741,451,361,299
2017,Pulaski County,51155,Two or More Races ,135,107,28,78,68,32
2017,Rappahannock County,51157,Two or More Races ,41,0,41,43,17,43
2017,Richmond County,51159,Two or More Races ,13,8,5,20,17,9
2017,Roanoke County,51161,Two or More Races ,365,182,183,132,69,107
2017,Rockbridge County,51163,Two or More Races ,86,57,29,35,43,27
2017,Rockingham County,51165,Two or More Races ,231,117,114,113,80,69
2017,Russell County,51167,Two or More Races ,32,6,26,24,11,21
2017,Scott County,51169,Two or More Races ,17,13,4,27,25,8
2017,Shenandoah County,51171,Two or More Races ,266,145,121,94,90,73
2017,Smyth County,51173,Two or More Races ,55,35,20,34,30,17
2017,Southampton County,51175,Two or More Races ,201,128,73,98,86,57
2017,Spotsylvania County,51177,Two or More Races ,756,616,140,157,148,74
2017,Stafford County,51179,Two or More Races ,1141,780,361,225,181,132
2017,Surry County,51181,Two or More Races ,30,23,7,25,25,11
2017,Sussex County,51183,Two or More Races ,10,1,9,17,3,16
2017,Tazewell County,51185,Two or More Races ,116,88,28,59,52,27
2017,Warren County,51187,Two or More Races ,270,134,136,100,66,88
2017,Washington County,51191,Two or More Races ,134,128,6,51,51,13
2017,Westmoreland County,51193,Two or More Races ,62,62,0,34,34,19
2017,Wise County,51195,Two or More Races ,43,43,0,31,31,25
2017,Wythe County,51197,Two or More Races ,20,12,8,20,15,13
2017,York County,51199,Two or More Races ,621,239,382,165,96,154
2017,Alexandria city,51510,Two or More Races ,2692,584,2108,358,151,369
2017,Bristol city,51520,Two or More Races ,118,74,44,72,56,44
2017,Buena Vista city,51530,Two or More Races ,30,30,0,42,42,17
2017,Charlottesville city,51540,Two or More Races ,330,84,246,119,57,111
2017,Chesapeake city,51550,Two or More Races ,1605,1118,487,268,205,153
2017,Colonial Heights city,51570,Two or More Races ,150,65,85,78,44,60
2017,Covington city,51580,Two or More Races ,62,23,39,51,25,47
2017,Danville city,51590,Two or More Races ,293,47,246,101,36,94
2017,Emporia city,51595,Two or More Races ,27,0,27,29,17,29
2017,Fairfax city,51600,Two or More Races ,208,158,50,73,66,41
2017,Falls Church city,51610,Two or More Races ,104,19,85,71,23,68
2017,Franklin city,51620,Two or More Races ,71,29,42,60,35,55
2017,Fredericksburg city,51630,Two or More Races ,277,65,212,115,48,110
2017,Galax city,51640,Two or More Races ,27,6,21,25,12,24
2017,Hampton city,51650,Two or More Races ,1211,671,540,254,191,190
2017,Harrisonburg city,51660,Two or More Races ,492,33,459,170,29,164
2017,Hopewell city,51670,Two or More Races ,43,13,30,27,13,23
2017,Lexington city,51678,Two or More Races ,10,0,10,15,17,15
2017,Lynchburg city,51680,Two or More Races ,352,44,308,156,36,150
2017,Manassas city,51683,Two or More Races ,299,142,157,117,74,87
2017,Manassas Park city,51685,Two or More Races ,154,136,18,76,72,28
2017,Martinsville city,51690,Two or More Races ,51,25,26,39,26,29
2017,Newport News city,51700,Two or More Races ,2112,763,1349,274,173,247
2017,Norfolk city,51710,Two or More Races ,2279,685,1594,276,146,266
2017,Norton city,51720,Two or More Races ,30,0,30,44,12,44
2017,Petersburg city,51730,Two or More Races ,322,124,198,145,64,127
2017,Poquoson city,51735,Two or More Races ,55,43,12,40,38,20
2017,Portsmouth city,51740,Two or More Races ,651,278,373,150,106,99
2017,Radford city,51750,Two or More Races ,47,10,37,40,13,35
2017,Richmond city,51760,Two or More Races ,2438,613,1825,373,137,352
2017,Roanoke city,51770,Two or More Races ,709,244,465,207,122,174
2017,Salem city,51775,Two or More Races ,54,39,15,42,32,25
2017,Staunton city,51790,Two or More Races ,160,37,123,110,39,97
2017,Suffolk city,51800,Two or More Races ,567,447,120,157,131,78
2017,Virginia Beach city,51810,Two or More Races ,4561,2668,1893,468,348,332
2017,Waynesboro city,51820,Two or More Races ,155,98,57,131,105,83
2017,Williamsburg city,51830,Two or More Races ,58,15,43,58,18,55
2017,Winchester city,51840,Two or More Races ,235,53,182,112,49,107
2018,Accomack County,51001,Two or More Races ,83,27,56,55,28,48
2018,Albemarle County,51003,Two or More Races ,574,249,325,142,92,101
2018,Alleghany County,51005,Two or More Races ,40,33,7,26,25,11
2018,Amelia County,51007,Two or More Races ,70,38,32,66,49,47
2018,Amherst County,51009,Two or More Races ,316,278,38,104,102,29
2018,Appomattox County,51011,Two or More Races ,51,20,31,44,26,34
2018,Arlington County,51013,Two or More Races ,2897,1064,1833,437,235,343
2018,Augusta County,51015,Two or More Races ,307,151,156,119,92,82
2018,Bath County,51017,Two or More Races ,20,20,0,20,20,12
2018,Bedford County,51019,Two or More Races ,354,200,154,110,84,73
2018,Bland County,51021,Two or More Races ,12,0,12,20,17,20
2018,Botetourt County,51023,Two or More Races ,5,5,0,8,8,25
2018,Brunswick County,51025,Two or More Races ,108,82,26,74,65,26
2018,Buchanan County,51027,Two or More Races ,10,7,3,11,9,8
2018,Buckingham County,51029,Two or More Races ,33,24,9,32,28,14
2018,Campbell County,51031,Two or More Races ,291,135,156,90,75,87
2018,Caroline County,51033,Two or More Races ,185,111,74,112,58,83
2018,Carroll County,51035,Two or More Races ,109,63,46,80,62,53
2018,Charles City County,51036,Two or More Races ,38,27,11,17,10,12
2018,Charlotte County,51037,Two or More Races ,10,9,1,15,15,3
2018,Chesterfield County,51041,Two or More Races ,2341,1582,759,322,258,175
2018,Clarke County,51043,Two or More Races ,50,22,28,48,28,40
2018,Craig County,51045,Two or More Races ,9,0,9,20,17,20
2018,Culpeper County,51047,Two or More Races ,252,152,100,118,79,80
2018,Cumberland County,51049,Two or More Races ,23,23,0,28,28,17
2018,Dickenson County,51051,Two or More Races ,22,19,3,15,15,4
2018,Dinwiddie County,51053,Two or More Races ,132,78,54,77,66,39
2018,Essex County,51057,Two or More Races ,77,77,0,76,76,19
2018,Fairfax County,51059,Two or More Races ,11639,6391,5248,702,447,517
2018,Fauquier County,51061,Two or More Races ,466,319,147,131,118,82
2018,Floyd County,51063,Two or More Races ,60,60,0,53,53,19
2018,Fluvanna County,51065,Two or More Races ,241,158,83,141,89,111
2018,Franklin County,51067,Two or More Races ,232,216,16,151,151,16
2018,Frederick County,51069,Two or More Races ,323,217,106,130,114,78
2018,Giles County,51071,Two or More Races ,16,11,5,19,16,8
2018,Gloucester County,51073,Two or More Races ,389,225,164,97,100,95
2018,Goochland County,51075,Two or More Races ,99,86,13,71,68,22
2018,Grayson County,51077,Two or More Races ,112,32,80,123,32,115
2018,Greene County,51079,Two or More Races ,218,144,74,154,107,91
2018,Greensville County,51081,Two or More Races ,17,3,14,21,5,21
2018,Halifax County,51083,Two or More Races ,152,80,72,107,75,71
2018,Hanover County,51085,Two or More Races ,416,311,105,118,114,62
2018,Henrico County,51087,Two or More Races ,2280,1134,1146,354,256,253
2018,Henry County,51089,Two or More Races ,385,322,63,133,117,64
2018,Highland County,51091,Two or More Races ,5,5,0,9,9,12
2018,Isle of Wight County,51093,Two or More Races ,179,119,60,82,64,58
2018,James City County,51095,Two or More Races ,500,234,266,180,106,145
2018,King and Queen County,51097,Two or More Races ,23,23,0,23,23,17
2018,King George County,51099,Two or More Races ,186,138,48,81,68,36
2018,King William County,51101,Two or More Races ,131,97,34,72,51,44
2018,Lancaster County,51103,Two or More Races ,15,0,15,20,19,20
2018,Lee County,51105,Two or More Races ,8,0,8,17,22,17
2018,Loudoun County,51107,Two or More Races ,3785,2534,1251,411,337,286
2018,Louisa County,51109,Two or More Races ,194,137,57,91,79,45
2018,Lunenburg County,51111,Two or More Races ,45,29,16,34,25,23
2018,Madison County,51113,Two or More Races ,125,125,0,81,81,19
2018,Mathews County,51115,Two or More Races ,86,47,39,94,68,62
2018,Mecklenburg County,51117,Two or More Races ,66,41,25,41,30,26
2018,Middlesex County,51119,Two or More Races ,73,42,31,50,34,33
2018,Montgomery County,51121,Two or More Races ,464,114,350,141,64,119
2018,Nelson County,51125,Two or More Races ,46,25,21,40,39,32
2018,New Kent County,51127,Two or More Races ,146,133,13,63,59,21
2018,Northampton County,51131,Two or More Races ,56,38,18,35,31,18
2018,Northumberland County,51133,Two or More Races ,36,36,0,49,49,19
2018,Nottoway County,51135,Two or More Races ,16,11,5,14,13,7
2018,Orange County,51137,Two or More Races ,237,66,171,167,70,153
2018,Page County,51139,Two or More Races ,61,39,22,42,38,34
2018,Patrick County,51141,Two or More Races ,48,34,14,17,24,20
2018,Pittsylvania County,51143,Two or More Races ,344,191,153,82,84,61
2018,Powhatan County,51145,Two or More Races ,108,74,34,60,39,41
2018,Prince Edward County,51147,Two or More Races ,25,10,15,20,12,17
2018,Prince George County,51149,Two or More Races ,276,154,122,106,79,73
2018,Prince William County,51153,Two or More Races ,5541,3464,2077,518,375,361
2018,Pulaski County,51155,Two or More Races ,180,95,85,76,78,48
2018,Rappahannock County,51157,Two or More Races ,9,0,9,15,17,15
2018,Richmond County,51159,Two or More Races ,47,35,12,38,32,14
2018,Roanoke County,51161,Two or More Races ,413,154,259,150,74,143
2018,Rockbridge County,51163,Two or More Races ,73,32,41,42,36,29
2018,Rockingham County,51165,Two or More Races ,235,123,112,108,78,72
2018,Russell County,51167,Two or More Races ,87,12,75,63,23,64
2018,Scott County,51169,Two or More Races ,22,17,5,24,22,8
2018,Shenandoah County,51171,Two or More Races ,301,141,160,130,92,91
2018,Smyth County,51173,Two or More Races ,79,33,46,64,36,45
2018,Southampton County,51175,Two or More Races ,232,147,85,125,105,63
2018,Spotsylvania County,51177,Two or More Races ,840,638,202,151,124,83
2018,Stafford County,51179,Two or More Races ,1204,741,463,232,172,181
2018,Surry County,51181,Two or More Races ,32,18,14,27,21,16
2018,Sussex County,51183,Two or More Races ,59,29,30,59,43,34
2018,Tazewell County,51185,Two or More Races ,92,61,31,44,34,29
2018,Warren County,51187,Two or More Races ,220,145,75,98,86,71
2018,Washington County,51191,Two or More Races ,192,148,44,60,56,45
2018,Westmoreland County,51193,Two or More Races ,45,45,0,32,32,19
2018,Wise County,51195,Two or More Races ,52,43,9,31,25,14
2018,Wythe County,51197,Two or More Races ,22,10,12,27,17,20
2018,York County,51199,Two or More Races ,663,270,393,196,111,180
2018,Alexandria city,51510,Two or More Races ,2852,721,2131,370,156,378
2018,Bristol city,51520,Two or More Races ,133,70,63,82,54,67
2018,Buena Vista city,51530,Two or More Races ,0,0,0,17,17,17
2018,Charlottesville city,51540,Two or More Races ,419,119,300,184,72,167
2018,Chesapeake city,51550,Two or More Races ,1773,1256,517,312,262,210
2018,Colonial Heights city,51570,Two or More Races ,162,66,96,70,38,55
2018,Covington city,51580,Two or More Races ,37,28,9,34,29,18
2018,Danville city,51590,Two or More Races ,358,58,300,113,41,109
2018,Emporia city,51595,Two or More Races ,47,20,27,43,29,31
2018,Fairfax city,51600,Two or More Races ,221,142,79,96,70,61
2018,Falls Church city,51610,Two or More Races ,10,10,0,16,16,19
2018,Franklin city,51620,Two or More Races ,65,32,33,75,37,61
2018,Fredericksburg city,51630,Two or More Races ,302,79,223,103,45,91
2018,Galax city,51640,Two or More Races ,26,4,22,28,12,26
2018,Hampton city,51650,Two or More Races ,1161,607,554,245,161,191
2018,Harrisonburg city,51660,Two or More Races ,615,46,569,198,39,194
2018,Hopewell city,51670,Two or More Races ,40,11,29,26,16,24
2018,Lexington city,51678,Two or More Races ,16,0,16,27,17,27
2018,Lynchburg city,51680,Two or More Races ,298,54,244,120,43,109
2018,Manassas city,51683,Two or More Races ,306,163,143,98,73,63
2018,Manassas Park city,51685,Two or More Races ,170,150,20,92,81,31
2018,Martinsville city,51690,Two or More Races ,45,13,32,35,15,30
2018,Newport News city,51700,Two or More Races ,2152,825,1327,367,215,302
2018,Norfolk city,51710,Two or More Races ,2392,827,1565,313,209,267
2018,Norton city,51720,Two or More Races ,38,0,38,60,12,60
2018,Petersburg city,51730,Two or More Races ,200,70,130,89,36,79
2018,Poquoson city,51735,Two or More Races ,42,33,9,49,50,15
2018,Portsmouth city,51740,Two or More Races ,725,323,402,168,111,113
2018,Radford city,51750,Two or More Races ,14,7,7,20,8,17
2018,Richmond city,51760,Two or More Races ,2307,574,1733,353,106,342
2018,Roanoke city,51770,Two or More Races ,800,395,405,246,170,165
2018,Salem city,51775,Two or More Races ,85,24,61,54,25,53
2018,Staunton city,51790,Two or More Races ,122,45,77,73,46,59
2018,Suffolk city,51800,Two or More Races ,623,474,149,182,139,112
2018,Virginia Beach city,51810,Two or More Races ,4760,2759,2001,481,343,367
2018,Waynesboro city,51820,Two or More Races ,101,44,57,72,37,59
2018,Williamsburg city,51830,Two or More Races ,134,14,120,94,14,96
2018,Winchester city,51840,Two or More Races ,234,36,198,116,47,114
2019,Accomack County,51001,Two or More Races ,95,56,39,72,48,48
2019,Albemarle County,51003,Two or More Races ,691,373,318,157,128,106
2019,Alleghany County,51005,Two or More Races ,46,39,7,35,32,11
2019,Amelia County,51007,Two or More Races ,92,52,40,86,64,59
2019,Amherst County,51009,Two or More Races ,246,199,47,124,116,36
2019,Appomattox County,51011,Two or More Races ,57,24,33,45,25,40
2019,Arlington County,51013,Two or More Races ,3283,1053,2230,359,224,328
2019,Augusta County,51015,Two or More Races ,256,137,119,122,89,83
2019,Bath County,51017,Two or More Races ,17,17,0,19,19,12
2019,Bedford County,51019,Two or More Races ,324,204,120,101,84,74
2019,Bland County,51021,Two or More Races ,17,0,17,31,17,31
2019,Botetourt County,51023,Two or More Races ,34,34,0,42,42,26
2019,Brunswick County,51025,Two or More Races ,102,68,34,65,57,36
2019,Buchanan County,51027,Two or More Races ,7,7,0,13,13,23
2019,Buckingham County,51029,Two or More Races ,56,25,31,45,29,35
2019,Campbell County,51031,Two or More Races ,318,170,148,110,93,83
2019,Caroline County,51033,Two or More Races ,167,88,79,105,57,79
2019,Carroll County,51035,Two or More Races ,68,33,35,66,45,44
2019,Charles City County,51036,Two or More Races ,52,38,14,22,17,15
2019,Charlotte County,51037,Two or More Races ,12,10,2,13,11,3
2019,Chesterfield County,51041,Two or More Races ,2189,1584,605,343,272,170
2019,Clarke County,51043,Two or More Races ,26,14,12,28,24,18
2019,Craig County,51045,Two or More Races ,7,0,7,17,17,17
2019,Culpeper County,51047,Two or More Races ,209,72,137,109,48,99
2019,Cumberland County,51049,Two or More Races ,39,39,0,41,41,17
2019,Dickenson County,51051,Two or More Races ,25,21,4,15,14,5
2019,Dinwiddie County,51053,Two or More Races ,132,91,41,76,83,35
2019,Essex County,51057,Two or More Races ,98,81,17,85,81,29
2019,Fairfax County,51059,Two or More Races ,12226,6842,5384,713,582,579
2019,Fauquier County,51061,Two or More Races ,447,351,96,116,107,61
2019,Floyd County,51063,Two or More Races ,97,97,0,72,72,19
2019,Fluvanna County,51065,Two or More Races ,148,145,3,66,66,6
2019,Franklin County,51067,Two or More Races ,342,214,128,182,156,110
2019,Frederick County,51069,Two or More Races ,374,249,125,130,130,73
2019,Giles County,51071,Two or More Races ,47,18,29,41,24,36
2019,Gloucester County,51073,Two or More Races ,255,154,101,104,87,56
2019,Goochland County,51075,Two or More Races ,115,84,31,90,72,37
2019,Grayson County,51077,Two or More Races ,47,25,22,68,31,57
2019,Greene County,51079,Two or More Races ,221,165,56,149,113,73
2019,Greensville County,51081,Two or More Races ,22,3,19,32,6,32
2019,Halifax County,51083,Two or More Races ,162,77,85,102,68,76
2019,Hanover County,51085,Two or More Races ,455,357,98,139,121,66
2019,Henrico County,51087,Two or More Races ,2509,1123,1386,390,248,296
2019,Henry County,51089,Two or More Races ,297,260,37,111,108,38
2019,Highland County,51091,Two or More Races ,9,9,0,13,13,12
2019,Isle of Wight County,51093,Two or More Races ,248,184,64,100,83,61
2019,James City County,51095,Two or More Races ,488,287,201,172,147,93
2019,King and Queen County,51097,Two or More Races ,11,11,0,10,10,17
2019,King George County,51099,Two or More Races ,136,110,26,57,53,26
2019,King William County,51101,Two or More Races ,105,84,21,54,39,31
2019,Lancaster County,51103,Two or More Races ,13,0,13,17,19,17
2019,Lee County,51105,Two or More Races ,7,0,7,12,23,12
2019,Loudoun County,51107,Two or More Races ,3976,2682,1294,444,358,254
2019,Louisa County,51109,Two or More Races ,180,129,51,74,76,31
2019,Lunenburg County,51111,Two or More Races ,66,46,20,47,39,21
2019,Madison County,51113,Two or More Races ,81,81,0,61,61,19
2019,Mathews County,51115,Two or More Races ,85,29,56,73,42,60
2019,Mecklenburg County,51117,Two or More Races ,82,38,44,59,32,46
2019,Middlesex County,51119,Two or More Races ,102,31,71,49,27,43
2019,Montgomery County,51121,Two or More Races ,409,102,307,129,56,119
2019,Nelson County,51125,Two or More Races ,58,17,41,55,29,60
2019,New Kent County,51127,Two or More Races ,106,106,0,70,70,23
2019,Northampton County,51131,Two or More Races ,44,31,13,43,40,13
2019,Northumberland County,51133,Two or More Races ,39,39,0,44,44,19
2019,Nottoway County,51135,Two or More Races ,25,25,0,37,37,19
2019,Orange County,51137,Two or More Races ,207,78,129,120,62,106
2019,Page County,51139,Two or More Races ,127,42,85,92,42,88
2019,Patrick County,51141,Two or More Races ,25,10,15,28,17,22
2019,Pittsylvania County,51143,Two or More Races ,373,242,131,101,90,58
2019,Powhatan County,51145,Two or More Races ,127,91,36,63,53,42
2019,Prince Edward County,51147,Two or More Races ,36,7,29,33,11,29
2019,Prince George County,51149,Two or More Races ,259,108,151,99,57,84
2019,Prince William County,51153,Two or More Races ,5251,3487,1764,495,378,337
2019,Pulaski County,51155,Two or More Races ,198,125,73,84,61,55
2019,Rappahannock County,51157,Two or More Races ,14,0,14,22,17,22
2019,Richmond County,51159,Two or More Races ,35,18,17,23,23,18
2019,Roanoke County,51161,Two or More Races ,351,112,239,144,51,140
2019,Rockbridge County,51163,Two or More Races ,102,67,35,56,59,30
2019,Rockingham County,51165,Two or More Races ,291,169,122,129,80,94
2019,Russell County,51167,Two or More Races ,23,23,0,40,40,23
2019,Scott County,51169,Two or More Races ,17,10,7,20,17,12
2019,Shenandoah County,51171,Two or More Races ,344,181,163,145,93,101
2019,Smyth County,51173,Two or More Races ,44,11,33,45,16,38
2019,Southampton County,51175,Two or More Races ,216,164,52,107,95,46
2019,Spotsylvania County,51177,Two or More Races ,1020,689,331,176,133,128
2019,Stafford County,51179,Two or More Races ,1241,690,551,266,177,212
2019,Surry County,51181,Two or More Races ,31,4,27,31,8,30
2019,Sussex County,51183,Two or More Races ,65,39,26,48,41,24
2019,Tazewell County,51185,Two or More Races ,103,68,35,44,47,25
2019,Warren County,51187,Two or More Races ,105,73,32,62,50,34
2019,Washington County,51191,Two or More Races ,223,141,82,70,73,68
2019,Westmoreland County,51193,Two or More Races ,30,30,0,37,37,19
2019,Wise County,51195,Two or More Races ,70,47,23,61,39,43
2019,Wythe County,51197,Two or More Races ,33,12,21,38,22,32
2019,York County,51199,Two or More Races ,769,349,420,197,139,153
2019,Alexandria city,51510,Two or More Races ,2995,761,2234,417,172,431
2019,Bristol city,51520,Two or More Races ,96,44,52,53,31,52
2019,Buena Vista city,51530,Two or More Races ,0,0,0,17,17,17
2019,Charlottesville city,51540,Two or More Races ,513,85,428,177,65,164
2019,Chesapeake city,51550,Two or More Races ,2026,1369,657,459,317,291
2019,Colonial Heights city,51570,Two or More Races ,144,48,96,59,34,55
2019,Covington city,51580,Two or More Races ,47,32,15,33,30,25
2019,Danville city,51590,Two or More Races ,530,85,445,143,58,140
2019,Emporia city,51595,Two or More Races ,68,22,46,67,35,56
2019,Fairfax city,51600,Two or More Races ,238,106,132,84,56,65
2019,Falls Church city,51610,Two or More Races ,44,17,27,39,20,29
2019,Franklin city,51620,Two or More Races ,163,57,106,129,84,99
2019,Fredericksburg city,51630,Two or More Races ,351,79,272,141,62,131
2019,Galax city,51640,Two or More Races ,8,0,8,15,17,15
2019,Hampton city,51650,Two or More Races ,1413,781,632,286,204,185
2019,Harrisonburg city,51660,Two or More Races ,722,56,666,240,49,239
2019,Hopewell city,51670,Two or More Races ,45,15,30,41,26,31
2019,Lexington city,51678,Two or More Races ,31,0,31,50,17,50
2019,Lynchburg city,51680,Two or More Races ,271,32,239,109,30,110
2019,Manassas city,51683,Two or More Races ,399,207,192,135,91,107
2019,Manassas Park city,51685,Two or More Races ,158,144,14,92,91,23
2019,Martinsville city,51690,Two or More Races ,98,26,72,63,28,55
2019,Newport News city,51700,Two or More Races ,2146,899,1247,283,202,226
2019,Norfolk city,51710,Two or More Races ,2659,1021,1638,355,229,254
2019,Norton city,51720,Two or More Races ,27,0,27,43,12,43
2019,Petersburg city,51730,Two or More Races ,229,44,185,97,32,106
2019,Poquoson city,51735,Two or More Races ,50,42,8,39,37,16
2019,Portsmouth city,51740,Two or More Races ,774,387,387,164,134,109
2019,Radford city,51750,Two or More Races ,18,13,5,18,14,11
2019,Richmond city,51760,Two or More Races ,2495,680,1815,390,154,355
2019,Roanoke city,51770,Two or More Races ,931,474,457,290,209,222
2019,Salem city,51775,Two or More Races ,90,21,69,64,21,59
2019,Staunton city,51790,Two or More Races ,128,64,64,76,57,59
2019,Suffolk city,51800,Two or More Races ,662,422,240,211,152,136
2019,Virginia Beach city,51810,Two or More Races ,5190,2833,2357,507,335,386
2019,Waynesboro city,51820,Two or More Races ,98,46,52,68,38,62
2019,Williamsburg city,51830,Two or More Races ,95,15,80,81,19,76
2019,Winchester city,51840,Two or More Races ,232,8,224,152,13,151
2020,Accomack County,51001,Two or More Races ,298,218,80,117,88,88
2020,Albemarle County,51003,Two or More Races ,790,464,326,194,159,108
2020,Alleghany County,51005,Two or More Races ,134,129,5,80,79,9
2020,Amelia County,51007,Two or More Races ,87,61,26,88,80,34
2020,Amherst County,51009,Two or More Races ,214,176,38,92,86,40
2020,Appomattox County,51011,Two or More Races ,53,30,23,46,23,32
2020,Arlington County,51013,Two or More Races ,4436,1586,2850,536,346,420
2020,Augusta County,51015,Two or More Races ,287,173,114,167,136,74
2020,Bath County,51017,Two or More Races ,22,22,0,30,30,13
2020,Bedford County,51019,Two or More Races ,356,232,124,143,127,79
2020,Bland County,51021,Two or More Races ,23,0,23,48,18,48
2020,Botetourt County,51023,Two or More Races ,52,49,3,38,38,5
2020,Brunswick County,51025,Two or More Races ,120,87,33,67,61,27
2020,Buchanan County,51027,Two or More Races ,73,73,0,114,114,24
2020,Buckingham County,51029,Two or More Races ,79,49,30,60,42,36
2020,Campbell County,51031,Two or More Races ,487,320,167,181,168,83
2020,Caroline County,51033,Two or More Races ,160,103,57,106,87,55
2020,Carroll County,51035,Two or More Races ,121,43,78,91,53,69
2020,Charles City County,51036,Two or More Races ,84,66,18,25,23,17
2020,Charlotte County,51037,Two or More Races ,30,21,9,27,24,14
2020,Chesterfield County,51041,Two or More Races ,3217,2373,844,513,427,268
2020,Clarke County,51043,Two or More Races ,38,11,27,43,18,37
2020,Craig County,51045,Two or More Races ,16,0,16,29,18,29
2020,Culpeper County,51047,Two or More Races ,344,250,94,128,97,79
2020,Cumberland County,51049,Two or More Races ,53,51,2,45,45,5
2020,Dickenson County,51051,Two or More Races ,27,22,5,27,27,7
2020,Dinwiddie County,51053,Two or More Races ,73,54,19,64,55,23
2020,Essex County,51057,Two or More Races ,121,90,31,97,84,47
2020,Fairfax County,51059,Two or More Races ,16692,10074,6618,1131,850,676
2020,Fauquier County,51061,Two or More Races ,755,509,246,201,163,144
2020,Floyd County,51063,Two or More Races ,61,61,0,56,56,20
2020,Fluvanna County,51065,Two or More Races ,158,137,21,91,85,31
2020,Franklin County,51067,Two or More Races ,355,202,153,187,126,114
2020,Frederick County,51069,Two or More Races ,577,456,121,181,167,73
2020,Giles County,51071,Two or More Races ,53,20,33,42,24,29
2020,Gloucester County,51073,Two or More Races ,176,70,106,103,59,77
2020,Goochland County,51075,Two or More Races ,171,128,43,98,78,50
2020,Grayson County,51077,Two or More Races ,27,11,16,37,21,27
2020,Greene County,51079,Two or More Races ,90,36,54,64,30,55
2020,Greensville County,51081,Two or More Races ,79,13,66,85,18,84
2020,Halifax County,51083,Two or More Races ,197,123,74,101,83,61
2020,Hanover County,51085,Two or More Races ,646,440,206,189,154,119
2020,Henrico County,51087,Two or More Races ,2845,1576,1269,473,377,306
2020,Henry County,51089,Two or More Races ,283,221,62,90,84,54
2020,Highland County,51091,Two or More Races ,7,7,0,12,12,13
2020,Isle of Wight County,51093,Two or More Races ,410,205,205,179,81,160
2020,James City County,51095,Two or More Races ,748,558,190,282,237,143
2020,King and Queen County,51097,Two or More Races ,9,9,0,16,16,18
2020,King George County,51099,Two or More Races ,267,229,38,96,94,20
2020,King William County,51101,Two or More Races ,273,262,11,133,134,23
2020,Lancaster County,51103,Two or More Races ,2,0,2,4,20,4
2020,Lee County,51105,Two or More Races ,15,1,14,49,6,47
2020,Loudoun County,51107,Two or More Races ,5563,3386,2177,607,426,528
2020,Louisa County,51109,Two or More Races ,236,191,45,107,97,48
2020,Lunenburg County,51111,Two or More Races ,50,16,34,33,20,30
2020,Madison County,51113,Two or More Races ,32,31,1,47,47,3
2020,Mathews County,51115,Two or More Races ,108,47,61,81,45,72
2020,Mecklenburg County,51117,Two or More Races ,97,50,47,64,37,48
2020,Middlesex County,51119,Two or More Races ,77,27,50,50,27,40
2020,Montgomery County,51121,Two or More Races ,582,154,428,141,98,124
2020,Nelson County,51125,Two or More Races ,43,14,29,55,21,49
2020,New Kent County,51127,Two or More Races ,283,283,0,160,160,24
2020,Northampton County,51131,Two or More Races ,67,41,26,47,38,28
2020,Northumberland County,51133,Two or More Races ,52,52,0,58,58,20
2020,Nottoway County,51135,Two or More Races ,24,24,0,26,26,20
2020,Orange County,51137,Two or More Races ,330,169,161,176,129,138
2020,Page County,51139,Two or More Races ,171,90,81,75,58,57
2020,Patrick County,51141,Two or More Races ,98,23,75,68,36,63
2020,Pittsylvania County,51143,Two or More Races ,392,265,127,104,92,49
2020,Powhatan County,51145,Two or More Races ,311,282,29,128,126,36
2020,Prince Edward County,51147,Two or More Races ,166,24,142,113,24,113
2020,Prince George County,51149,Two or More Races ,264,137,127,92,62,74
2020,Prince William County,51153,Two or More Races ,7899,4958,2941,780,642,574
2020,Pulaski County,51155,Two or More Races ,190,100,90,78,68,60
2020,Rappahannock County,51157,Two or More Races ,34,22,12,40,32,17
2020,Richmond County,51159,Two or More Races ,45,20,25,43,27,32
2020,Roanoke County,51161,Two or More Races ,359,56,303,147,41,147
2020,Rockbridge County,51163,Two or More Races ,74,70,4,48,49,9
2020,Rockingham County,51165,Two or More Races ,539,367,172,153,126,99
2020,Russell County,51167,Two or More Races ,48,48,0,61,61,24
2020,Scott County,51169,Two or More Races ,35,30,5,34,33,10
2020,Shenandoah County,51171,Two or More Races ,502,195,307,158,99,141
2020,Smyth County,51173,Two or More Races ,72,28,44,67,34,61
2020,Southampton County,51175,Two or More Races ,181,138,43,59,54,38
2020,Spotsylvania County,51177,Two or More Races ,1286,848,438,227,172,166
2020,Stafford County,51179,Two or More Races ,1926,1168,758,331,229,257
2020,Surry County,51181,Two or More Races ,33,8,25,29,17,22
2020,Sussex County,51183,Two or More Races ,72,54,18,62,58,17
2020,Tazewell County,51185,Two or More Races ,132,93,39,105,85,41
2020,Warren County,51187,Two or More Races ,380,309,71,176,171,61
2020,Washington County,51191,Two or More Races ,296,241,55,102,104,50
2020,Westmoreland County,51193,Two or More Races ,94,88,6,91,90,14
2020,Wise County,51195,Two or More Races ,132,35,97,114,23,111
2020,Wythe County,51197,Two or More Races ,19,11,8,31,23,19
2020,York County,51199,Two or More Races ,1258,819,439,260,250,164
2020,Alexandria city,51510,Two or More Races ,3096,900,2196,482,240,420
2020,Bristol city,51520,Two or More Races ,120,43,77,86,44,78
2020,Buena Vista city,51530,Two or More Races ,80,46,34,68,52,48
2020,Charlottesville city,51540,Two or More Races ,632,164,468,241,158,181
2020,Chesapeake city,51550,Two or More Races ,2837,1967,870,502,379,289
2020,Colonial Heights city,51570,Two or More Races ,150,44,106,76,39,60
2020,Covington city,51580,Two or More Races ,49,34,15,34,30,31
2020,Danville city,51590,Two or More Races ,799,142,657,243,89,231
2020,Emporia city,51595,Two or More Races ,83,25,58,71,40,55
2020,Fairfax city,51600,Two or More Races ,446,228,218,149,127,92
2020,Falls Church city,51610,Two or More Races ,76,51,25,45,40,25
2020,Franklin city,51620,Two or More Races ,172,30,142,129,40,121
2020,Fredericksburg city,51630,Two or More Races ,493,143,350,181,103,141
2020,Galax city,51640,Two or More Races ,74,0,74,72,18,72
2020,Hampton city,51650,Two or More Races ,1747,1019,728,350,229,258
2020,Harrisonburg city,51660,Two or More Races ,1201,381,820,315,186,264
2020,Hopewell city,51670,Two or More Races ,143,84,59,87,77,51
2020,Lexington city,51678,Two or More Races ,21,0,21,48,18,48
2020,Lynchburg city,51680,Two or More Races ,360,103,257,109,62,92
2020,Manassas city,51683,Two or More Races ,786,607,179,234,207,91
2020,Manassas Park city,51685,Two or More Races ,226,226,0,132,132,20
2020,Martinsville city,51690,Two or More Races ,133,16,117,80,24,77
2020,Newport News city,51700,Two or More Races ,3010,1078,1932,481,222,449
2020,Norfolk city,51710,Two or More Races ,3416,1522,1894,378,327,285
2020,Norton city,51720,Two or More Races ,21,0,21,42,13,42
2020,Petersburg city,51730,Two or More Races ,371,52,319,162,47,155
2020,Poquoson city,51735,Two or More Races ,128,128,0,75,75,20
2020,Portsmouth city,51740,Two or More Races ,998,439,559,246,156,212
2020,Radford city,51750,Two or More Races ,28,27,1,24,24,3
2020,Richmond city,51760,Two or More Races ,2837,1001,1836,343,275,315
2020,Roanoke city,51770,Two or More Races ,983,368,615,228,161,179
2020,Salem city,51775,Two or More Races ,162,57,105,80,40,67
2020,Staunton city,51790,Two or More Races ,88,39,49,52,34,44
2020,Suffolk city,51800,Two or More Races ,829,471,358,257,175,183
2020,Virginia Beach city,51810,Two or More Races ,6819,3764,3055,741,512,621
2020,Waynesboro city,51820,Two or More Races ,199,35,164,151,46,144
2020,Williamsburg city,51830,Two or More Races ,115,18,97,87,21,84
2020,Winchester city,51840,Two or More Races ,460,110,350,183,139,166
2021,Accomack County,51001,Two or More Races ,616,331,285,172,131,156
2021,Albemarle County,51003,Two or More Races ,885,485,400,214,153,141
2021,Alleghany County,51005,Two or More Races ,142,115,27,117,114,24
2021,Amelia County,51007,Two or More Races ,85,75,10,101,101,18
2021,Amherst County,51009,Two or More Races ,229,179,50,113,100,62
2021,Appomattox County,51011,Two or More Races ,56,24,32,38,16,36
2021,Arlington County,51013,Two or More Races ,5958,2237,3721,557,356,494
2021,Augusta County,51015,Two or More Races ,286,167,119,134,104,71
2021,Bath County,51017,Two or More Races ,0,0,0,13,13,13
2021,Bedford County,51019,Two or More Races ,593,387,206,214,147,136
2021,Bland County,51021,Two or More Races ,4,4,0,8,8,19
2021,Botetourt County,51023,Two or More Races ,190,188,2,98,99,4
2021,Brunswick County,51025,Two or More Races ,154,94,60,79,63,45
2021,Buchanan County,51027,Two or More Races ,170,167,3,158,156,6
2021,Buckingham County,51029,Two or More Races ,86,67,19,48,42,20
2021,Campbell County,51031,Two or More Races ,526,409,117,160,161,65
2021,Caroline County,51033,Two or More Races ,220,148,72,114,84,68
2021,Carroll County,51035,Two or More Races ,135,72,63,86,56,66
2021,Charles City County,51036,Two or More Races ,78,68,10,24,19,10
2021,Charlotte County,51037,Two or More Races ,59,47,12,38,36,16
2021,Chesterfield County,51041,Two or More Races ,4100,3045,1055,446,407,267
2021,Clarke County,51043,Two or More Races ,133,111,22,81,80,34
2021,Craig County,51045,Two or More Races ,37,0,37,52,13,52
2021,Culpeper County,51047,Two or More Races ,380,255,125,164,130,94
2021,Cumberland County,51049,Two or More Races ,29,27,2,35,35,4
2021,Dickenson County,51051,Two or More Races ,41,25,16,36,31,15
2021,Dinwiddie County,51053,Two or More Races ,64,14,50,54,19,53
2021,Essex County,51057,Two or More Races ,180,111,69,112,84,68
2021,Fairfax County,51059,Two or More Races ,22631,13865,8766,1313,934,866
2021,Fauquier County,51061,Two or More Races ,1083,688,395,213,163,172
2021,Floyd County,51063,Two or More Races ,44,44,0,61,61,21
2021,Fluvanna County,51065,Two or More Races ,256,222,34,129,123,36
2021,Franklin County,51067,Two or More Races ,336,174,162,103,85,78
2021,Frederick County,51069,Two or More Races ,613,369,244,153,132,121
2021,Giles County,51071,Two or More Races ,133,55,78,99,58,75
2021,Gloucester County,51073,Two or More Races ,660,524,136,230,234,103
2021,Goochland County,51075,Two or More Races ,115,82,33,72,55,47
2021,Grayson County,51077,Two or More Races ,45,27,18,55,35,34
2021,Greene County,51079,Two or More Races ,138,61,77,78,37,66
2021,Greensville County,51081,Two or More Races ,109,13,96,82,21,79
2021,Halifax County,51083,Two or More Races ,341,284,57,96,104,40
2021,Hanover County,51085,Two or More Races ,987,673,314,259,211,164
2021,Henrico County,51087,Two or More Races ,3923,2021,1902,588,452,405
2021,Henry County,51089,Two or More Races ,268,186,82,109,91,58
2021,Highland County,51091,Two or More Races ,17,13,4,14,13,6
2021,Isle of Wight County,51093,Two or More Races ,543,293,250,167,103,140
2021,James City County,51095,Two or More Races ,1047,759,288,262,200,179
2021,King and Queen County,51097,Two or More Races ,89,83,6,96,95,10
2021,King George County,51099,Two or More Races ,274,225,49,108,102,31
2021,King William County,51101,Two or More Races ,195,195,0,96,96,21
2021,Lancaster County,51103,Two or More Races ,22,16,6,22,18,12
2021,Lee County,51105,Two or More Races ,94,22,72,64,24,64
2021,Loudoun County,51107,Two or More Races ,7430,4640,2790,576,444,436
2021,Louisa County,51109,Two or More Races ,464,341,123,156,147,70
2021,Lunenburg County,51111,Two or More Races ,111,28,83,79,33,70
2021,Madison County,51113,Two or More Races ,207,206,1,123,124,4
2021,Mathews County,51115,Two or More Races ,118,71,47,113,91,55
2021,Mecklenburg County,51117,Two or More Races ,126,55,71,74,36,66
2021,Middlesex County,51119,Two or More Races ,35,35,0,30,30,21
2021,Montgomery County,51121,Two or More Races ,477,150,327,138,79,127
2021,Nelson County,51125,Two or More Races ,107,56,51,79,56,53
2021,New Kent County,51127,Two or More Races ,338,338,0,148,148,25
2021,Northampton County,51131,Two or More Races ,179,42,137,110,45,101
2021,Northumberland County,51133,Two or More Races ,193,164,29,140,130,57
2021,Nottoway County,51135,Two or More Races ,120,101,19,59,63,33
2021,Orange County,51137,Two or More Races ,488,311,177,186,141,129
2021,Page County,51139,Two or More Races ,271,140,131,110,46,90
2021,Patrick County,51141,Two or More Races ,102,31,71,64,30,62
2021,Pittsylvania County,51143,Two or More Races ,383,276,107,105,95,47
2021,Powhatan County,51145,Two or More Races ,354,314,40,143,142,52
2021,Prince Edward County,51147,Two or More Races ,175,20,155,130,23,126
2021,Prince George County,51149,Two or More Races ,375,171,204,110,80,90
2021,Prince William County,51153,Two or More Races ,11368,7501,3867,999,732,656
2021,Pulaski County,51155,Two or More Races ,182,121,61,67,54,43
2021,Rappahannock County,51157,Two or More Races ,77,58,19,56,54,24
2021,Richmond County,51159,Two or More Races ,118,102,16,93,90,19
2021,Roanoke County,51161,Two or More Races ,534,230,304,196,84,186
2021,Rockbridge County,51163,Two or More Races ,84,75,9,59,61,14
2021,Rockingham County,51165,Two or More Races ,841,616,225,175,152,111
2021,Russell County,51167,Two or More Races ,108,103,5,101,99,11
2021,Scott County,51169,Two or More Races ,46,39,7,34,34,8
2021,Shenandoah County,51171,Two or More Races ,556,203,353,155,110,135
2021,Smyth County,51173,Two or More Races ,200,40,160,133,46,130
2021,Southampton County,51175,Two or More Races ,251,213,38,93,88,44
2021,Spotsylvania County,51177,Two or More Races ,1488,1110,378,227,182,141
2021,Stafford County,51179,Two or More Races ,2459,1690,769,469,355,270
2021,Surry County,51181,Two or More Races ,21,13,8,21,17,11
2021,Sussex County,51183,Two or More Races ,116,74,42,83,69,45
2021,Tazewell County,51185,Two or More Races ,131,78,53,78,62,47
2021,Warren County,51187,Two or More Races ,440,366,74,181,160,78
2021,Washington County,51191,Two or More Races ,368,292,76,139,132,51
2021,Westmoreland County,51193,Two or More Races ,189,138,51,118,105,57
2021,Wise County,51195,Two or More Races ,76,13,63,72,11,71
2021,Wythe County,51197,Two or More Races ,87,74,13,67,56,26
2021,York County,51199,Two or More Races ,1224,778,446,295,207,168
2021,Alexandria city,51510,Two or More Races ,4538,1397,3141,639,310,546
2021,Bristol city,51520,Two or More Races ,241,73,168,135,62,142
2021,Buena Vista city,51530,Two or More Races ,41,28,13,20,23,23
2021,Charlottesville city,51540,Two or More Races ,719,258,461,207,151,135
2021,Chesapeake city,51550,Two or More Races ,3292,2350,942,484,363,330
2021,Colonial Heights city,51570,Two or More Races ,223,118,105,99,60,81
2021,Covington city,51580,Two or More Races ,31,1,30,40,3,40
2021,Danville city,51590,Two or More Races ,853,282,571,239,141,198
2021,Emporia city,51595,Two or More Races ,112,31,81,67,47,41
2021,Fairfax city,51600,Two or More Races ,556,290,266,161,111,115
2021,Falls Church city,51610,Two or More Races ,209,148,61,99,86,54
2021,Franklin city,51620,Two or More Races ,235,95,140,117,87,101
2021,Fredericksburg city,51630,Two or More Races ,622,252,370,202,140,176
2021,Galax city,51640,Two or More Races ,140,0,140,90,19,90
2021,Hampton city,51650,Two or More Races ,2643,1505,1138,440,242,360
2021,Harrisonburg city,51660,Two or More Races ,1698,562,1136,315,228,325
2021,Hopewell city,51670,Two or More Races ,308,112,196,103,57,95
2021,Lexington city,51678,Two or More Races ,89,54,35,71,52,47
2021,Lynchburg city,51680,Two or More Races ,541,159,382,171,80,159
2021,Manassas city,51683,Two or More Races ,1394,1042,352,282,265,140
2021,Manassas Park city,51685,Two or More Races ,194,176,18,119,116,29
2021,Martinsville city,51690,Two or More Races ,169,61,108,98,56,77
2021,Newport News city,51700,Two or More Races ,3986,1602,2384,528,307,455
2021,Norfolk city,51710,Two or More Races ,4204,1808,2396,455,295,373
2021,Norton city,51720,Two or More Races ,18,0,18,39,13,39
2021,Petersburg city,51730,Two or More Races ,508,100,408,195,58,184
2021,Poquoson city,51735,Two or More Races ,150,140,10,64,64,14
2021,Portsmouth city,51740,Two or More Races ,1608,911,697,366,258,255
2021,Radford city,51750,Two or More Races ,122,58,64,78,53,64
2021,Richmond city,51760,Two or More Races ,3808,1415,2393,485,284,433
2021,Roanoke city,51770,Two or More Races ,1380,548,832,275,188,241
2021,Salem city,51775,Two or More Races ,296,109,187,111,57,109
2021,Staunton city,51790,Two or More Races ,125,43,82,72,36,56
2021,Suffolk city,51800,Two or More Races ,1200,669,531,267,184,187
2021,Virginia Beach city,51810,Two or More Races ,8580,4684,3896,703,511,577
2021,Waynesboro city,51820,Two or More Races ,598,268,330,215,112,195
2021,Williamsburg city,51830,Two or More Races ,130,27,103,80,33,74
2021,Winchester city,51840,Two or More Races ,420,131,289,204,137,152
2010,Accomack County,51001,"White, Not Hispanic or Latino ",9420,7547,1873,355,361,276
2010,Albemarle County,51003,"White, Not Hispanic or Latino ",30834,21847,8987,510,406,523
2010,Alleghany County,51005,"White, Not Hispanic or Latino ",6545,5484,1061,217,215,179
2010,Amelia County,51007,"White, Not Hispanic or Latino ",3757,3154,603,148,215,182
2010,Amherst County,51009,"White, Not Hispanic or Latino ",9806,7587,2219,330,299,268
2010,Appomattox County,51011,"White, Not Hispanic or Latino ",4819,3840,979,169,213,199
2010,Arlington County,51013,"White, Not Hispanic or Latino ",64466,34580,29886,924,802,1150
2010,Augusta County,51015,"White, Not Hispanic or Latino ",26623,21776,4847,443,527,420
2010,Bath County,51017,"White, Not Hispanic or Latino ",1921,1681,240,197,227,142
2010,Bedford County,51019,"White, Not Hispanic or Latino ",24670,21139,3531,388,445,372
2010,Bland County,51021,"White, Not Hispanic or Latino ",2498,2127,371,221,205,116
2010,Botetourt County,51023,"White, Not Hispanic or Latino ",12324,10814,1510,271,291,240
2010,Brunswick County,51025,"White, Not Hispanic or Latino ",2744,2369,375,204,184,111
2010,Buchanan County,51027,"White, Not Hispanic or Latino ",9079,7233,1846,297,347,265
2010,Buckingham County,51029,"White, Not Hispanic or Latino ",2801,2250,551,874,471,440
2010,Campbell County,51031,"White, Not Hispanic or Latino ",18524,14578,3946,351,384,346
2010,Caroline County,51033,"White, Not Hispanic or Latino ",6862,5837,1025,193,245,219
2010,Carroll County,51035,"White, Not Hispanic or Latino ",12253,9521,2732,429,408,362
2010,Charles City County,51036,"White, Not Hispanic or Latino ",1276,1045,231,61,79,58
2010,Charlotte County,51037,"White, Not Hispanic or Latino ",3027,2487,540,201,184,121
2010,Chesterfield County,51041,"White, Not Hispanic or Latino ",80459,67402,13057,647,787,735
2010,Clarke County,51043,"White, Not Hispanic or Latino ",5028,3930,1098,169,209,185
2010,Craig County,51045,"White, Not Hispanic or Latino ",1970,1704,266,175,150,114
2010,Culpeper County,51047,"White, Not Hispanic or Latino ",12390,9536,2854,334,381,353
2010,Cumberland County,51049,"White, Not Hispanic or Latino ",2487,2024,463,151,171,148
2010,Dickenson County,51051,"White, Not Hispanic or Latino ",6099,4907,1192,226,267,206
2010,Dinwiddie County,51053,"White, Not Hispanic or Latino ",6620,5341,1279,216,240,212
2010,Essex County,51057,"White, Not Hispanic or Latino ",2687,2251,436,150,143,149
2010,Fairfax County,51059,"White, Not Hispanic or Latino ",243982,190564,53418,1236,1634,1283
2010,Fauquier County,51061,"White, Not Hispanic or Latino ",19213,15621,3592,471,457,394
2010,Floyd County,51063,"White, Not Hispanic or Latino ",5981,4818,1163,210,278,219
2010,Fluvanna County,51065,"White, Not Hispanic or Latino ",7468,6539,929,276,304,191
2010,Franklin County,51067,"White, Not Hispanic or Latino ",20852,16690,4162,399,530,449
2010,Frederick County,51069,"White, Not Hispanic or Latino ",25686,20752,4934,555,623,456
2010,Giles County,51071,"White, Not Hispanic or Latino ",6894,5371,1523,241,248,210
2010,Gloucester County,51073,"White, Not Hispanic or Latino ",12042,10073,1969,327,377,307
2010,Goochland County,51075,"White, Not Hispanic or Latino ",5387,4973,414,874,633,306
2010,Grayson County,51077,"White, Not Hispanic or Latino ",6662,5393,1269,232,244,208
2010,Greene County,51079,"White, Not Hispanic or Latino ",5989,4850,1139,255,319,231
2010,Greensville County,51081,"White, Not Hispanic or Latino ",1663,1363,300,145,132,88
2010,Halifax County,51083,"White, Not Hispanic or Latino ",9258,7280,1978,299,323,317
2010,Hanover County,51085,"White, Not Hispanic or Latino ",31757,27258,4499,429,538,436
2010,Henrico County,51087,"White, Not Hispanic or Latino ",76687,57447,19240,788,856,780
2010,Henry County,51089,"White, Not Hispanic or Latino ",17147,13776,3371,384,501,399
2010,Highland County,51091,"White, Not Hispanic or Latino ",1096,832,264,88,104,85
2010,Isle of Wight County,51093,"White, Not Hispanic or Latino ",9649,8400,1249,200,241,191
2010,James City County,51095,"White, Not Hispanic or Latino ",21386,17016,4370,338,434,378
2010,King and Queen County,51097,"White, Not Hispanic or Latino ",1959,1554,405,124,138,133
2010,King George County,51099,"White, Not Hispanic or Latino ",6280,5053,1227,288,273,293
2010,King William County,51101,"White, Not Hispanic or Latino ",4555,3994,561,138,176,167
2010,Lancaster County,51103,"White, Not Hispanic or Latino ",3891,3253,638,161,189,131
2010,Lee County,51105,"White, Not Hispanic or Latino ",9604,7119,2485,287,284,255
2010,Loudoun County,51107,"White, Not Hispanic or Latino ",67069,55749,11320,730,773,598
2010,Louisa County,51109,"White, Not Hispanic or Latino ",10426,8514,1912,318,357,332
2010,Lunenburg County,51111,"White, Not Hispanic or Latino ",2892,2326,566,156,149,148
2010,Madison County,51113,"White, Not Hispanic or Latino ",4437,3592,845,175,251,198
2010,Mathews County,51115,"White, Not Hispanic or Latino ",3329,2845,484,229,183,170
2010,Mecklenburg County,51117,"White, Not Hispanic or Latino ",8177,6664,1513,283,243,187
2010,Middlesex County,51119,"White, Not Hispanic or Latino ",3611,2975,636,222,176,157
2010,Montgomery County,51121,"White, Not Hispanic or Latino ",30091,18170,11921,690,473,761
2010,Nelson County,51125,"White, Not Hispanic or Latino ",5393,4219,1174,263,270,297
2010,New Kent County,51127,"White, Not Hispanic or Latino ",5437,4971,466,157,169,115
2010,Northampton County,51131,"White, Not Hispanic or Latino ",3133,2497,636,156,170,126
2010,Northumberland County,51133,"White, Not Hispanic or Latino ",4271,3680,591,247,229,183
2010,Nottoway County,51135,"White, Not Hispanic or Latino ",3504,2634,870,200,209,203
2010,Orange County,51137,"White, Not Hispanic or Latino ",10746,8671,2075,323,286,260
2010,Page County,51139,"White, Not Hispanic or Latino ",9289,7081,2208,274,329,321
2010,Patrick County,51141,"White, Not Hispanic or Latino ",6828,5693,1135,292,294,227
2010,Pittsylvania County,51143,"White, Not Hispanic or Latino ",20386,16786,3600,348,455,438
2010,Powhatan County,51145,"White, Not Hispanic or Latino ",7585,6857,728,852,751,236
2010,Prince Edward County,51147,"White, Not Hispanic or Latino ",4653,3190,1463,332,221,285
2010,Prince George County,51149,"White, Not Hispanic or Latino ",6892,5654,1238,378,324,226
2010,Prince William County,51153,"White, Not Hispanic or Latino ",70802,57533,13269,695,793,701
2010,Pulaski County,51155,"White, Not Hispanic or Latino ",13786,10333,3453,328,379,331
2010,Rappahannock County,51157,"White, Not Hispanic or Latino ",2921,2162,759,140,149,167
2010,Richmond County,51159,"White, Not Hispanic or Latino ",2334,1920,414,164,166,124
2010,Roanoke County,51161,"White, Not Hispanic or Latino ",34485,27600,6885,455,518,447
2010,Rockbridge County,51163,"White, Not Hispanic or Latino ",9078,6967,2111,267,303,289
2010,Rockingham County,51165,"White, Not Hispanic or Latino ",27912,21279,6633,424,479,433
2010,Russell County,51167,"White, Not Hispanic or Latino ",11275,8678,2597,288,343,368
2010,Scott County,51169,"White, Not Hispanic or Latino ",9449,7320,2129,289,335,288
2010,Shenandoah County,51171,"White, Not Hispanic or Latino ",16288,11485,4803,385,422,439
2010,Smyth County,51173,"White, Not Hispanic or Latino ",12610,9322,3288,352,327,296
2010,Southampton County,51175,"White, Not Hispanic or Latino ",4129,3361,768,155,185,164
2010,Spotsylvania County,51177,"White, Not Hispanic or Latino ",31159,25173,5986,596,615,566
2010,Stafford County,51179,"White, Not Hispanic or Latino ",29430,23966,5464,559,562,436
2010,Surry County,51181,"White, Not Hispanic or Latino ",1312,1012,300,114,100,104
2010,Sussex County,51183,"White, Not Hispanic or Latino ",1758,1341,417,120,112,118
2010,Tazewell County,51185,"White, Not Hispanic or Latino ",17132,12848,4284,333,423,420
2010,Warren County,51187,"White, Not Hispanic or Latino ",12884,9769,3115,313,414,338
2010,Washington County,51191,"White, Not Hispanic or Latino ",21936,16454,5482,472,495,444
2010,Westmoreland County,51193,"White, Not Hispanic or Latino ",5054,3864,1190,217,223,230
2010,Wise County,51195,"White, Not Hispanic or Latino ",15288,10688,4600,366,417,395
2010,Wythe County,51197,"White, Not Hispanic or Latino ",11213,8640,2573,369,419,343
2010,York County,51199,"White, Not Hispanic or Latino ",18796,15345,3451,377,368,350
2010,Alexandria city,51510,"White, Not Hispanic or Latino ",39825,22772,17053,556,660,613
2010,Bedford County,51019,"White, Not Hispanic or Latino ",2083,1498,585,176,226,180
2010,Bristol city,51520,"White, Not Hispanic or Latino ",7417,4775,2642,241,294,324
2010,Buena Vista city,51530,"White, Not Hispanic or Latino ",2403,1523,880,139,164,171
2010,Charlottesville city,51540,"White, Not Hispanic or Latino ",12742,5987,6755,677,292,718
2010,Chesapeake city,51550,"White, Not Hispanic or Latino ",50083,40914,9169,581,551,634
2010,Colonial Heights city,51570,"White, Not Hispanic or Latino ",6001,4360,1641,206,195,232
2010,Covington city,51580,"White, Not Hispanic or Latino ",2158,1487,671,139,115,148
2010,Danville city,51590,"White, Not Hispanic or Latino ",10169,6882,3287,377,378,314
2010,Emporia city,51595,"White, Not Hispanic or Latino ",906,586,320,154,132,106
2010,Fairfax city,51600,"White, Not Hispanic or Latino ",6080,4664,1416,164,211,187
2010,Falls Church city,51610,"White, Not Hispanic or Latino ",3737,2532,1205,132,170,161
2010,Franklin city,51620,"White, Not Hispanic or Latino ",1473,1141,332,123,122,86
2010,Fredericksburg city,51630,"White, Not Hispanic or Latino ",6417,2891,3526,284,275,332
2010,Galax city,51640,"White, Not Hispanic or Latino ",2658,1710,948,447,348,238
2010,Hampton city,51650,"White, Not Hispanic or Latino ",24776,17151,7625,395,463,437
2010,Harrisonburg city,51660,"White, Not Hispanic or Latino ",11319,4915,6404,536,325,536
2010,Hopewell city,51670,"White, Not Hispanic or Latino ",5273,3423,1850,218,269,258
2010,Lexington city,51678,"White, Not Hispanic or Latino ",1704,943,761,373,219,220
2010,Lynchburg city,51680,"White, Not Hispanic or Latino ",18418,11719,6699,483,407,510
2010,Manassas city,51683,"White, Not Hispanic or Latino ",7426,5482,1944,225,253,267
2010,Manassas Park city,51685,"White, Not Hispanic or Latino ",2173,1474,699,120,143,154
2010,Martinsville city,51690,"White, Not Hispanic or Latino ",3299,2374,925,184,157,150
2010,Newport News city,51700,"White, Not Hispanic or Latino ",35039,23241,11798,728,644,640
2010,Norfolk city,51710,"White, Not Hispanic or Latino ",43043,25887,17156,1033,696,879
2010,Norton city,51720,"White, Not Hispanic or Latino ",1630,909,721,162,156,144
2010,Petersburg city,51730,"White, Not Hispanic or Latino ",2284,1551,733,204,170,139
2010,Poquoson city,51735,"White, Not Hispanic or Latino ",4346,3690,656,92,167,151
2010,Portsmouth city,51740,"White, Not Hispanic or Latino ",16897,12995,3902,443,415,416
2010,Radford city,51750,"White, Not Hispanic or Latino ",5099,2681,2418,316,156,347
2010,Richmond city,51760,"White, Not Hispanic or Latino ",37287,21246,16041,709,607,668
2010,Roanoke city,51770,"White, Not Hispanic or Latino ",29310,18316,10994,543,587,626
2010,Salem city,51775,"White, Not Hispanic or Latino ",8957,6583,2374,289,267,312
2010,Staunton city,51790,"White, Not Hispanic or Latino ",9126,5763,3363,375,390,321
2010,Suffolk city,51800,"White, Not Hispanic or Latino ",16428,13972,2456,345,402,315
2010,Virginia Beach city,51810,"White, Not Hispanic or Latino ",114721,82241,32480,1243,1026,1109
2010,Waynesboro city,51820,"White, Not Hispanic or Latino ",7219,4564,2655,347,322,324
2010,Williamsburg city,51830,"White, Not Hispanic or Latino ",3158,1729,1429,305,130,302
2010,Winchester city,51840,"White, Not Hispanic or Latino ",8469,4539,3930,398,347,379
2011,Accomack County,51001,"White, Not Hispanic or Latino ",9288,7634,1654,298,296,245
2011,Albemarle County,51003,"White, Not Hispanic or Latino ",30594,21908,8686,528,448,551
2011,Alleghany County,51005,"White, Not Hispanic or Latino ",6540,5307,1233,203,212,174
2011,Amelia County,51007,"White, Not Hispanic or Latino ",3727,3092,635,171,194,191
2011,Amherst County,51009,"White, Not Hispanic or Latino ",9685,7557,2128,277,300,265
2011,Appomattox County,51011,"White, Not Hispanic or Latino ",4733,3700,1033,162,228,209
2011,Arlington County,51013,"White, Not Hispanic or Latino ",64751,34269,30482,831,690,922
2011,Augusta County,51015,"White, Not Hispanic or Latino ",26757,22026,4731,531,528,470
2011,Bath County,51017,"White, Not Hispanic or Latino ",1857,1592,265,205,222,129
2011,Bedford County,51019,"White, Not Hispanic or Latino ",24712,21173,3539,383,471,406
2011,Bland County,51021,"White, Not Hispanic or Latino ",2595,2193,402,234,219,132
2011,Botetourt County,51023,"White, Not Hispanic or Latino ",12225,10783,1442,265,333,249
2011,Brunswick County,51025,"White, Not Hispanic or Latino ",2742,2338,404,171,179,121
2011,Buchanan County,51027,"White, Not Hispanic or Latino ",9043,7159,1884,303,314,266
2011,Buckingham County,51029,"White, Not Hispanic or Latino ",3681,2869,812,385,346,253
2011,Campbell County,51031,"White, Not Hispanic or Latino ",18170,14276,3894,375,451,427
2011,Caroline County,51033,"White, Not Hispanic or Latino ",6866,5834,1032,222,296,235
2011,Carroll County,51035,"White, Not Hispanic or Latino ",12105,9523,2582,474,429,390
2011,Charles City County,51036,"White, Not Hispanic or Latino ",1279,1066,213,59,66,50
2011,Charlotte County,51037,"White, Not Hispanic or Latino ",3074,2583,491,227,195,128
2011,Chesterfield County,51041,"White, Not Hispanic or Latino ",80349,66792,13557,631,857,836
2011,Clarke County,51043,"White, Not Hispanic or Latino ",5055,3998,1057,167,195,193
2011,Craig County,51045,"White, Not Hispanic or Latino ",1976,1756,220,181,211,121
2011,Culpeper County,51047,"White, Not Hispanic or Latino ",12340,9451,2889,284,320,387
2011,Cumberland County,51049,"White, Not Hispanic or Latino ",2507,2011,496,159,194,142
2011,Dickenson County,51051,"White, Not Hispanic or Latino ",6116,4772,1344,250,237,200
2011,Dinwiddie County,51053,"White, Not Hispanic or Latino ",6370,5289,1081,197,240,201
2011,Essex County,51057,"White, Not Hispanic or Latino ",2692,2254,438,140,150,137
2011,Fairfax County,51059,"White, Not Hispanic or Latino ",243767,189041,54726,1223,1512,1526
2011,Fauquier County,51061,"White, Not Hispanic or Latino ",19840,16000,3840,381,471,441
2011,Floyd County,51063,"White, Not Hispanic or Latino ",5828,4629,1199,266,338,237
2011,Fluvanna County,51065,"White, Not Hispanic or Latino ",7639,6706,933,271,322,211
2011,Franklin County,51067,"White, Not Hispanic or Latino ",20932,17022,3910,447,410,450
2011,Frederick County,51069,"White, Not Hispanic or Latino ",25768,20736,5032,431,470,515
2011,Giles County,51071,"White, Not Hispanic or Latino ",6860,5351,1509,196,221,177
2011,Gloucester County,51073,"White, Not Hispanic or Latino ",11924,10148,1776,325,319,268
2011,Goochland County,51075,"White, Not Hispanic or Latino ",6540,6087,453,193,204,135
2011,Grayson County,51077,"White, Not Hispanic or Latino ",6532,5207,1325,370,308,225
2011,Greene County,51079,"White, Not Hispanic or Latino ",6139,4958,1181,201,295,276
2011,Greensville County,51081,"White, Not Hispanic or Latino ",1556,1237,319,304,211,150
2011,Halifax County,51083,"White, Not Hispanic or Latino ",9166,7298,1868,235,286,288
2011,Hanover County,51085,"White, Not Hispanic or Latino ",31964,27313,4651,340,549,436
2011,Henrico County,51087,"White, Not Hispanic or Latino ",76453,57064,19389,723,835,771
2011,Henry County,51089,"White, Not Hispanic or Latino ",17187,13512,3675,373,390,386
2011,Highland County,51091,"White, Not Hispanic or Latino ",1076,856,220,77,80,72
2011,Isle of Wight County,51093,"White, Not Hispanic or Latino ",9755,8491,1264,208,256,221
2011,James City County,51095,"White, Not Hispanic or Latino ",21660,17253,4407,343,457,390
2011,King and Queen County,51097,"White, Not Hispanic or Latino ",1946,1519,427,111,119,109
2011,King George County,51099,"White, Not Hispanic or Latino ",6247,4966,1281,292,271,270
2011,King William County,51101,"White, Not Hispanic or Latino ",4636,3907,729,150,170,175
2011,Lancaster County,51103,"White, Not Hispanic or Latino ",4017,3371,646,130,149,149
2011,Lee County,51105,"White, Not Hispanic or Latino ",9782,7322,2460,268,309,273
2011,Loudoun County,51107,"White, Not Hispanic or Latino ",69249,56675,12574,699,786,700
2011,Louisa County,51109,"White, Not Hispanic or Latino ",10412,8396,2016,305,318,303
2011,Lunenburg County,51111,"White, Not Hispanic or Latino ",2893,2284,609,167,202,129
2011,Madison County,51113,"White, Not Hispanic or Latino ",4464,3565,899,160,215,208
2011,Mathews County,51115,"White, Not Hispanic or Latino ",3358,2840,518,231,204,173
2011,Mecklenburg County,51117,"White, Not Hispanic or Latino ",8094,6678,1416,284,287,212
2011,Middlesex County,51119,"White, Not Hispanic or Latino ",3604,2982,622,203,205,147
2011,Montgomery County,51121,"White, Not Hispanic or Latino ",30046,17721,12325,736,454,746
2011,Nelson County,51125,"White, Not Hispanic or Latino ",5429,4142,1287,289,259,291
2011,New Kent County,51127,"White, Not Hispanic or Latino ",5467,5039,428,198,195,130
2011,Northampton County,51131,"White, Not Hispanic or Latino ",3183,2486,697,164,183,119
2011,Northumberland County,51133,"White, Not Hispanic or Latino ",4378,3734,644,278,240,227
2011,Nottoway County,51135,"White, Not Hispanic or Latino ",3533,2776,757,183,218,167
2011,Orange County,51137,"White, Not Hispanic or Latino ",10787,8387,2400,321,351,302
2011,Page County,51139,"White, Not Hispanic or Latino ",9209,6969,2240,278,311,257
2011,Patrick County,51141,"White, Not Hispanic or Latino ",6654,5412,1242,339,332,248
2011,Pittsylvania County,51143,"White, Not Hispanic or Latino ",20194,16604,3590,370,356,328
2011,Powhatan County,51145,"White, Not Hispanic or Latino ",8545,7628,917,196,214,172
2011,Prince Edward County,51147,"White, Not Hispanic or Latino ",4560,3233,1327,362,210,339
2011,Prince George County,51149,"White, Not Hispanic or Latino ",7211,5848,1363,337,324,272
2011,Prince William County,51153,"White, Not Hispanic or Latino ",71077,58049,13028,649,778,739
2011,Pulaski County,51155,"White, Not Hispanic or Latino ",13897,10353,3544,381,373,408
2011,Rappahannock County,51157,"White, Not Hispanic or Latino ",2999,2313,686,142,145,166
2011,Richmond County,51159,"White, Not Hispanic or Latino ",2180,1766,414,141,136,115
2011,Roanoke County,51161,"White, Not Hispanic or Latino ",34593,27401,7192,445,535,494
2011,Rockbridge County,51163,"White, Not Hispanic or Latino ",8872,6597,2275,253,316,292
2011,Rockingham County,51165,"White, Not Hispanic or Latino ",28057,21770,6287,416,422,384
2011,Russell County,51167,"White, Not Hispanic or Latino ",11085,8503,2582,357,344,292
2011,Scott County,51169,"White, Not Hispanic or Latino ",9551,7465,2086,263,273,265
2011,Shenandoah County,51171,"White, Not Hispanic or Latino ",16194,11590,4604,386,382,440
2011,Smyth County,51173,"White, Not Hispanic or Latino ",12308,8887,3421,289,328,306
2011,Southampton County,51175,"White, Not Hispanic or Latino ",4162,3288,874,185,190,153
2011,Spotsylvania County,51177,"White, Not Hispanic or Latino ",31095,24896,6199,470,564,454
2011,Stafford County,51179,"White, Not Hispanic or Latino ",29842,24543,5299,432,545,467
2011,Surry County,51181,"White, Not Hispanic or Latino ",1325,1017,308,114,109,98
2011,Sussex County,51183,"White, Not Hispanic or Latino ",1754,1246,508,181,145,172
2011,Tazewell County,51185,"White, Not Hispanic or Latino ",17172,12709,4463,425,429,466
2011,Warren County,51187,"White, Not Hispanic or Latino ",12969,9753,3216,351,404,369
2011,Washington County,51191,"White, Not Hispanic or Latino ",22340,16924,5416,442,444,375
2011,Westmoreland County,51193,"White, Not Hispanic or Latino ",5046,3873,1173,257,258,239
2011,Wise County,51195,"White, Not Hispanic or Latino ",15050,10579,4471,414,409,359
2011,Wythe County,51197,"White, Not Hispanic or Latino ",11270,8359,2911,405,433,427
2011,York County,51199,"White, Not Hispanic or Latino ",18664,15148,3516,323,340,311
2011,Alexandria city,51510,"White, Not Hispanic or Latino ",40082,22591,17491,567,656,684
2011,Bedford County,51019,"White, Not Hispanic or Latino ",2118,1462,656,205,192,178
2011,Bristol city,51520,"White, Not Hispanic or Latino ",7373,4656,2717,230,282,313
2011,Buena Vista city,51530,"White, Not Hispanic or Latino ",2411,1512,899,128,174,189
2011,Charlottesville city,51540,"White, Not Hispanic or Latino ",12853,5906,6947,329,287,416
2011,Chesapeake city,51550,"White, Not Hispanic or Latino ",50124,40543,9581,582,748,706
2011,Colonial Heights city,51570,"White, Not Hispanic or Latino ",6056,4419,1637,205,225,208
2011,Covington city,51580,"White, Not Hispanic or Latino ",2071,1467,604,126,147,133
2011,Danville city,51590,"White, Not Hispanic or Latino ",9767,6632,3135,323,217,313
2011,Emporia city,51595,"White, Not Hispanic or Latino ",803,523,280,134,104,111
2011,Fairfax city,51600,"White, Not Hispanic or Latino ",5969,4531,1438,174,216,198
2011,Falls Church city,51610,"White, Not Hispanic or Latino ",3777,2588,1189,158,160,174
2011,Franklin city,51620,"White, Not Hispanic or Latino ",1485,1067,418,117,145,108
2011,Fredericksburg city,51630,"White, Not Hispanic or Latino ",6338,2784,3554,292,205,300
2011,Galax city,51640,"White, Not Hispanic or Latino ",2945,1910,1035,293,246,257
2011,Hampton city,51650,"White, Not Hispanic or Latino ",24192,17126,7066,508,532,525
2011,Harrisonburg city,51660,"White, Not Hispanic or Latino ",11654,4772,6882,395,367,485
2011,Hopewell city,51670,"White, Not Hispanic or Latino ",5213,3329,1884,231,224,242
2011,Lexington city,51678,"White, Not Hispanic or Latino ",1360,749,611,694,366,370
2011,Lynchburg city,51680,"White, Not Hispanic or Latino ",18898,11935,6963,368,378,418
2011,Manassas city,51683,"White, Not Hispanic or Latino ",7125,5247,1878,272,302,280
2011,Manassas Park city,51685,"White, Not Hispanic or Latino ",2154,1450,704,143,136,137
2011,Martinsville city,51690,"White, Not Hispanic or Latino ",3189,2278,911,192,166,160
2011,Newport News city,51700,"White, Not Hispanic or Latino ",34632,22582,12050,618,651,630
2011,Norfolk city,51710,"White, Not Hispanic or Latino ",42622,25197,17425,671,672,645
2011,Norton city,51720,"White, Not Hispanic or Latino ",1571,897,674,163,136,153
2011,Petersburg city,51730,"White, Not Hispanic or Latino ",2206,1492,714,162,155,153
2011,Poquoson city,51735,"White, Not Hispanic or Latino ",4319,3609,710,105,175,166
2011,Portsmouth city,51740,"White, Not Hispanic or Latino ",16275,12409,3866,422,446,377
2011,Radford city,51750,"White, Not Hispanic or Latino ",5004,2536,2468,287,203,318
2011,Richmond city,51760,"White, Not Hispanic or Latino ",37526,21264,16262,800,564,806
2011,Roanoke city,51770,"White, Not Hispanic or Latino ",29343,18662,10681,442,510,499
2011,Salem city,51775,"White, Not Hispanic or Latino ",9064,6673,2391,243,327,305
2011,Staunton city,51790,"White, Not Hispanic or Latino ",9370,5832,3538,247,249,300
2011,Suffolk city,51800,"White, Not Hispanic or Latino ",16505,14012,2493,308,373,284
2011,Virginia Beach city,51810,"White, Not Hispanic or Latino ",114271,81066,33205,937,995,990
2011,Waynesboro city,51820,"White, Not Hispanic or Latino ",7377,4662,2715,201,266,256
2011,Williamsburg city,51830,"White, Not Hispanic or Latino ",3321,1639,1682,291,107,292
2011,Winchester city,51840,"White, Not Hispanic or Latino ",8182,4385,3797,288,286,335
2012,Accomack County,51001,"White, Not Hispanic or Latino ",9388,7351,2037,319,278,258
2012,Albemarle County,51003,"White, Not Hispanic or Latino ",30957,21967,8990,568,535,604
2012,Alleghany County,51005,"White, Not Hispanic or Latino ",6435,5259,1176,200,190,181
2012,Amelia County,51007,"White, Not Hispanic or Latino ",3575,2913,662,197,234,214
2012,Amherst County,51009,"White, Not Hispanic or Latino ",9711,7528,2183,287,268,265
2012,Appomattox County,51011,"White, Not Hispanic or Latino ",4726,3713,1013,174,221,207
2012,Arlington County,51013,"White, Not Hispanic or Latino ",65738,34062,31676,787,754,1001
2012,Augusta County,51015,"White, Not Hispanic or Latino ",27121,22347,4774,390,534,520
2012,Bath County,51017,"White, Not Hispanic or Latino ",1926,1552,374,205,228,176
2012,Bedford County,51019,"White, Not Hispanic or Latino ",24687,21238,3449,442,463,346
2012,Bland County,51021,"White, Not Hispanic or Latino ",2433,2020,413,188,183,118
2012,Botetourt County,51023,"White, Not Hispanic or Latino ",12258,10778,1480,277,311,219
2012,Brunswick County,51025,"White, Not Hispanic or Latino ",2728,2296,432,201,198,135
2012,Buchanan County,51027,"White, Not Hispanic or Latino ",9267,7294,1973,329,339,266
2012,Buckingham County,51029,"White, Not Hispanic or Latino ",3724,2974,750,392,321,216
2012,Campbell County,51031,"White, Not Hispanic or Latino ",18186,14370,3816,433,472,365
2012,Caroline County,51033,"White, Not Hispanic or Latino ",7045,5922,1123,243,268,171
2012,Carroll County,51035,"White, Not Hispanic or Latino ",12395,9783,2612,380,444,369
2012,Charles City County,51036,"White, Not Hispanic or Latino ",1287,1045,242,64,64,61
2012,Charlotte County,51037,"White, Not Hispanic or Latino ",3280,2615,665,182,208,152
2012,Chesterfield County,51041,"White, Not Hispanic or Latino ",80052,66567,13485,667,732,668
2012,Clarke County,51043,"White, Not Hispanic or Latino ",5078,4071,1007,183,238,191
2012,Craig County,51045,"White, Not Hispanic or Latino ",2059,1758,301,179,205,118
2012,Culpeper County,51047,"White, Not Hispanic or Latino ",12387,9657,2730,365,386,331
2012,Cumberland County,51049,"White, Not Hispanic or Latino ",2532,2083,449,159,185,135
2012,Dickenson County,51051,"White, Not Hispanic or Latino ",6325,4974,1351,159,243,197
2012,Dinwiddie County,51053,"White, Not Hispanic or Latino ",6316,5131,1185,234,257,224
2012,Essex County,51057,"White, Not Hispanic or Latino ",2605,2138,467,133,122,128
2012,Fairfax County,51059,"White, Not Hispanic or Latino ",243666,187405,56261,1529,1482,1497
2012,Fauquier County,51061,"White, Not Hispanic or Latino ",19790,16000,3790,372,444,427
2012,Floyd County,51063,"White, Not Hispanic or Latino ",5778,4585,1193,279,308,256
2012,Fluvanna County,51065,"White, Not Hispanic or Latino ",7884,6974,910,236,284,216
2012,Franklin County,51067,"White, Not Hispanic or Latino ",20971,16660,4311,396,416,455
2012,Frederick County,51069,"White, Not Hispanic or Latino ",26041,21090,4951,379,523,405
2012,Giles County,51071,"White, Not Hispanic or Latino ",6923,5371,1552,231,242,234
2012,Gloucester County,51073,"White, Not Hispanic or Latino ",11969,10170,1799,351,419,343
2012,Goochland County,51075,"White, Not Hispanic or Latino ",6575,6058,517,186,180,128
2012,Grayson County,51077,"White, Not Hispanic or Latino ",6562,5094,1468,321,291,237
2012,Greene County,51079,"White, Not Hispanic or Latino ",6127,4821,1306,235,309,279
2012,Greensville County,51081,"White, Not Hispanic or Latino ",1575,1142,433,318,227,172
2012,Halifax County,51083,"White, Not Hispanic or Latino ",9158,7127,2031,264,267,230
2012,Hanover County,51085,"White, Not Hispanic or Latino ",31835,27209,4626,412,480,382
2012,Henrico County,51087,"White, Not Hispanic or Latino ",76162,56688,19474,631,913,772
2012,Henry County,51089,"White, Not Hispanic or Latino ",17136,13641,3495,455,443,391
2012,Highland County,51091,"White, Not Hispanic or Latino ",1035,864,171,86,105,57
2012,Isle of Wight County,51093,"White, Not Hispanic or Latino ",9790,8431,1359,195,292,258
2012,James City County,51095,"White, Not Hispanic or Latino ",21810,17311,4499,418,442,398
2012,King and Queen County,51097,"White, Not Hispanic or Latino ",2022,1531,491,112,140,151
2012,King George County,51099,"White, Not Hispanic or Latino ",6307,5025,1282,259,226,245
2012,King William County,51101,"White, Not Hispanic or Latino ",4666,3955,711,182,227,193
2012,Lancaster County,51103,"White, Not Hispanic or Latino ",3939,3416,523,169,164,118
2012,Lee County,51105,"White, Not Hispanic or Latino ",9618,7201,2417,299,333,240
2012,Loudoun County,51107,"White, Not Hispanic or Latino ",71710,58603,13107,661,738,755
2012,Louisa County,51109,"White, Not Hispanic or Latino ",10373,8581,1792,307,381,326
2012,Lunenburg County,51111,"White, Not Hispanic or Latino ",2930,2412,518,176,168,109
2012,Madison County,51113,"White, Not Hispanic or Latino ",4353,3461,892,187,218,222
2012,Mathews County,51115,"White, Not Hispanic or Latino ",3416,2758,658,230,203,173
2012,Mecklenburg County,51117,"White, Not Hispanic or Latino ",7994,6507,1487,273,283,254
2012,Middlesex County,51119,"White, Not Hispanic or Latino ",3610,3055,555,218,195,152
2012,Montgomery County,51121,"White, Not Hispanic or Latino ",30151,17586,12565,718,553,718
2012,Nelson County,51125,"White, Not Hispanic or Latino ",5250,4086,1164,313,253,236
2012,New Kent County,51127,"White, Not Hispanic or Latino ",5625,5089,536,205,213,127
2012,Northampton County,51131,"White, Not Hispanic or Latino ",3087,2409,678,170,159,161
2012,Northumberland County,51133,"White, Not Hispanic or Latino ",4351,3776,575,285,258,209
2012,Nottoway County,51135,"White, Not Hispanic or Latino ",3401,2644,757,199,187,149
2012,Orange County,51137,"White, Not Hispanic or Latino ",10589,8379,2210,311,311,325
2012,Page County,51139,"White, Not Hispanic or Latino ",9131,6885,2246,271,291,295
2012,Patrick County,51141,"White, Not Hispanic or Latino ",6984,5512,1472,314,297,259
2012,Pittsylvania County,51143,"White, Not Hispanic or Latino ",20384,16839,3545,403,382,400
2012,Powhatan County,51145,"White, Not Hispanic or Latino ",8453,7608,845,179,232,178
2012,Prince Edward County,51147,"White, Not Hispanic or Latino ",4516,3340,1176,269,209,251
2012,Prince George County,51149,"White, Not Hispanic or Latino ",7122,5863,1259,280,305,217
2012,Prince William County,51153,"White, Not Hispanic or Latino ",72592,58636,13956,659,837,757
2012,Pulaski County,51155,"White, Not Hispanic or Latino ",13891,10193,3698,393,434,373
2012,Rappahannock County,51157,"White, Not Hispanic or Latino ",2988,2307,681,157,122,152
2012,Richmond County,51159,"White, Not Hispanic or Latino ",2039,1548,491,147,143,126
2012,Roanoke County,51161,"White, Not Hispanic or Latino ",34459,26963,7496,415,594,510
2012,Rockbridge County,51163,"White, Not Hispanic or Latino ",8683,6385,2298,281,335,282
2012,Rockingham County,51165,"White, Not Hispanic or Latino ",27936,21647,6289,382,447,398
2012,Russell County,51167,"White, Not Hispanic or Latino ",10909,8472,2437,369,359,315
2012,Scott County,51169,"White, Not Hispanic or Latino ",9432,7371,2061,250,315,252
2012,Shenandoah County,51171,"White, Not Hispanic or Latino ",16244,11795,4449,414,442,420
2012,Smyth County,51173,"White, Not Hispanic or Latino ",12192,8750,3442,339,354,362
2012,Southampton County,51175,"White, Not Hispanic or Latino ",4171,3293,878,171,181,135
2012,Spotsylvania County,51177,"White, Not Hispanic or Latino ",31090,25045,6045,495,590,475
2012,Stafford County,51179,"White, Not Hispanic or Latino ",29945,24552,5393,405,463,406
2012,Surry County,51181,"White, Not Hispanic or Latino ",1356,1105,251,99,104,94
2012,Sussex County,51183,"White, Not Hispanic or Latino ",1652,1274,378,140,132,106
2012,Tazewell County,51185,"White, Not Hispanic or Latino ",17272,12691,4581,363,465,417
2012,Warren County,51187,"White, Not Hispanic or Latino ",13097,9611,3486,308,445,409
2012,Washington County,51191,"White, Not Hispanic or Latino ",22169,16886,5283,471,500,449
2012,Westmoreland County,51193,"White, Not Hispanic or Latino ",5006,3852,1154,274,254,222
2012,Wise County,51195,"White, Not Hispanic or Latino ",15275,10621,4654,310,393,379
2012,Wythe County,51197,"White, Not Hispanic or Latino ",11289,8204,3085,406,412,402
2012,York County,51199,"White, Not Hispanic or Latino ",18320,14626,3694,340,364,324
2012,Alexandria city,51510,"White, Not Hispanic or Latino ",39629,22179,17450,646,599,683
2012,Bedford County,51019,"White, Not Hispanic or Latino ",2062,1401,661,172,188,224
2012,Bristol city,51520,"White, Not Hispanic or Latino ",7264,4478,2786,253,252,300
2012,Buena Vista city,51530,"White, Not Hispanic or Latino ",2469,1653,816,124,152,180
2012,Charlottesville city,51540,"White, Not Hispanic or Latino ",12649,5779,6870,348,297,439
2012,Chesapeake city,51550,"White, Not Hispanic or Latino ",50051,40092,9959,596,739,543
2012,Colonial Heights city,51570,"White, Not Hispanic or Latino ",5946,4388,1558,195,219,247
2012,Covington city,51580,"White, Not Hispanic or Latino ",2102,1464,638,117,164,141
2012,Danville city,51590,"White, Not Hispanic or Latino ",9700,6431,3269,353,324,310
2012,Emporia city,51595,"White, Not Hispanic or Latino ",801,532,269,134,111,98
2012,Fairfax city,51600,"White, Not Hispanic or Latino ",5953,4581,1372,165,204,172
2012,Falls Church city,51610,"White, Not Hispanic or Latino ",3803,2601,1202,158,144,149
2012,Franklin city,51620,"White, Not Hispanic or Latino ",1445,1089,356,98,125,110
2012,Fredericksburg city,51630,"White, Not Hispanic or Latino ",6325,2750,3575,362,243,389
2012,Galax city,51640,"White, Not Hispanic or Latino ",2892,1909,983,252,206,224
2012,Hampton city,51650,"White, Not Hispanic or Latino ",23816,16817,6999,426,527,474
2012,Harrisonburg city,51660,"White, Not Hispanic or Latino ",11537,4665,6872,428,328,471
2012,Hopewell city,51670,"White, Not Hispanic or Latino ",5053,3248,1805,249,279,266
2012,Lexington city,51678,"White, Not Hispanic or Latino ",1495,863,632,760,335,454
2012,Lynchburg city,51680,"White, Not Hispanic or Latino ",18767,11694,7073,408,341,437
2012,Manassas city,51683,"White, Not Hispanic or Latino ",7092,5245,1847,216,280,227
2012,Manassas Park city,51685,"White, Not Hispanic or Latino ",2228,1459,769,163,168,203
2012,Martinsville city,51690,"White, Not Hispanic or Latino ",3265,2238,1027,159,162,162
2012,Newport News city,51700,"White, Not Hispanic or Latino ",34111,22214,11897,684,551,667
2012,Norfolk city,51710,"White, Not Hispanic or Latino ",42702,25045,17657,909,560,749
2012,Norton city,51720,"White, Not Hispanic or Latino ",1537,850,687,173,155,149
2012,Petersburg city,51730,"White, Not Hispanic or Latino ",2185,1479,706,146,121,119
2012,Poquoson city,51735,"White, Not Hispanic or Latino ",4376,3704,672,106,169,141
2012,Portsmouth city,51740,"White, Not Hispanic or Latino ",16087,12019,4068,503,394,367
2012,Radford city,51750,"White, Not Hispanic or Latino ",5091,2574,2517,295,171,291
2012,Richmond city,51760,"White, Not Hispanic or Latino ",38121,21141,16980,739,506,750
2012,Roanoke city,51770,"White, Not Hispanic or Latino ",28975,18256,10719,522,604,672
2012,Salem city,51775,"White, Not Hispanic or Latino ",8959,6387,2572,242,242,270
2012,Staunton city,51790,"White, Not Hispanic or Latino ",9344,5720,3624,250,260,330
2012,Suffolk city,51800,"White, Not Hispanic or Latino ",16572,13986,2586,298,336,293
2012,Virginia Beach city,51810,"White, Not Hispanic or Latino ",113946,79962,33984,913,1125,1025
2012,Waynesboro city,51820,"White, Not Hispanic or Latino ",7383,4738,2645,285,296,261
2012,Williamsburg city,51830,"White, Not Hispanic or Latino ",3208,1669,1539,285,153,308
2012,Winchester city,51840,"White, Not Hispanic or Latino ",8393,4485,3908,297,270,306
2013,Accomack County,51001,"White, Not Hispanic or Latino ",9353,7229,2124,303,313,332
2013,Albemarle County,51003,"White, Not Hispanic or Latino ",31234,22265,8969,567,536,534
2013,Alleghany County,51005,"White, Not Hispanic or Latino ",6377,5089,1288,170,201,197
2013,Amelia County,51007,"White, Not Hispanic or Latino ",3580,2868,712,193,234,219
2013,Amherst County,51009,"White, Not Hispanic or Latino ",9916,7597,2319,245,344,303
2013,Appomattox County,51011,"White, Not Hispanic or Latino ",4684,3845,839,215,214,203
2013,Arlington County,51013,"White, Not Hispanic or Latino ",66521,34369,32152,877,819,1031
2013,Augusta County,51015,"White, Not Hispanic or Latino ",26803,21951,4852,477,464,385
2013,Bath County,51017,"White, Not Hispanic or Latino ",1956,1519,437,195,227,176
2013,Bedford County,51019,"White, Not Hispanic or Latino ",24895,21560,3335,458,439,390
2013,Bland County,51021,"White, Not Hispanic or Latino ",2443,2028,415,181,181,116
2013,Botetourt County,51023,"White, Not Hispanic or Latino ",12232,10774,1458,282,324,308
2013,Brunswick County,51025,"White, Not Hispanic or Latino ",2692,2328,364,195,207,113
2013,Buchanan County,51027,"White, Not Hispanic or Latino ",9341,7392,1949,274,314,274
2013,Buckingham County,51029,"White, Not Hispanic or Latino ",3871,3057,814,276,247,160
2013,Campbell County,51031,"White, Not Hispanic or Latino ",18274,14321,3953,340,423,373
2013,Caroline County,51033,"White, Not Hispanic or Latino ",7048,5773,1275,226,332,234
2013,Carroll County,51035,"White, Not Hispanic or Latino ",12357,9738,2619,421,466,376
2013,Charles City County,51036,"White, Not Hispanic or Latino ",1304,1019,285,55,64,62
2013,Charlotte County,51037,"White, Not Hispanic or Latino ",3270,2567,703,204,200,137
2013,Chesterfield County,51041,"White, Not Hispanic or Latino ",79894,65802,14092,676,831,731
2013,Clarke County,51043,"White, Not Hispanic or Latino ",5062,4107,955,157,193,192
2013,Craig County,51045,"White, Not Hispanic or Latino ",2093,1762,331,185,197,117
2013,Culpeper County,51047,"White, Not Hispanic or Latino ",12746,9793,2953,323,345,399
2013,Cumberland County,51049,"White, Not Hispanic or Latino ",2558,2077,481,153,176,142
2013,Dickenson County,51051,"White, Not Hispanic or Latino ",6284,4910,1374,203,224,202
2013,Dinwiddie County,51053,"White, Not Hispanic or Latino ",6583,5290,1293,253,276,226
2013,Essex County,51057,"White, Not Hispanic or Latino ",2587,2103,484,133,114,117
2013,Fairfax County,51059,"White, Not Hispanic or Latino ",243130,185611,57519,1206,1576,1471
2013,Fauquier County,51061,"White, Not Hispanic or Latino ",19773,16216,3557,263,416,346
2013,Floyd County,51063,"White, Not Hispanic or Latino ",5742,4530,1212,383,351,282
2013,Fluvanna County,51065,"White, Not Hispanic or Latino ",7852,6785,1067,236,278,247
2013,Franklin County,51067,"White, Not Hispanic or Latino ",20983,16699,4284,430,437,489
2013,Frederick County,51069,"White, Not Hispanic or Latino ",26094,20742,5352,416,498,423
2013,Giles County,51071,"White, Not Hispanic or Latino ",7014,5342,1672,223,208,213
2013,Gloucester County,51073,"White, Not Hispanic or Latino ",12083,10205,1878,366,397,283
2013,Goochland County,51075,"White, Not Hispanic or Latino ",6633,6064,569,179,184,111
2013,Grayson County,51077,"White, Not Hispanic or Latino ",6345,4951,1394,244,246,214
2013,Greene County,51079,"White, Not Hispanic or Latino ",6154,4888,1266,484,387,278
2013,Greensville County,51081,"White, Not Hispanic or Latino ",1552,1260,292,306,264,120
2013,Halifax County,51083,"White, Not Hispanic or Latino ",9259,7177,2082,271,285,313
2013,Hanover County,51085,"White, Not Hispanic or Latino ",32176,27526,4650,391,465,399
2013,Henrico County,51087,"White, Not Hispanic or Latino ",75431,55862,19569,633,806,718
2013,Henry County,51089,"White, Not Hispanic or Latino ",17085,13462,3623,404,509,461
2013,Highland County,51091,"White, Not Hispanic or Latino ",1003,865,138,83,97,42
2013,Isle of Wight County,51093,"White, Not Hispanic or Latino ",9779,8383,1396,193,264,229
2013,James City County,51095,"White, Not Hispanic or Latino ",21874,17302,4572,449,415,450
2013,King and Queen County,51097,"White, Not Hispanic or Latino ",1958,1486,472,127,162,127
2013,King George County,51099,"White, Not Hispanic or Latino ",6361,4991,1370,199,240,220
2013,King William County,51101,"White, Not Hispanic or Latino ",4750,3974,776,147,194,186
2013,Lancaster County,51103,"White, Not Hispanic or Latino ",3838,3264,574,187,183,131
2013,Lee County,51105,"White, Not Hispanic or Latino ",9544,7075,2469,314,318,255
2013,Loudoun County,51107,"White, Not Hispanic or Latino ",72879,59189,13690,628,795,698
2013,Louisa County,51109,"White, Not Hispanic or Latino ",10427,8434,1993,314,388,344
2013,Lunenburg County,51111,"White, Not Hispanic or Latino ",3044,2528,516,156,162,98
2013,Madison County,51113,"White, Not Hispanic or Latino ",4367,3534,833,207,201,152
2013,Mathews County,51115,"White, Not Hispanic or Latino ",3434,2794,640,215,174,182
2013,Mecklenburg County,51117,"White, Not Hispanic or Latino ",8234,6721,1513,286,296,251
2013,Middlesex County,51119,"White, Not Hispanic or Latino ",3596,3036,560,189,177,133
2013,Montgomery County,51121,"White, Not Hispanic or Latino ",30327,17743,12584,528,468,639
2013,Nelson County,51125,"White, Not Hispanic or Latino ",5368,4191,1177,292,261,277
2013,New Kent County,51127,"White, Not Hispanic or Latino ",5768,5126,642,174,205,159
2013,Northampton County,51131,"White, Not Hispanic or Latino ",3017,2356,661,158,141,147
2013,Northumberland County,51133,"White, Not Hispanic or Latino ",4453,3898,555,275,230,200
2013,Nottoway County,51135,"White, Not Hispanic or Latino ",3619,2637,982,191,192,183
2013,Orange County,51137,"White, Not Hispanic or Latino ",10685,8424,2261,307,335,314
2013,Page County,51139,"White, Not Hispanic or Latino ",9269,6719,2550,270,252,296
2013,Patrick County,51141,"White, Not Hispanic or Latino ",7221,5643,1578,305,320,266
2013,Pittsylvania County,51143,"White, Not Hispanic or Latino ",20322,16707,3615,361,370,387
2013,Powhatan County,51145,"White, Not Hispanic or Latino ",8537,7653,884,208,249,162
2013,Prince Edward County,51147,"White, Not Hispanic or Latino ",4626,3335,1291,207,230,273
2013,Prince George County,51149,"White, Not Hispanic or Latino ",7168,5779,1389,261,294,231
2013,Prince William County,51153,"White, Not Hispanic or Latino ",73070,58879,14191,747,919,812
2013,Pulaski County,51155,"White, Not Hispanic or Latino ",13871,10324,3547,323,405,371
2013,Rappahannock County,51157,"White, Not Hispanic or Latino ",2991,2370,621,138,144,154
2013,Richmond County,51159,"White, Not Hispanic or Latino ",2086,1573,513,162,149,123
2013,Roanoke County,51161,"White, Not Hispanic or Latino ",34354,27165,7189,498,466,545
2013,Rockbridge County,51163,"White, Not Hispanic or Latino ",8694,6410,2284,291,320,333
2013,Rockingham County,51165,"White, Not Hispanic or Latino ",27852,21604,6248,429,507,458
2013,Russell County,51167,"White, Not Hispanic or Latino ",10996,8645,2351,299,383,300
2013,Scott County,51169,"White, Not Hispanic or Latino ",9472,7285,2187,265,299,306
2013,Shenandoah County,51171,"White, Not Hispanic or Latino ",16298,11790,4508,377,445,365
2013,Smyth County,51173,"White, Not Hispanic or Latino ",12249,8823,3426,372,307,361
2013,Southampton County,51175,"White, Not Hispanic or Latino ",4202,3341,861,149,187,162
2013,Spotsylvania County,51177,"White, Not Hispanic or Latino ",31454,25476,5978,501,584,512
2013,Stafford County,51179,"White, Not Hispanic or Latino ",30466,24757,5709,434,557,505
2013,Surry County,51181,"White, Not Hispanic or Latino ",1425,1191,234,101,114,75
2013,Sussex County,51183,"White, Not Hispanic or Latino ",1682,1322,360,136,104,91
2013,Tazewell County,51185,"White, Not Hispanic or Latino ",17412,12873,4539,294,380,413
2013,Warren County,51187,"White, Not Hispanic or Latino ",13121,9724,3397,291,370,386
2013,Washington County,51191,"White, Not Hispanic or Latino ",22060,16878,5182,369,465,487
2013,Westmoreland County,51193,"White, Not Hispanic or Latino ",5029,3971,1058,244,234,213
2013,Wise County,51195,"White, Not Hispanic or Latino ",15003,10650,4353,393,456,369
2013,Wythe County,51197,"White, Not Hispanic or Latino ",11264,8403,2861,401,408,407
2013,York County,51199,"White, Not Hispanic or Latino ",18383,14608,3775,382,405,339
2013,Alexandria city,51510,"White, Not Hispanic or Latino ",40019,22447,17572,570,625,743
2013,Bedford County,51019,"White, Not Hispanic or Latino ",2148,1415,733,259,171,250
2013,Bristol city,51520,"White, Not Hispanic or Latino ",7168,4413,2755,254,249,296
2013,Buena Vista city,51530,"White, Not Hispanic or Latino ",2456,1632,824,130,181,179
2013,Charlottesville city,51540,"White, Not Hispanic or Latino ",12657,5787,6870,308,349,391
2013,Chesapeake city,51550,"White, Not Hispanic or Latino ",49892,39505,10387,627,667,581
2013,Colonial Heights city,51570,"White, Not Hispanic or Latino ",5828,4164,1664,165,173,204
2013,Covington city,51580,"White, Not Hispanic or Latino ",2030,1504,526,153,143,139
2013,Danville city,51590,"White, Not Hispanic or Latino ",9313,6181,3132,311,309,284
2013,Emporia city,51595,"White, Not Hispanic or Latino ",853,591,262,142,119,93
2013,Fairfax city,51600,"White, Not Hispanic or Latino ",5996,4607,1389,146,201,166
2013,Falls Church city,51610,"White, Not Hispanic or Latino ",3807,2564,1243,145,160,173
2013,Franklin city,51620,"White, Not Hispanic or Latino ",1489,1014,475,125,138,143
2013,Fredericksburg city,51630,"White, Not Hispanic or Latino ",6484,2759,3725,305,219,298
2013,Galax city,51640,"White, Not Hispanic or Latino ",2646,1752,894,262,180,200
2013,Hampton city,51650,"White, Not Hispanic or Latino ",23701,16587,7114,550,459,563
2013,Harrisonburg city,51660,"White, Not Hispanic or Latino ",11719,4634,7085,500,302,440
2013,Hopewell city,51670,"White, Not Hispanic or Latino ",4871,3197,1674,204,257,259
2013,Lexington city,51678,"White, Not Hispanic or Latino ",1332,778,554,696,356,375
2013,Lynchburg city,51680,"White, Not Hispanic or Latino ",18891,11403,7488,409,397,470
2013,Manassas city,51683,"White, Not Hispanic or Latino ",6891,5170,1721,280,307,274
2013,Manassas Park city,51685,"White, Not Hispanic or Latino ",2252,1522,730,151,164,168
2013,Martinsville city,51690,"White, Not Hispanic or Latino ",3249,2137,1112,177,150,160
2013,Newport News city,51700,"White, Not Hispanic or Latino ",33984,22545,11439,667,606,676
2013,Norfolk city,51710,"White, Not Hispanic or Latino ",42371,24192,18179,699,612,617
2013,Norton city,51720,"White, Not Hispanic or Latino ",1563,875,688,180,143,164
2013,Petersburg city,51730,"White, Not Hispanic or Latino ",2208,1439,769,153,151,144
2013,Poquoson city,51735,"White, Not Hispanic or Latino ",4398,3588,810,95,186,160
2013,Portsmouth city,51740,"White, Not Hispanic or Latino ",16102,11653,4449,383,373,411
2013,Radford city,51750,"White, Not Hispanic or Latino ",4998,2415,2583,251,170,263
2013,Richmond city,51760,"White, Not Hispanic or Latino ",38553,20799,17754,657,560,621
2013,Roanoke city,51770,"White, Not Hispanic or Latino ",28807,17812,10995,429,565,607
2013,Salem city,51775,"White, Not Hispanic or Latino ",8868,6252,2616,253,250,284
2013,Staunton city,51790,"White, Not Hispanic or Latino ",9204,5478,3726,250,301,342
2013,Suffolk city,51800,"White, Not Hispanic or Latino ",16521,13714,2807,316,358,304
2013,Virginia Beach city,51810,"White, Not Hispanic or Latino ",114728,79744,34984,814,928,1053
2013,Waynesboro city,51820,"White, Not Hispanic or Latino ",7277,4555,2722,253,249,272
2013,Williamsburg city,51830,"White, Not Hispanic or Latino ",3325,1758,1567,232,143,224
2013,Winchester city,51840,"White, Not Hispanic or Latino ",8236,4364,3872,288,300,315
2014,Accomack County,51001,"White, Not Hispanic or Latino ",9248,7179,2069,334,297,318
2014,Albemarle County,51003,"White, Not Hispanic or Latino ",31684,22313,9371,538,588,589
2014,Alleghany County,51005,"White, Not Hispanic or Latino ",6361,5090,1271,193,215,180
2014,Amelia County,51007,"White, Not Hispanic or Latino ",3524,2953,571,202,248,187
2014,Amherst County,51009,"White, Not Hispanic or Latino ",9727,7465,2262,234,257,284
2014,Appomattox County,51011,"White, Not Hispanic or Latino ",4760,3899,861,188,211,154
2014,Arlington County,51013,"White, Not Hispanic or Latino ",66953,34483,32470,872,731,1008
2014,Augusta County,51015,"White, Not Hispanic or Latino ",26823,22149,4674,461,488,435
2014,Bath County,51017,"White, Not Hispanic or Latino ",2087,1589,498,162,187,159
2014,Bedford County,51019,"White, Not Hispanic or Latino ",27190,22955,4235,475,460,447
2014,Bland County,51021,"White, Not Hispanic or Latino ",2574,2070,504,167,162,130
2014,Botetourt County,51023,"White, Not Hispanic or Latino ",12285,10866,1419,209,275,229
2014,Brunswick County,51025,"White, Not Hispanic or Latino ",2809,2371,438,138,148,120
2014,Buchanan County,51027,"White, Not Hispanic or Latino ",9268,7501,1767,275,275,281
2014,Buckingham County,51029,"White, Not Hispanic or Latino ",3898,3051,847,239,221,164
2014,Campbell County,51031,"White, Not Hispanic or Latino ",18279,14468,3811,339,403,369
2014,Caroline County,51033,"White, Not Hispanic or Latino ",7172,5941,1231,271,306,202
2014,Carroll County,51035,"White, Not Hispanic or Latino ",12277,9668,2609,366,366,365
2014,Charles City County,51036,"White, Not Hispanic or Latino ",1295,1034,261,59,69,65
2014,Charlotte County,51037,"White, Not Hispanic or Latino ",3143,2533,610,189,185,135
2014,Chesterfield County,51041,"White, Not Hispanic or Latino ",80092,65544,14548,730,774,608
2014,Clarke County,51043,"White, Not Hispanic or Latino ",5119,4002,1117,173,242,233
2014,Craig County,51045,"White, Not Hispanic or Latino ",2114,1696,418,166,193,130
2014,Culpeper County,51047,"White, Not Hispanic or Latino ",12862,9981,2881,303,354,328
2014,Cumberland County,51049,"White, Not Hispanic or Latino ",2533,1964,569,148,153,126
2014,Dickenson County,51051,"White, Not Hispanic or Latino ",6150,4794,1356,240,219,190
2014,Dinwiddie County,51053,"White, Not Hispanic or Latino ",6580,5140,1440,263,282,247
2014,Essex County,51057,"White, Not Hispanic or Latino ",2620,2065,555,132,117,122
2014,Fairfax County,51059,"White, Not Hispanic or Latino ",241278,183609,57669,1207,1424,1283
2014,Fauquier County,51061,"White, Not Hispanic or Latino ",19719,15922,3797,437,362,413
2014,Floyd County,51063,"White, Not Hispanic or Latino ",5750,4567,1183,275,274,206
2014,Fluvanna County,51065,"White, Not Hispanic or Latino ",8184,6871,1313,257,306,231
2014,Franklin County,51067,"White, Not Hispanic or Latino ",20845,16643,4202,481,483,496
2014,Frederick County,51069,"White, Not Hispanic or Latino ",26108,20721,5387,405,519,462
2014,Giles County,51071,"White, Not Hispanic or Latino ",7076,5333,1743,231,225,214
2014,Gloucester County,51073,"White, Not Hispanic or Latino ",12254,10015,2239,371,435,339
2014,Goochland County,51075,"White, Not Hispanic or Latino ",6656,6014,642,173,223,153
2014,Grayson County,51077,"White, Not Hispanic or Latino ",6338,4892,1446,274,267,208
2014,Greene County,51079,"White, Not Hispanic or Latino ",6228,4883,1345,232,262,232
2014,Greensville County,51081,"White, Not Hispanic or Latino ",1483,1206,277,309,242,126
2014,Halifax County,51083,"White, Not Hispanic or Latino ",9120,7168,1952,250,291,279
2014,Hanover County,51085,"White, Not Hispanic or Latino ",32273,27138,5135,367,477,493
2014,Henrico County,51087,"White, Not Hispanic or Latino ",74243,54194,20049,877,971,835
2014,Henry County,51089,"White, Not Hispanic or Latino ",16937,13203,3734,369,419,359
2014,Highland County,51091,"White, Not Hispanic or Latino ",1063,907,156,93,101,63
2014,Isle of Wight County,51093,"White, Not Hispanic or Latino ",9822,8293,1529,234,249,224
2014,James City County,51095,"White, Not Hispanic or Latino ",22458,17515,4943,488,460,457
2014,King and Queen County,51097,"White, Not Hispanic or Latino ",1950,1545,405,126,151,118
2014,King George County,51099,"White, Not Hispanic or Latino ",6406,4960,1446,237,234,216
2014,King William County,51101,"White, Not Hispanic or Latino ",4901,4075,826,175,213,169
2014,Lancaster County,51103,"White, Not Hispanic or Latino ",3871,3192,679,194,201,134
2014,Lee County,51105,"White, Not Hispanic or Latino ",9320,6734,2586,310,333,309
2014,Loudoun County,51107,"White, Not Hispanic or Latino ",74038,59648,14390,673,776,713
2014,Louisa County,51109,"White, Not Hispanic or Latino ",10217,8332,1885,294,333,286
2014,Lunenburg County,51111,"White, Not Hispanic or Latino ",3099,2467,632,173,156,116
2014,Madison County,51113,"White, Not Hispanic or Latino ",4545,3598,947,169,198,203
2014,Mathews County,51115,"White, Not Hispanic or Latino ",3369,2815,554,239,201,196
2014,Mecklenburg County,51117,"White, Not Hispanic or Latino ",8175,6611,1564,259,293,223
2014,Middlesex County,51119,"White, Not Hispanic or Latino ",3645,3118,527,173,170,129
2014,Montgomery County,51121,"White, Not Hispanic or Latino ",30446,17747,12699,790,521,697
2014,Nelson County,51125,"White, Not Hispanic or Latino ",5408,4168,1240,252,254,194
2014,New Kent County,51127,"White, Not Hispanic or Latino ",6015,5227,788,190,280,218
2014,Northampton County,51131,"White, Not Hispanic or Latino ",3075,2371,704,154,167,134
2014,Northumberland County,51133,"White, Not Hispanic or Latino ",4312,3721,591,204,201,195
2014,Nottoway County,51135,"White, Not Hispanic or Latino ",3435,2527,908,180,200,169
2014,Orange County,51137,"White, Not Hispanic or Latino ",10455,8471,1984,342,384,290
2014,Page County,51139,"White, Not Hispanic or Latino ",9164,6596,2568,300,378,340
2014,Patrick County,51141,"White, Not Hispanic or Latino ",7157,5517,1640,318,277,232
2014,Pittsylvania County,51143,"White, Not Hispanic or Latino ",20119,16274,3845,419,370,390
2014,Powhatan County,51145,"White, Not Hispanic or Latino ",8662,7699,963,218,252,202
2014,Prince Edward County,51147,"White, Not Hispanic or Latino ",4873,3507,1366,228,202,291
2014,Prince George County,51149,"White, Not Hispanic or Latino ",7114,5549,1565,292,265,226
2014,Prince William County,51153,"White, Not Hispanic or Latino ",73403,59260,14143,708,881,666
2014,Pulaski County,51155,"White, Not Hispanic or Latino ",14284,10518,3766,326,416,340
2014,Rappahannock County,51157,"White, Not Hispanic or Latino ",3008,2432,576,148,154,126
2014,Richmond County,51159,"White, Not Hispanic or Latino ",2048,1580,468,145,167,115
2014,Roanoke County,51161,"White, Not Hispanic or Latino ",34544,26836,7708,464,576,526
2014,Rockbridge County,51163,"White, Not Hispanic or Latino ",8704,6592,2112,312,328,331
2014,Rockingham County,51165,"White, Not Hispanic or Latino ",27813,21539,6274,469,512,403
2014,Russell County,51167,"White, Not Hispanic or Latino ",10853,8518,2335,350,383,346
2014,Scott County,51169,"White, Not Hispanic or Latino ",9145,7185,1960,271,258,233
2014,Shenandoah County,51171,"White, Not Hispanic or Latino ",16088,11940,4148,293,395,432
2014,Smyth County,51173,"White, Not Hispanic or Latino ",12460,8809,3651,280,321,274
2014,Southampton County,51175,"White, Not Hispanic or Latino ",4114,3300,814,162,166,155
2014,Spotsylvania County,51177,"White, Not Hispanic or Latino ",31815,25560,6255,466,654,495
2014,Stafford County,51179,"White, Not Hispanic or Latino ",30691,24916,5775,455,492,448
2014,Surry County,51181,"White, Not Hispanic or Latino ",1455,1213,242,90,119,85
2014,Sussex County,51183,"White, Not Hispanic or Latino ",1692,1169,523,159,133,125
2014,Tazewell County,51185,"White, Not Hispanic or Latino ",17512,12960,4552,365,372,392
2014,Warren County,51187,"White, Not Hispanic or Latino ",13003,9929,3074,288,410,359
2014,Washington County,51191,"White, Not Hispanic or Latino ",22213,17260,4953,361,461,394
2014,Westmoreland County,51193,"White, Not Hispanic or Latino ",4996,3930,1066,226,261,232
2014,Wise County,51195,"White, Not Hispanic or Latino ",15161,10526,4635,342,398,342
2014,Wythe County,51197,"White, Not Hispanic or Latino ",11606,8319,3287,345,382,431
2014,York County,51199,"White, Not Hispanic or Latino ",18420,14427,3993,353,367,349
2014,Alexandria city,51510,"White, Not Hispanic or Latino ",40033,22146,17887,559,622,635
2014,Bristol city,51520,"White, Not Hispanic or Latino ",7243,4174,3069,266,301,319
2014,Buena Vista city,51530,"White, Not Hispanic or Latino ",2500,1632,868,151,195,176
2014,Charlottesville city,51540,"White, Not Hispanic or Latino ",12736,6110,6626,321,327,391
2014,Chesapeake city,51550,"White, Not Hispanic or Latino ",50443,39966,10477,563,600,552
2014,Colonial Heights city,51570,"White, Not Hispanic or Latino ",5867,4221,1646,172,184,185
2014,Covington city,51580,"White, Not Hispanic or Latino ",2018,1601,417,115,125,96
2014,Danville city,51590,"White, Not Hispanic or Latino ",9208,6294,2914,271,277,274
2014,Emporia city,51595,"White, Not Hispanic or Latino ",779,516,263,121,95,84
2014,Fairfax city,51600,"White, Not Hispanic or Latino ",5959,4672,1287,191,214,181
2014,Falls Church city,51610,"White, Not Hispanic or Latino ",3739,2546,1193,188,176,173
2014,Franklin city,51620,"White, Not Hispanic or Latino ",1396,906,490,134,157,181
2014,Fredericksburg city,51630,"White, Not Hispanic or Latino ",6614,2757,3857,289,230,268
2014,Galax city,51640,"White, Not Hispanic or Latino ",2515,1517,998,183,148,175
2014,Hampton city,51650,"White, Not Hispanic or Latino ",23631,16391,7240,459,443,439
2014,Harrisonburg city,51660,"White, Not Hispanic or Latino ",11731,4801,6930,350,323,400
2014,Hopewell city,51670,"White, Not Hispanic or Latino ",4914,3285,1629,225,219,244
2014,Lexington city,51678,"White, Not Hispanic or Latino ",1521,824,697,771,379,434
2014,Lynchburg city,51680,"White, Not Hispanic or Latino ",18649,11257,7392,431,412,488
2014,Manassas city,51683,"White, Not Hispanic or Latino ",6865,5101,1764,251,278,246
2014,Manassas Park city,51685,"White, Not Hispanic or Latino ",2290,1586,704,154,212,198
2014,Martinsville city,51690,"White, Not Hispanic or Latino ",3272,2179,1093,160,182,173
2014,Newport News city,51700,"White, Not Hispanic or Latino ",33715,21903,11812,636,561,661
2014,Norfolk city,51710,"White, Not Hispanic or Latino ",42224,23762,18462,796,671,738
2014,Norton city,51720,"White, Not Hispanic or Latino ",1509,841,668,143,188,163
2014,Petersburg city,51730,"White, Not Hispanic or Latino ",2231,1404,827,178,180,133
2014,Poquoson city,51735,"White, Not Hispanic or Latino ",4397,3548,849,98,183,167
2014,Portsmouth city,51740,"White, Not Hispanic or Latino ",15992,11263,4729,424,396,405
2014,Radford city,51750,"White, Not Hispanic or Latino ",4762,2373,2389,289,211,300
2014,Richmond city,51760,"White, Not Hispanic or Latino ",39453,21070,18383,915,545,874
2014,Roanoke city,51770,"White, Not Hispanic or Latino ",29105,17687,11418,542,581,569
2014,Salem city,51775,"White, Not Hispanic or Latino ",8900,6263,2637,234,265,244
2014,Staunton city,51790,"White, Not Hispanic or Latino ",9198,5539,3659,236,277,303
2014,Suffolk city,51800,"White, Not Hispanic or Latino ",16668,13569,3099,337,387,304
2014,Virginia Beach city,51810,"White, Not Hispanic or Latino ",114325,79861,34464,933,1009,822
2014,Waynesboro city,51820,"White, Not Hispanic or Latino ",7518,4598,2920,267,344,326
2014,Williamsburg city,51830,"White, Not Hispanic or Latino ",3158,1734,1424,227,144,238
2014,Winchester city,51840,"White, Not Hispanic or Latino ",8321,4392,3929,268,279,314
2015,Accomack County,51001,"White, Not Hispanic or Latino ",9240,7117,2123,303,326,300
2015,Albemarle County,51003,"White, Not Hispanic or Latino ",32193,22521,9672,602,614,626
2015,Alleghany County,51005,"White, Not Hispanic or Latino ",6426,5121,1305,188,208,167
2015,Amelia County,51007,"White, Not Hispanic or Latino ",3381,2773,608,175,222,197
2015,Amherst County,51009,"White, Not Hispanic or Latino ",9715,7674,2041,259,268,267
2015,Appomattox County,51011,"White, Not Hispanic or Latino ",4794,3935,859,204,199,174
2015,Arlington County,51013,"White, Not Hispanic or Latino ",67504,34407,33097,935,733,991
2015,Augusta County,51015,"White, Not Hispanic or Latino ",26807,21647,5160,459,569,445
2015,Bath County,51017,"White, Not Hispanic or Latino ",2032,1404,628,177,182,173
2015,Bedford County,51019,"White, Not Hispanic or Latino ",27725,23091,4634,433,465,458
2015,Bland County,51021,"White, Not Hispanic or Latino ",2580,2055,525,227,206,127
2015,Botetourt County,51023,"White, Not Hispanic or Latino ",12337,10880,1457,233,270,208
2015,Brunswick County,51025,"White, Not Hispanic or Latino ",2806,2349,457,136,157,141
2015,Buchanan County,51027,"White, Not Hispanic or Latino ",9223,7376,1847,229,252,242
2015,Buckingham County,51029,"White, Not Hispanic or Latino ",3919,3031,888,192,197,184
2015,Campbell County,51031,"White, Not Hispanic or Latino ",18197,14310,3887,434,402,417
2015,Caroline County,51033,"White, Not Hispanic or Latino ",7276,6042,1234,219,278,230
2015,Carroll County,51035,"White, Not Hispanic or Latino ",12311,9736,2575,427,407,346
2015,Charles City County,51036,"White, Not Hispanic or Latino ",1299,1045,254,51,56,58
2015,Charlotte County,51037,"White, Not Hispanic or Latino ",3170,2401,769,177,173,157
2015,Chesterfield County,51041,"White, Not Hispanic or Latino ",80742,66122,14620,713,793,755
2015,Clarke County,51043,"White, Not Hispanic or Latino ",4947,3908,1039,176,197,195
2015,Craig County,51045,"White, Not Hispanic or Latino ",2184,1764,420,182,207,122
2015,Culpeper County,51047,"White, Not Hispanic or Latino ",12892,9983,2909,308,362,376
2015,Cumberland County,51049,"White, Not Hispanic or Latino ",2652,1957,695,182,184,159
2015,Dickenson County,51051,"White, Not Hispanic or Latino ",6157,4766,1391,202,228,198
2015,Dinwiddie County,51053,"White, Not Hispanic or Latino ",6560,5071,1489,226,278,220
2015,Essex County,51057,"White, Not Hispanic or Latino ",2564,2042,522,153,131,135
2015,Fairfax County,51059,"White, Not Hispanic or Latino ",239616,181042,58574,1223,1380,1350
2015,Fauquier County,51061,"White, Not Hispanic or Latino ",20180,16186,3994,405,440,359
2015,Floyd County,51063,"White, Not Hispanic or Latino ",5909,4623,1286,264,309,269
2015,Fluvanna County,51065,"White, Not Hispanic or Latino ",8260,6854,1406,241,304,264
2015,Franklin County,51067,"White, Not Hispanic or Latino ",20724,16736,3988,446,509,460
2015,Frederick County,51069,"White, Not Hispanic or Latino ",26247,20862,5385,432,534,472
2015,Giles County,51071,"White, Not Hispanic or Latino ",7030,5374,1656,210,236,238
2015,Gloucester County,51073,"White, Not Hispanic or Latino ",12498,10077,2421,331,382,318
2015,Goochland County,51075,"White, Not Hispanic or Latino ",6598,5898,700,151,216,152
2015,Grayson County,51077,"White, Not Hispanic or Latino ",6368,4888,1480,282,240,220
2015,Greene County,51079,"White, Not Hispanic or Latino ",6268,4954,1314,222,298,244
2015,Greensville County,51081,"White, Not Hispanic or Latino ",1503,1194,309,292,225,127
2015,Halifax County,51083,"White, Not Hispanic or Latino ",8960,6947,2013,260,285,230
2015,Hanover County,51085,"White, Not Hispanic or Latino ",32645,26936,5709,349,519,435
2015,Henrico County,51087,"White, Not Hispanic or Latino ",74215,53432,20783,844,932,865
2015,Henry County,51089,"White, Not Hispanic or Latino ",16752,13122,3630,322,418,396
2015,Highland County,51091,"White, Not Hispanic or Latino ",1068,880,188,88,100,60
2015,Isle of Wight County,51093,"White, Not Hispanic or Latino ",9986,8254,1732,211,242,221
2015,James City County,51095,"White, Not Hispanic or Latino ",22801,17988,4813,470,522,532
2015,King and Queen County,51097,"White, Not Hispanic or Latino ",2083,1649,434,121,145,101
2015,King George County,51099,"White, Not Hispanic or Latino ",6488,4959,1529,202,186,179
2015,King William County,51101,"White, Not Hispanic or Latino ",4735,3915,820,189,221,170
2015,Lancaster County,51103,"White, Not Hispanic or Latino ",3835,3073,762,197,176,140
2015,Lee County,51105,"White, Not Hispanic or Latino ",9169,6674,2495,280,285,229
2015,Loudoun County,51107,"White, Not Hispanic or Latino ",75200,60573,14627,670,818,759
2015,Louisa County,51109,"White, Not Hispanic or Latino ",10304,8294,2010,350,365,313
2015,Lunenburg County,51111,"White, Not Hispanic or Latino ",2955,2379,576,241,200,110
2015,Madison County,51113,"White, Not Hispanic or Latino ",4552,3352,1200,209,240,222
2015,Mathews County,51115,"White, Not Hispanic or Latino ",3358,2846,512,234,214,189
2015,Mecklenburg County,51117,"White, Not Hispanic or Latino ",8121,6551,1570,266,278,217
2015,Middlesex County,51119,"White, Not Hispanic or Latino ",3568,3031,537,201,180,122
2015,Montgomery County,51121,"White, Not Hispanic or Latino ",30903,18021,12882,681,524,796
2015,Nelson County,51125,"White, Not Hispanic or Latino ",5449,4061,1388,262,245,230
2015,New Kent County,51127,"White, Not Hispanic or Latino ",6207,5238,969,183,232,251
2015,Northampton County,51131,"White, Not Hispanic or Latino ",3024,2307,717,159,156,113
2015,Northumberland County,51133,"White, Not Hispanic or Latino ",4379,3757,622,230,192,221
2015,Nottoway County,51135,"White, Not Hispanic or Latino ",3406,2555,851,178,196,190
2015,Orange County,51137,"White, Not Hispanic or Latino ",10688,8602,2086,306,325,338
2015,Page County,51139,"White, Not Hispanic or Latino ",9052,6476,2576,281,313,272
2015,Patrick County,51141,"White, Not Hispanic or Latino ",7200,5646,1554,297,341,277
2015,Pittsylvania County,51143,"White, Not Hispanic or Latino ",20267,16070,4197,382,393,432
2015,Powhatan County,51145,"White, Not Hispanic or Latino ",8764,7712,1052,176,271,215
2015,Prince Edward County,51147,"White, Not Hispanic or Latino ",4744,3298,1446,224,186,259
2015,Prince George County,51149,"White, Not Hispanic or Latino ",7055,5595,1460,236,272,229
2015,Prince William County,51153,"White, Not Hispanic or Latino ",73282,58935,14347,740,705,647
2015,Pulaski County,51155,"White, Not Hispanic or Latino ",13845,9912,3933,372,348,372
2015,Rappahannock County,51157,"White, Not Hispanic or Latino ",2956,2353,603,126,130,145
2015,Richmond County,51159,"White, Not Hispanic or Latino ",2003,1537,466,141,139,128
2015,Roanoke County,51161,"White, Not Hispanic or Latino ",34468,26482,7986,405,543,648
2015,Rockbridge County,51163,"White, Not Hispanic or Latino ",8792,6586,2206,279,316,288
2015,Rockingham County,51165,"White, Not Hispanic or Latino ",27893,21379,6514,334,438,383
2015,Russell County,51167,"White, Not Hispanic or Latino ",10814,8516,2298,267,356,292
2015,Scott County,51169,"White, Not Hispanic or Latino ",9149,7101,2048,286,337,241
2015,Shenandoah County,51171,"White, Not Hispanic or Latino ",15794,11921,3873,337,429,403
2015,Smyth County,51173,"White, Not Hispanic or Latino ",12316,8763,3553,298,304,290
2015,Southampton County,51175,"White, Not Hispanic or Latino ",4069,3190,879,168,180,156
2015,Spotsylvania County,51177,"White, Not Hispanic or Latino ",32271,25964,6307,457,634,428
2015,Stafford County,51179,"White, Not Hispanic or Latino ",30730,25238,5492,491,485,486
2015,Surry County,51181,"White, Not Hispanic or Latino ",1474,1266,208,80,94,70
2015,Sussex County,51183,"White, Not Hispanic or Latino ",1650,1134,516,178,138,102
2015,Tazewell County,51185,"White, Not Hispanic or Latino ",17138,12982,4156,355,421,472
2015,Warren County,51187,"White, Not Hispanic or Latino ",12949,10224,2725,342,360,290
2015,Washington County,51191,"White, Not Hispanic or Latino ",22015,16911,5104,404,431,414
2015,Westmoreland County,51193,"White, Not Hispanic or Latino ",4940,3758,1182,278,258,221
2015,Wise County,51195,"White, Not Hispanic or Latino ",14896,10408,4488,295,392,363
2015,Wythe County,51197,"White, Not Hispanic or Latino ",11462,8106,3356,353,395,394
2015,York County,51199,"White, Not Hispanic or Latino ",18278,14260,4018,363,382,356
2015,Alexandria city,51510,"White, Not Hispanic or Latino ",40437,21997,18440,618,653,651
2015,Bristol city,51520,"White, Not Hispanic or Latino ",7190,4112,3078,243,284,296
2015,Buena Vista city,51530,"White, Not Hispanic or Latino ",2519,1545,974,116,210,231
2015,Charlottesville city,51540,"White, Not Hispanic or Latino ",12854,6387,6467,315,320,367
2015,Chesapeake city,51550,"White, Not Hispanic or Latino ",50992,40041,10951,632,750,714
2015,Colonial Heights city,51570,"White, Not Hispanic or Latino ",5838,4094,1744,179,259,257
2015,Covington city,51580,"White, Not Hispanic or Latino ",2073,1608,465,128,152,141
2015,Danville city,51590,"White, Not Hispanic or Latino ",9236,6278,2958,308,287,250
2015,Emporia city,51595,"White, Not Hispanic or Latino ",998,674,324,168,139,119
2015,Fairfax city,51600,"White, Not Hispanic or Latino ",5894,4602,1292,171,192,170
2015,Falls Church city,51610,"White, Not Hispanic or Latino ",3822,2626,1196,175,146,209
2015,Franklin city,51620,"White, Not Hispanic or Latino ",1426,958,468,113,141,152
2015,Fredericksburg city,51630,"White, Not Hispanic or Latino ",6692,2682,4010,260,246,312
2015,Galax city,51640,"White, Not Hispanic or Latino ",2564,1560,1004,189,187,201
2015,Hampton city,51650,"White, Not Hispanic or Latino ",23778,16213,7565,495,431,588
2015,Harrisonburg city,51660,"White, Not Hispanic or Latino ",12156,4964,7192,287,291,383
2015,Hopewell city,51670,"White, Not Hispanic or Latino ",4743,3083,1660,247,247,248
2015,Lexington city,51678,"White, Not Hispanic or Latino ",1245,705,540,889,424,489
2015,Lynchburg city,51680,"White, Not Hispanic or Latino ",18648,11126,7522,415,401,469
2015,Manassas city,51683,"White, Not Hispanic or Latino ",6799,5067,1732,256,268,231
2015,Manassas Park city,51685,"White, Not Hispanic or Latino ",2389,1693,696,143,193,191
2015,Martinsville city,51690,"White, Not Hispanic or Latino ",3249,2100,1149,164,168,159
2015,Newport News city,51700,"White, Not Hispanic or Latino ",33380,21753,11627,619,599,651
2015,Norfolk city,51710,"White, Not Hispanic or Latino ",41951,23628,18323,793,518,706
2015,Norton city,51720,"White, Not Hispanic or Latino ",1577,864,713,158,152,167
2015,Petersburg city,51730,"White, Not Hispanic or Latino ",2184,1314,870,153,156,143
2015,Poquoson city,51735,"White, Not Hispanic or Latino ",4469,3658,811,83,150,151
2015,Portsmouth city,51740,"White, Not Hispanic or Latino ",16161,10920,5241,369,384,441
2015,Radford city,51750,"White, Not Hispanic or Latino ",4915,2286,2629,263,223,281
2015,Richmond city,51760,"White, Not Hispanic or Latino ",40256,21314,18942,665,641,730
2015,Roanoke city,51770,"White, Not Hispanic or Latino ",28901,17190,11711,484,602,674
2015,Salem city,51775,"White, Not Hispanic or Latino ",8938,6215,2723,232,303,288
2015,Staunton city,51790,"White, Not Hispanic or Latino ",9083,5321,3762,256,277,336
2015,Suffolk city,51800,"White, Not Hispanic or Latino ",16488,13342,3146,312,353,303
2015,Virginia Beach city,51810,"White, Not Hispanic or Latino ",113687,78995,34692,1040,982,1072
2015,Waynesboro city,51820,"White, Not Hispanic or Latino ",7426,4636,2790,242,325,304
2015,Williamsburg city,51830,"White, Not Hispanic or Latino ",3434,1817,1617,186,160,210
2015,Winchester city,51840,"White, Not Hispanic or Latino ",8257,4124,4133,250,291,355
2016,Accomack County,51001,"White, Not Hispanic or Latino ",9109,6960,2149,378,351,335
2016,Albemarle County,51003,"White, Not Hispanic or Latino ",32784,22842,9942,590,598,564
2016,Alleghany County,51005,"White, Not Hispanic or Latino ",6447,5179,1268,200,208,164
2016,Amelia County,51007,"White, Not Hispanic or Latino ",3363,2834,529,213,228,184
2016,Amherst County,51009,"White, Not Hispanic or Latino ",9510,7662,1848,302,328,236
2016,Appomattox County,51011,"White, Not Hispanic or Latino ",4819,3915,904,171,221,193
2016,Arlington County,51013,"White, Not Hispanic or Latino ",68692,34906,33786,833,857,1032
2016,Augusta County,51015,"White, Not Hispanic or Latino ",27142,21934,5208,438,573,555
2016,Bath County,51017,"White, Not Hispanic or Latino ",2022,1405,617,194,209,189
2016,Bedford County,51019,"White, Not Hispanic or Latino ",27838,23201,4637,424,516,418
2016,Bland County,51021,"White, Not Hispanic or Latino ",2540,2091,449,192,190,120
2016,Botetourt County,51023,"White, Not Hispanic or Latino ",12719,10978,1741,254,304,246
2016,Brunswick County,51025,"White, Not Hispanic or Latino ",2910,2346,564,154,162,148
2016,Buchanan County,51027,"White, Not Hispanic or Latino ",8885,7103,1782,277,274,232
2016,Buckingham County,51029,"White, Not Hispanic or Latino ",3931,3046,885,182,203,187
2016,Campbell County,51031,"White, Not Hispanic or Latino ",18500,14513,3987,341,361,414
2016,Caroline County,51033,"White, Not Hispanic or Latino ",7382,5938,1444,276,346,251
2016,Carroll County,51035,"White, Not Hispanic or Latino ",12366,9680,2686,400,356,323
2016,Charles City County,51036,"White, Not Hispanic or Latino ",1280,1045,235,66,64,57
2016,Charlotte County,51037,"White, Not Hispanic or Latino ",3110,2243,867,190,209,146
2016,Chesterfield County,51041,"White, Not Hispanic or Latino ",81304,66470,14834,729,807,787
2016,Clarke County,51043,"White, Not Hispanic or Latino ",5008,3923,1085,198,226,208
2016,Craig County,51045,"White, Not Hispanic or Latino ",2297,1661,636,171,203,170
2016,Culpeper County,51047,"White, Not Hispanic or Latino ",13167,10149,3018,298,307,306
2016,Cumberland County,51049,"White, Not Hispanic or Latino ",2670,2090,580,120,167,144
2016,Dickenson County,51051,"White, Not Hispanic or Latino ",6017,4511,1506,228,269,220
2016,Dinwiddie County,51053,"White, Not Hispanic or Latino ",6763,5252,1511,270,311,259
2016,Essex County,51057,"White, Not Hispanic or Latino ",2651,2076,575,158,156,154
2016,Fairfax County,51059,"White, Not Hispanic or Latino ",237787,179374,58413,1329,1371,1330
2016,Fauquier County,51061,"White, Not Hispanic or Latino ",20366,16211,4155,342,449,381
2016,Floyd County,51063,"White, Not Hispanic or Latino ",5921,4605,1316,255,284,286
2016,Fluvanna County,51065,"White, Not Hispanic or Latino ",8243,6646,1597,262,366,272
2016,Franklin County,51067,"White, Not Hispanic or Latino ",20547,16993,3554,420,474,438
2016,Frederick County,51069,"White, Not Hispanic or Latino ",26623,21225,5398,467,568,476
2016,Giles County,51071,"White, Not Hispanic or Latino ",7089,5340,1749,227,243,235
2016,Gloucester County,51073,"White, Not Hispanic or Latino ",12651,9848,2803,309,368,355
2016,Goochland County,51075,"White, Not Hispanic or Latino ",6595,5787,808,210,236,162
2016,Grayson County,51077,"White, Not Hispanic or Latino ",6444,5165,1279,220,186,198
2016,Greene County,51079,"White, Not Hispanic or Latino ",6158,4977,1181,249,296,224
2016,Greensville County,51081,"White, Not Hispanic or Latino ",1607,1312,295,132,109,115
2016,Halifax County,51083,"White, Not Hispanic or Latino ",8944,6896,2048,274,270,278
2016,Hanover County,51085,"White, Not Hispanic or Latino ",32815,27165,5650,376,438,380
2016,Henrico County,51087,"White, Not Hispanic or Latino ",74437,53273,21164,809,1031,827
2016,Henry County,51089,"White, Not Hispanic or Latino ",16246,12714,3532,352,348,404
2016,Highland County,51091,"White, Not Hispanic or Latino ",1117,953,164,92,94,71
2016,Isle of Wight County,51093,"White, Not Hispanic or Latino ",10138,8251,1887,222,248,219
2016,James City County,51095,"White, Not Hispanic or Latino ",23340,18328,5012,520,504,417
2016,King and Queen County,51097,"White, Not Hispanic or Latino ",1970,1619,351,115,150,116
2016,King George County,51099,"White, Not Hispanic or Latino ",6673,5134,1539,191,216,209
2016,King William County,51101,"White, Not Hispanic or Latino ",4808,4091,717,160,197,161
2016,Lancaster County,51103,"White, Not Hispanic or Latino ",3777,3006,771,193,201,138
2016,Lee County,51105,"White, Not Hispanic or Latino ",9162,6561,2601,342,285,286
2016,Loudoun County,51107,"White, Not Hispanic or Latino ",76531,61547,14984,660,722,660
2016,Louisa County,51109,"White, Not Hispanic or Latino ",10535,8341,2194,321,352,277
2016,Lunenburg County,51111,"White, Not Hispanic or Latino ",2974,2317,657,139,144,127
2016,Madison County,51113,"White, Not Hispanic or Latino ",4602,3368,1234,189,215,242
2016,Mathews County,51115,"White, Not Hispanic or Latino ",3395,2910,485,186,207,168
2016,Mecklenburg County,51117,"White, Not Hispanic or Latino ",7819,6100,1719,253,274,273
2016,Middlesex County,51119,"White, Not Hispanic or Latino ",3663,3087,576,196,203,119
2016,Montgomery County,51121,"White, Not Hispanic or Latino ",31441,18018,13423,582,572,759
2016,Nelson County,51125,"White, Not Hispanic or Latino ",5444,4079,1365,246,246,239
2016,New Kent County,51127,"White, Not Hispanic or Latino ",6273,5213,1060,178,279,263
2016,Northampton County,51131,"White, Not Hispanic or Latino ",3030,2309,721,138,147,122
2016,Northumberland County,51133,"White, Not Hispanic or Latino ",4324,3843,481,203,213,178
2016,Nottoway County,51135,"White, Not Hispanic or Latino ",3485,2371,1114,185,214,202
2016,Orange County,51137,"White, Not Hispanic or Latino ",11073,9105,1968,313,384,323
2016,Page County,51139,"White, Not Hispanic or Latino ",9203,6564,2639,261,295,248
2016,Patrick County,51141,"White, Not Hispanic or Latino ",7279,5712,1567,280,320,239
2016,Pittsylvania County,51143,"White, Not Hispanic or Latino ",20173,15880,4293,367,432,380
2016,Powhatan County,51145,"White, Not Hispanic or Latino ",8860,7839,1021,209,305,255
2016,Prince Edward County,51147,"White, Not Hispanic or Latino ",4752,3309,1443,277,217,253
2016,Prince George County,51149,"White, Not Hispanic or Latino ",6896,5341,1555,260,261,221
2016,Prince William County,51153,"White, Not Hispanic or Latino ",72860,58295,14565,815,779,768
2016,Pulaski County,51155,"White, Not Hispanic or Latino ",13699,9873,3826,352,376,352
2016,Rappahannock County,51157,"White, Not Hispanic or Latino ",2944,2314,630,131,152,136
2016,Richmond County,51159,"White, Not Hispanic or Latino ",2180,1627,553,152,132,131
2016,Roanoke County,51161,"White, Not Hispanic or Latino ",34552,26604,7948,390,564,542
2016,Rockbridge County,51163,"White, Not Hispanic or Latino ",8824,6839,1985,264,323,290
2016,Rockingham County,51165,"White, Not Hispanic or Latino ",28057,21170,6887,365,466,507
2016,Russell County,51167,"White, Not Hispanic or Latino ",10722,8418,2304,359,334,333
2016,Scott County,51169,"White, Not Hispanic or Latino ",8914,6845,2069,267,270,190
2016,Shenandoah County,51171,"White, Not Hispanic or Latino ",15721,11534,4187,345,414,382
2016,Smyth County,51173,"White, Not Hispanic or Latino ",12446,8876,3570,279,313,317
2016,Southampton County,51175,"White, Not Hispanic or Latino ",4112,3243,869,140,187,176
2016,Spotsylvania County,51177,"White, Not Hispanic or Latino ",32539,26432,6107,385,482,432
2016,Stafford County,51179,"White, Not Hispanic or Latino ",30919,24811,6108,526,534,536
2016,Surry County,51181,"White, Not Hispanic or Latino ",1457,1256,201,78,84,65
2016,Sussex County,51183,"White, Not Hispanic or Latino ",1611,1157,454,156,138,91
2016,Tazewell County,51185,"White, Not Hispanic or Latino ",16924,12844,4080,381,563,461
2016,Warren County,51187,"White, Not Hispanic or Latino ",12823,9975,2848,288,366,324
2016,Washington County,51191,"White, Not Hispanic or Latino ",21835,16764,5071,341,400,357
2016,Westmoreland County,51193,"White, Not Hispanic or Latino ",5119,4064,1055,275,272,204
2016,Wise County,51195,"White, Not Hispanic or Latino ",14810,10260,4550,358,367,377
2016,Wythe County,51197,"White, Not Hispanic or Latino ",11568,8385,3183,338,340,330
2016,York County,51199,"White, Not Hispanic or Latino ",18098,13966,4132,391,376,399
2016,Alexandria city,51510,"White, Not Hispanic or Latino ",40715,22445,18270,513,579,647
2016,Bristol city,51520,"White, Not Hispanic or Latino ",7175,4276,2899,248,243,287
2016,Buena Vista city,51530,"White, Not Hispanic or Latino ",2484,1542,942,144,196,213
2016,Charlottesville city,51540,"White, Not Hispanic or Latino ",12948,6353,6595,326,316,361
2016,Chesapeake city,51550,"White, Not Hispanic or Latino ",51274,40258,11016,707,773,698
2016,Colonial Heights city,51570,"White, Not Hispanic or Latino ",5792,3963,1829,188,266,232
2016,Covington city,51580,"White, Not Hispanic or Latino ",2045,1591,454,122,118,126
2016,Danville city,51590,"White, Not Hispanic or Latino ",9189,6257,2932,247,270,258
2016,Emporia city,51595,"White, Not Hispanic or Latino ",830,527,303,117,91,100
2016,Fairfax city,51600,"White, Not Hispanic or Latino ",5824,4478,1346,179,185,163
2016,Falls Church city,51610,"White, Not Hispanic or Latino ",3862,2647,1215,144,134,146
2016,Franklin city,51620,"White, Not Hispanic or Latino ",1463,1054,409,112,120,151
2016,Fredericksburg city,51630,"White, Not Hispanic or Latino ",6874,2803,4071,312,224,355
2016,Galax city,51640,"White, Not Hispanic or Latino ",2364,1336,1028,211,174,184
2016,Hampton city,51650,"White, Not Hispanic or Latino ",23544,15706,7838,531,496,498
2016,Harrisonburg city,51660,"White, Not Hispanic or Latino ",12181,5122,7059,298,338,388
2016,Hopewell city,51670,"White, Not Hispanic or Latino ",4779,3014,1765,235,262,274
2016,Lexington city,51678,"White, Not Hispanic or Latino ",1488,817,671,223,176,153
2016,Lynchburg city,51680,"White, Not Hispanic or Latino ",18509,10979,7530,487,430,450
2016,Manassas city,51683,"White, Not Hispanic or Latino ",6592,4899,1693,219,212,193
2016,Manassas Park city,51685,"White, Not Hispanic or Latino ",2338,1597,741,157,166,166
2016,Martinsville city,51690,"White, Not Hispanic or Latino ",3154,2079,1075,126,135,126
2016,Newport News city,51700,"White, Not Hispanic or Latino ",33332,21503,11829,597,601,611
2016,Norfolk city,51710,"White, Not Hispanic or Latino ",42278,23785,18493,731,555,710
2016,Norton city,51720,"White, Not Hispanic or Latino ",1627,808,819,164,155,163
2016,Petersburg city,51730,"White, Not Hispanic or Latino ",2280,1257,1023,137,146,150
2016,Poquoson city,51735,"White, Not Hispanic or Latino ",4408,3673,735,111,181,163
2016,Portsmouth city,51740,"White, Not Hispanic or Latino ",16163,10853,5310,367,402,383
2016,Radford city,51750,"White, Not Hispanic or Latino ",4991,2309,2682,258,204,295
2016,Richmond city,51760,"White, Not Hispanic or Latino ",41133,21368,19765,643,563,782
2016,Roanoke city,51770,"White, Not Hispanic or Latino ",28575,16651,11924,471,570,638
2016,Salem city,51775,"White, Not Hispanic or Latino ",8835,6068,2767,232,269,288
2016,Staunton city,51790,"White, Not Hispanic or Latino ",9038,5397,3641,282,276,305
2016,Suffolk city,51800,"White, Not Hispanic or Latino ",16738,13406,3332,312,304,286
2016,Virginia Beach city,51810,"White, Not Hispanic or Latino ",114292,78895,35397,962,965,854
2016,Waynesboro city,51820,"White, Not Hispanic or Latino ",7398,4657,2741,279,333,306
2016,Williamsburg city,51830,"White, Not Hispanic or Latino ",3512,1876,1636,190,149,205
2016,Winchester city,51840,"White, Not Hispanic or Latino ",8124,4144,3980,280,335,337
2017,Accomack County,51001,"White, Not Hispanic or Latino ",9133,7057,2076,338,293,294
2017,Albemarle County,51003,"White, Not Hispanic or Latino ",32845,22568,10277,545,566,567
2017,Alleghany County,51005,"White, Not Hispanic or Latino ",6430,5024,1406,188,196,198
2017,Amelia County,51007,"White, Not Hispanic or Latino ",3429,2845,584,192,229,154
2017,Amherst County,51009,"White, Not Hispanic or Latino ",9292,7563,1729,339,297,293
2017,Appomattox County,51011,"White, Not Hispanic or Latino ",4840,3993,847,160,190,183
2017,Arlington County,51013,"White, Not Hispanic or Latino ",69058,35401,33657,850,798,940
2017,Augusta County,51015,"White, Not Hispanic or Latino ",27504,22025,5479,516,621,463
2017,Bath County,51017,"White, Not Hispanic or Latino ",1724,1313,411,215,184,152
2017,Bedford County,51019,"White, Not Hispanic or Latino ",27912,23190,4722,382,565,455
2017,Bland County,51021,"White, Not Hispanic or Latino ",2544,2103,441,245,212,122
2017,Botetourt County,51023,"White, Not Hispanic or Latino ",12638,10812,1826,238,334,239
2017,Brunswick County,51025,"White, Not Hispanic or Latino ",2873,2407,466,155,151,151
2017,Buchanan County,51027,"White, Not Hispanic or Latino ",8832,7071,1761,298,248,241
2017,Buckingham County,51029,"White, Not Hispanic or Latino ",3898,2974,924,177,159,165
2017,Campbell County,51031,"White, Not Hispanic or Latino ",18656,14535,4121,401,400,375
2017,Caroline County,51033,"White, Not Hispanic or Latino ",7301,6021,1280,284,304,226
2017,Carroll County,51035,"White, Not Hispanic or Latino ",12244,9569,2675,307,325,361
2017,Charles City County,51036,"White, Not Hispanic or Latino ",1309,1060,249,73,70,60
2017,Charlotte County,51037,"White, Not Hispanic or Latino ",3060,2319,741,178,180,125
2017,Chesterfield County,51041,"White, Not Hispanic or Latino ",81862,67095,14767,745,845,671
2017,Clarke County,51043,"White, Not Hispanic or Latino ",4947,3876,1071,207,216,189
2017,Craig County,51045,"White, Not Hispanic or Latino ",2335,1725,610,167,201,160
2017,Culpeper County,51047,"White, Not Hispanic or Latino ",13188,10235,2953,295,370,318
2017,Cumberland County,51049,"White, Not Hispanic or Latino ",2594,2006,588,159,174,166
2017,Dickenson County,51051,"White, Not Hispanic or Latino ",6055,4594,1461,239,215,238
2017,Dinwiddie County,51053,"White, Not Hispanic or Latino ",6955,5532,1423,257,280,277
2017,Essex County,51057,"White, Not Hispanic or Latino ",2636,2082,554,123,162,143
2017,Fairfax County,51059,"White, Not Hispanic or Latino ",235367,178399,56968,1325,1570,1404
2017,Fauquier County,51061,"White, Not Hispanic or Latino ",20523,16519,4004,351,442,388
2017,Floyd County,51063,"White, Not Hispanic or Latino ",5984,4857,1127,245,238,225
2017,Fluvanna County,51065,"White, Not Hispanic or Latino ",8297,6804,1493,215,316,286
2017,Franklin County,51067,"White, Not Hispanic or Latino ",21015,17180,3835,446,423,418
2017,Frederick County,51069,"White, Not Hispanic or Latino ",27108,21287,5821,446,516,465
2017,Giles County,51071,"White, Not Hispanic or Latino ",6849,5166,1683,249,263,227
2017,Gloucester County,51073,"White, Not Hispanic or Latino ",12633,9866,2767,321,367,358
2017,Goochland County,51075,"White, Not Hispanic or Latino ",6691,5945,746,195,233,157
2017,Grayson County,51077,"White, Not Hispanic or Latino ",6287,5079,1208,241,230,183
2017,Greene County,51079,"White, Not Hispanic or Latino ",6258,5096,1162,223,312,235
2017,Greensville County,51081,"White, Not Hispanic or Latino ",1631,1310,321,126,127,109
2017,Halifax County,51083,"White, Not Hispanic or Latino ",8834,6975,1859,299,249,238
2017,Hanover County,51085,"White, Not Hispanic or Latino ",33059,27511,5548,352,466,362
2017,Henrico County,51087,"White, Not Hispanic or Latino ",74027,53191,20836,727,873,834
2017,Henry County,51089,"White, Not Hispanic or Latino ",16023,12574,3449,356,408,389
2017,Highland County,51091,"White, Not Hispanic or Latino ",1161,992,169,75,90,71
2017,Isle of Wight County,51093,"White, Not Hispanic or Latino ",10319,8391,1928,213,238,238
2017,James City County,51095,"White, Not Hispanic or Latino ",23005,18157,4848,525,574,480
2017,King and Queen County,51097,"White, Not Hispanic or Latino ",1930,1615,315,133,120,97
2017,King George County,51099,"White, Not Hispanic or Latino ",6844,5355,1489,184,256,209
2017,King William County,51101,"White, Not Hispanic or Latino ",4875,4274,601,160,228,167
2017,Lancaster County,51103,"White, Not Hispanic or Latino ",3640,2887,753,166,179,138
2017,Lee County,51105,"White, Not Hispanic or Latino ",9163,6607,2556,349,281,307
2017,Loudoun County,51107,"White, Not Hispanic or Latino ",78082,62771,15311,660,736,812
2017,Louisa County,51109,"White, Not Hispanic or Latino ",10685,8535,2150,394,436,259
2017,Lunenburg County,51111,"White, Not Hispanic or Latino ",2867,2259,608,142,148,108
2017,Madison County,51113,"White, Not Hispanic or Latino ",4610,3428,1182,190,213,249
2017,Mathews County,51115,"White, Not Hispanic or Latino ",3268,2872,396,242,252,172
2017,Mecklenburg County,51117,"White, Not Hispanic or Latino ",7816,6191,1625,286,255,217
2017,Middlesex County,51119,"White, Not Hispanic or Latino ",3633,3052,581,193,190,127
2017,Montgomery County,51121,"White, Not Hispanic or Latino ",31063,18118,12945,675,596,743
2017,Nelson County,51125,"White, Not Hispanic or Latino ",5386,4073,1313,260,261,247
2017,New Kent County,51127,"White, Not Hispanic or Latino ",6325,5158,1167,187,226,233
2017,Northampton County,51131,"White, Not Hispanic or Latino ",3038,2276,762,141,158,147
2017,Northumberland County,51133,"White, Not Hispanic or Latino ",4329,3786,543,224,241,189
2017,Nottoway County,51135,"White, Not Hispanic or Latino ",3346,2292,1054,161,204,212
2017,Orange County,51137,"White, Not Hispanic or Latino ",11157,9004,2153,418,399,321
2017,Page County,51139,"White, Not Hispanic or Latino ",9193,6393,2800,273,344,342
2017,Patrick County,51141,"White, Not Hispanic or Latino ",7211,5626,1585,301,282,251
2017,Pittsylvania County,51143,"White, Not Hispanic or Latino ",20242,15830,4412,396,473,420
2017,Powhatan County,51145,"White, Not Hispanic or Latino ",9023,8048,975,204,268,218
2017,Prince Edward County,51147,"White, Not Hispanic or Latino ",4635,3147,1488,340,209,336
2017,Prince George County,51149,"White, Not Hispanic or Latino ",6903,5282,1621,251,250,238
2017,Prince William County,51153,"White, Not Hispanic or Latino ",72144,58264,13880,776,813,659
2017,Pulaski County,51155,"White, Not Hispanic or Latino ",13624,10009,3615,376,353,322
2017,Rappahannock County,51157,"White, Not Hispanic or Latino ",2875,2282,593,149,125,143
2017,Richmond County,51159,"White, Not Hispanic or Latino ",2253,1730,523,169,145,116
2017,Roanoke County,51161,"White, Not Hispanic or Latino ",34285,26592,7693,463,473,507
2017,Rockbridge County,51163,"White, Not Hispanic or Latino ",8713,6716,1997,311,309,315
2017,Rockingham County,51165,"White, Not Hispanic or Latino ",28501,21257,7244,386,396,448
2017,Russell County,51167,"White, Not Hispanic or Latino ",10856,8513,2343,317,371,321
2017,Scott County,51169,"White, Not Hispanic or Latino ",8852,6882,1970,303,335,268
2017,Shenandoah County,51171,"White, Not Hispanic or Latino ",15936,11464,4472,313,348,363
2017,Smyth County,51173,"White, Not Hispanic or Latino ",12344,8836,3508,311,271,257
2017,Southampton County,51175,"White, Not Hispanic or Latino ",4119,3363,756,156,188,174
2017,Spotsylvania County,51177,"White, Not Hispanic or Latino ",32313,26194,6119,407,452,397
2017,Stafford County,51179,"White, Not Hispanic or Latino ",30739,25062,5677,400,594,485
2017,Surry County,51181,"White, Not Hispanic or Latino ",1457,1198,259,83,111,91
2017,Sussex County,51183,"White, Not Hispanic or Latino ",1637,1203,434,224,179,100
2017,Tazewell County,51185,"White, Not Hispanic or Latino ",16689,12922,3767,396,440,416
2017,Warren County,51187,"White, Not Hispanic or Latino ",12871,10167,2704,334,299,302
2017,Washington County,51191,"White, Not Hispanic or Latino ",21706,16546,5160,407,454,404
2017,Westmoreland County,51193,"White, Not Hispanic or Latino ",5383,4246,1137,240,272,220
2017,Wise County,51195,"White, Not Hispanic or Latino ",14819,10258,4561,327,373,404
2017,Wythe County,51197,"White, Not Hispanic or Latino ",11428,8789,2639,374,396,418
2017,York County,51199,"White, Not Hispanic or Latino ",18459,14192,4267,328,372,364
2017,Alexandria city,51510,"White, Not Hispanic or Latino ",41256,23054,18202,570,655,702
2017,Bristol city,51520,"White, Not Hispanic or Latino ",6865,4194,2671,266,312,247
2017,Buena Vista city,51530,"White, Not Hispanic or Latino ",2417,1557,860,159,178,178
2017,Charlottesville city,51540,"White, Not Hispanic or Latino ",13168,6814,6354,344,331,383
2017,Chesapeake city,51550,"White, Not Hispanic or Latino ",51243,40437,10806,661,760,659
2017,Colonial Heights city,51570,"White, Not Hispanic or Latino ",5721,4032,1689,195,251,207
2017,Covington city,51580,"White, Not Hispanic or Latino ",2066,1584,482,135,134,117
2017,Danville city,51590,"White, Not Hispanic or Latino ",8912,6166,2746,270,263,252
2017,Emporia city,51595,"White, Not Hispanic or Latino ",703,463,240,124,85,104
2017,Fairfax city,51600,"White, Not Hispanic or Latino ",5606,4269,1337,191,203,196
2017,Falls Church city,51610,"White, Not Hispanic or Latino ",3981,2739,1242,159,149,170
2017,Franklin city,51620,"White, Not Hispanic or Latino ",1443,1023,420,114,118,148
2017,Fredericksburg city,51630,"White, Not Hispanic or Latino ",6857,2861,3996,262,213,305
2017,Galax city,51640,"White, Not Hispanic or Latino ",2411,1469,942,202,175,153
2017,Hampton city,51650,"White, Not Hispanic or Latino ",23153,15747,7406,465,488,545
2017,Harrisonburg city,51660,"White, Not Hispanic or Latino ",12455,5389,7066,372,334,396
2017,Hopewell city,51670,"White, Not Hispanic or Latino ",4871,3120,1751,256,243,267
2017,Lexington city,51678,"White, Not Hispanic or Latino ",1453,859,594,212,166,149
2017,Lynchburg city,51680,"White, Not Hispanic or Latino ",18274,10884,7390,476,450,467
2017,Manassas city,51683,"White, Not Hispanic or Latino ",6612,4869,1743,252,270,223
2017,Manassas Park city,51685,"White, Not Hispanic or Latino ",2252,1546,706,148,132,161
2017,Martinsville city,51690,"White, Not Hispanic or Latino ",2998,2108,890,122,145,148
2017,Newport News city,51700,"White, Not Hispanic or Latino ",32937,21245,11692,655,617,650
2017,Norfolk city,51710,"White, Not Hispanic or Latino ",42062,24022,18040,730,618,723
2017,Norton city,51720,"White, Not Hispanic or Latino ",1607,819,788,159,160,144
2017,Petersburg city,51730,"White, Not Hispanic or Latino ",2243,1159,1084,169,150,139
2017,Poquoson city,51735,"White, Not Hispanic or Latino ",4380,3495,885,117,167,174
2017,Portsmouth city,51740,"White, Not Hispanic or Latino ",15904,10687,5217,356,357,388
2017,Radford city,51750,"White, Not Hispanic or Latino ",5001,2450,2551,252,238,282
2017,Richmond city,51760,"White, Not Hispanic or Latino ",41810,21914,19896,723,670,671
2017,Roanoke city,51770,"White, Not Hispanic or Latino ",28399,16440,11959,567,586,701
2017,Salem city,51775,"White, Not Hispanic or Latino ",8903,6265,2638,259,289,253
2017,Staunton city,51790,"White, Not Hispanic or Latino ",9079,5401,3678,245,306,288
2017,Suffolk city,51800,"White, Not Hispanic or Latino ",16941,13448,3493,285,319,311
2017,Virginia Beach city,51810,"White, Not Hispanic or Latino ",113562,79216,34346,1059,1065,1069
2017,Waynesboro city,51820,"White, Not Hispanic or Latino ",7362,4766,2596,277,332,284
2017,Williamsburg city,51830,"White, Not Hispanic or Latino ",3480,1864,1616,200,123,197
2017,Winchester city,51840,"White, Not Hispanic or Latino ",7993,4054,3939,331,301,370
2018,Accomack County,51001,"White, Not Hispanic or Latino ",9175,6921,2254,305,303,261
2018,Albemarle County,51003,"White, Not Hispanic or Latino ",33248,22343,10905,606,617,654
2018,Alleghany County,51005,"White, Not Hispanic or Latino ",6325,5020,1305,189,209,197
2018,Amelia County,51007,"White, Not Hispanic or Latino ",3566,3005,561,189,191,179
2018,Amherst County,51009,"White, Not Hispanic or Latino ",9312,7467,1845,282,336,231
2018,Appomattox County,51011,"White, Not Hispanic or Latino ",4958,3987,971,184,240,193
2018,Arlington County,51013,"White, Not Hispanic or Latino ",70175,35220,34955,830,707,897
2018,Augusta County,51015,"White, Not Hispanic or Latino ",28019,22422,5597,449,549,544
2018,Bath County,51017,"White, Not Hispanic or Latino ",1917,1423,494,189,222,181
2018,Bedford County,51019,"White, Not Hispanic or Latino ",28087,23285,4802,466,516,498
2018,Bland County,51021,"White, Not Hispanic or Latino ",2501,2077,424,136,144,112
2018,Botetourt County,51023,"White, Not Hispanic or Latino ",12560,10929,1631,231,302,230
2018,Brunswick County,51025,"White, Not Hispanic or Latino ",2869,2336,533,149,168,128
2018,Buchanan County,51027,"White, Not Hispanic or Latino ",8673,6863,1810,318,296,261
2018,Buckingham County,51029,"White, Not Hispanic or Latino ",3895,3006,889,181,211,141
2018,Campbell County,51031,"White, Not Hispanic or Latino ",18832,14707,4125,394,471,418
2018,Caroline County,51033,"White, Not Hispanic or Latino ",7365,6196,1169,292,285,257
2018,Carroll County,51035,"White, Not Hispanic or Latino ",12051,9278,2773,351,429,397
2018,Charles City County,51036,"White, Not Hispanic or Latino ",1285,1072,213,64,65,44
2018,Charlotte County,51037,"White, Not Hispanic or Latino ",3075,2267,808,226,201,137
2018,Chesterfield County,51041,"White, Not Hispanic or Latino ",82856,68010,14846,720,904,781
2018,Clarke County,51043,"White, Not Hispanic or Latino ",5051,3894,1157,184,214,191
2018,Craig County,51045,"White, Not Hispanic or Latino ",2257,1636,621,178,239,196
2018,Culpeper County,51047,"White, Not Hispanic or Latino ",13140,10348,2792,293,385,333
2018,Cumberland County,51049,"White, Not Hispanic or Latino ",2552,1974,578,158,160,156
2018,Dickenson County,51051,"White, Not Hispanic or Latino ",5791,4410,1381,244,288,226
2018,Dinwiddie County,51053,"White, Not Hispanic or Latino ",6754,5419,1335,271,305,197
2018,Essex County,51057,"White, Not Hispanic or Latino ",2647,2134,513,168,180,129
2018,Fairfax County,51059,"White, Not Hispanic or Latino ",233996,177345,56651,1071,1281,1302
2018,Fauquier County,51061,"White, Not Hispanic or Latino ",20693,16500,4193,368,403,362
2018,Floyd County,51063,"White, Not Hispanic or Latino ",6100,5010,1090,239,248,240
2018,Fluvanna County,51065,"White, Not Hispanic or Latino ",8300,7107,1193,229,286,233
2018,Franklin County,51067,"White, Not Hispanic or Latino ",20818,17133,3685,441,467,467
2018,Frederick County,51069,"White, Not Hispanic or Latino ",27445,21666,5779,474,613,431
2018,Giles County,51071,"White, Not Hispanic or Latino ",6779,5246,1533,219,233,208
2018,Gloucester County,51073,"White, Not Hispanic or Latino ",12590,9782,2808,285,358,364
2018,Goochland County,51075,"White, Not Hispanic or Latino ",6862,5881,981,194,233,198
2018,Grayson County,51077,"White, Not Hispanic or Latino ",6181,5024,1157,281,288,173
2018,Greene County,51079,"White, Not Hispanic or Latino ",6244,5044,1200,266,293,207
2018,Greensville County,51081,"White, Not Hispanic or Latino ",1683,1330,353,118,124,100
2018,Halifax County,51083,"White, Not Hispanic or Latino ",8748,6998,1750,275,256,231
2018,Hanover County,51085,"White, Not Hispanic or Latino ",33328,27751,5577,410,457,421
2018,Henrico County,51087,"White, Not Hispanic or Latino ",74219,53299,20920,770,809,875
2018,Henry County,51089,"White, Not Hispanic or Latino ",15551,12040,3511,368,439,364
2018,Highland County,51091,"White, Not Hispanic or Latino ",1118,915,203,66,100,75
2018,Isle of Wight County,51093,"White, Not Hispanic or Latino ",10353,8254,2099,214,292,252
2018,James City County,51095,"White, Not Hispanic or Latino ",23213,18465,4748,471,462,458
2018,King and Queen County,51097,"White, Not Hispanic or Latino ",2074,1801,273,112,126,98
2018,King George County,51099,"White, Not Hispanic or Latino ",6998,5572,1426,204,245,219
2018,King William County,51101,"White, Not Hispanic or Latino ",4960,4377,583,175,211,151
2018,Lancaster County,51103,"White, Not Hispanic or Latino ",3607,2966,641,179,160,126
2018,Lee County,51105,"White, Not Hispanic or Latino ",9042,6408,2634,328,293,343
2018,Loudoun County,51107,"White, Not Hispanic or Latino ",79886,64158,15728,689,760,701
2018,Louisa County,51109,"White, Not Hispanic or Latino ",10864,8785,2079,343,351,286
2018,Lunenburg County,51111,"White, Not Hispanic or Latino ",2767,2115,652,167,165,128
2018,Madison County,51113,"White, Not Hispanic or Latino ",4440,3254,1186,234,235,222
2018,Mathews County,51115,"White, Not Hispanic or Latino ",3415,3079,336,232,221,156
2018,Mecklenburg County,51117,"White, Not Hispanic or Latino ",7790,5974,1816,256,264,249
2018,Middlesex County,51119,"White, Not Hispanic or Latino ",3538,2962,576,211,194,144
2018,Montgomery County,51121,"White, Not Hispanic or Latino ",30850,18021,12829,607,674,731
2018,Nelson County,51125,"White, Not Hispanic or Latino ",5225,4041,1184,274,264,240
2018,New Kent County,51127,"White, Not Hispanic or Latino ",6405,5466,939,228,290,231
2018,Northampton County,51131,"White, Not Hispanic or Latino ",3123,2297,826,150,142,150
2018,Northumberland County,51133,"White, Not Hispanic or Latino ",4281,3794,487,202,204,161
2018,Nottoway County,51135,"White, Not Hispanic or Latino ",3299,2331,968,216,220,194
2018,Orange County,51137,"White, Not Hispanic or Latino ",11206,9076,2130,373,485,360
2018,Page County,51139,"White, Not Hispanic or Latino ",9039,6423,2616,312,284,271
2018,Patrick County,51141,"White, Not Hispanic or Latino ",7155,5550,1605,215,253,240
2018,Pittsylvania County,51143,"White, Not Hispanic or Latino ",20085,15558,4527,364,375,399
2018,Powhatan County,51145,"White, Not Hispanic or Latino ",9204,8259,945,232,306,226
2018,Prince Edward County,51147,"White, Not Hispanic or Latino ",4661,3195,1466,286,249,328
2018,Prince George County,51149,"White, Not Hispanic or Latino ",6882,5150,1732,282,286,221
2018,Prince William County,51153,"White, Not Hispanic or Latino ",71353,57520,13833,796,780,783
2018,Pulaski County,51155,"White, Not Hispanic or Latino ",13561,9931,3630,384,391,368
2018,Rappahannock County,51157,"White, Not Hispanic or Latino ",2767,2117,650,198,171,135
2018,Richmond County,51159,"White, Not Hispanic or Latino ",2145,1703,442,169,186,116
2018,Roanoke County,51161,"White, Not Hispanic or Latino ",34217,26333,7884,478,633,524
2018,Rockbridge County,51163,"White, Not Hispanic or Latino ",8535,6742,1793,338,319,299
2018,Rockingham County,51165,"White, Not Hispanic or Latino ",28784,21433,7351,394,590,546
2018,Russell County,51167,"White, Not Hispanic or Latino ",10662,8227,2435,343,337,311
2018,Scott County,51169,"White, Not Hispanic or Latino ",8641,6772,1869,266,259,231
2018,Shenandoah County,51171,"White, Not Hispanic or Latino ",15905,11598,4307,370,401,383
2018,Smyth County,51173,"White, Not Hispanic or Latino ",12358,8994,3364,321,281,259
2018,Southampton County,51175,"White, Not Hispanic or Latino ",3984,3260,724,169,222,161
2018,Spotsylvania County,51177,"White, Not Hispanic or Latino ",32100,26202,5898,399,553,482
2018,Stafford County,51179,"White, Not Hispanic or Latino ",30532,24975,5557,433,541,454
2018,Surry County,51181,"White, Not Hispanic or Latino ",1456,1226,230,73,82,61
2018,Sussex County,51183,"White, Not Hispanic or Latino ",1603,1224,379,173,161,82
2018,Tazewell County,51185,"White, Not Hispanic or Latino ",16342,12589,3753,438,460,355
2018,Warren County,51187,"White, Not Hispanic or Latino ",13045,10212,2833,313,337,300
2018,Washington County,51191,"White, Not Hispanic or Latino ",21645,16420,5225,425,426,413
2018,Westmoreland County,51193,"White, Not Hispanic or Latino ",5430,4224,1206,266,286,297
2018,Wise County,51195,"White, Not Hispanic or Latino ",14804,9812,4992,356,407,407
2018,Wythe County,51197,"White, Not Hispanic or Latino ",11478,8924,2554,340,399,358
2018,York County,51199,"White, Not Hispanic or Latino ",18515,14272,4243,385,403,379
2018,Alexandria city,51510,"White, Not Hispanic or Latino ",41878,23238,18640,523,512,649
2018,Bristol city,51520,"White, Not Hispanic or Latino ",6860,4184,2676,270,284,312
2018,Buena Vista city,51530,"White, Not Hispanic or Latino ",2320,1630,690,159,206,179
2018,Charlottesville city,51540,"White, Not Hispanic or Latino ",13385,6789,6596,277,405,368
2018,Chesapeake city,51550,"White, Not Hispanic or Latino ",51658,41145,10513,549,666,710
2018,Colonial Heights city,51570,"White, Not Hispanic or Latino ",5680,4063,1617,185,207,184
2018,Covington city,51580,"White, Not Hispanic or Latino ",2084,1526,558,112,128,134
2018,Danville city,51590,"White, Not Hispanic or Latino ",8706,6110,2596,248,245,260
2018,Emporia city,51595,"White, Not Hispanic or Latino ",573,356,217,114,82,97
2018,Fairfax city,51600,"White, Not Hispanic or Latino ",5437,4163,1274,208,214,183
2018,Falls Church city,51610,"White, Not Hispanic or Latino ",3994,2801,1193,183,171,162
2018,Franklin city,51620,"White, Not Hispanic or Latino ",1343,1050,293,98,138,126
2018,Fredericksburg city,51630,"White, Not Hispanic or Latino ",7098,2905,4193,312,267,401
2018,Galax city,51640,"White, Not Hispanic or Latino ",2289,1506,783,168,181,163
2018,Hampton city,51650,"White, Not Hispanic or Latino ",22473,15350,7123,568,547,551
2018,Harrisonburg city,51660,"White, Not Hispanic or Latino ",12332,5381,6951,355,315,392
2018,Hopewell city,51670,"White, Not Hispanic or Latino ",4838,3029,1809,272,245,236
2018,Lexington city,51678,"White, Not Hispanic or Latino ",1661,961,700,225,172,158
2018,Lynchburg city,51680,"White, Not Hispanic or Latino ",18145,10767,7378,556,430,521
2018,Manassas city,51683,"White, Not Hispanic or Latino ",6606,4898,1708,259,261,245
2018,Manassas Park city,51685,"White, Not Hispanic or Latino ",2214,1444,770,152,142,172
2018,Martinsville city,51690,"White, Not Hispanic or Latino ",2826,2156,670,132,144,127
2018,Newport News city,51700,"White, Not Hispanic or Latino ",32387,20801,11586,602,538,646
2018,Norfolk city,51710,"White, Not Hispanic or Latino ",42611,24254,18357,655,588,674
2018,Norton city,51720,"White, Not Hispanic or Latino ",1602,793,809,162,143,170
2018,Petersburg city,51730,"White, Not Hispanic or Latino ",2165,1083,1082,187,170,141
2018,Poquoson city,51735,"White, Not Hispanic or Latino ",4333,3623,710,102,160,145
2018,Portsmouth city,51740,"White, Not Hispanic or Latino ",15473,10550,4923,366,326,395
2018,Radford city,51750,"White, Not Hispanic or Latino ",5005,2569,2436,237,266,295
2018,Richmond city,51760,"White, Not Hispanic or Latino ",42879,23081,19798,607,562,656
2018,Roanoke city,51770,"White, Not Hispanic or Latino ",27487,16022,11465,500,563,619
2018,Salem city,51775,"White, Not Hispanic or Latino ",8663,6078,2585,280,278,315
2018,Staunton city,51790,"White, Not Hispanic or Latino ",9148,5400,3748,243,303,317
2018,Suffolk city,51800,"White, Not Hispanic or Latino ",17213,13873,3340,314,370,311
2018,Virginia Beach city,51810,"White, Not Hispanic or Latino ",113825,80131,33694,878,943,963
2018,Waynesboro city,51820,"White, Not Hispanic or Latino ",7402,4867,2535,268,299,299
2018,Williamsburg city,51830,"White, Not Hispanic or Latino ",3609,1919,1690,168,154,186
2018,Winchester city,51840,"White, Not Hispanic or Latino ",8075,4267,3808,308,283,309
2019,Accomack County,51001,"White, Not Hispanic or Latino ",9198,7009,2189,389,309,363
2019,Albemarle County,51003,"White, Not Hispanic or Latino ",34070,22972,11098,562,610,607
2019,Alleghany County,51005,"White, Not Hispanic or Latino ",6126,4767,1359,184,188,155
2019,Amelia County,51007,"White, Not Hispanic or Latino ",3616,3005,611,187,207,171
2019,Amherst County,51009,"White, Not Hispanic or Latino ",9386,7529,1857,284,321,279
2019,Appomattox County,51011,"White, Not Hispanic or Latino ",4964,4053,911,185,216,182
2019,Arlington County,51013,"White, Not Hispanic or Latino ",71300,35340,35960,734,786,866
2019,Augusta County,51015,"White, Not Hispanic or Latino ",28314,22754,5560,497,551,520
2019,Bath County,51017,"White, Not Hispanic or Latino ",1713,1340,373,226,224,138
2019,Bedford County,51019,"White, Not Hispanic or Latino ",28251,23520,4731,494,548,439
2019,Bland County,51021,"White, Not Hispanic or Latino ",2337,1914,423,179,176,118
2019,Botetourt County,51023,"White, Not Hispanic or Latino ",12587,10928,1659,308,318,275
2019,Brunswick County,51025,"White, Not Hispanic or Latino ",2882,2277,605,145,173,161
2019,Buchanan County,51027,"White, Not Hispanic or Latino ",8338,6565,1773,339,305,309
2019,Buckingham County,51029,"White, Not Hispanic or Latino ",3845,2955,890,193,226,167
2019,Campbell County,51031,"White, Not Hispanic or Latino ",18946,14561,4385,331,462,401
2019,Caroline County,51033,"White, Not Hispanic or Latino ",7351,5935,1416,320,316,293
2019,Carroll County,51035,"White, Not Hispanic or Latino ",12062,9450,2612,401,453,347
2019,Charles City County,51036,"White, Not Hispanic or Latino ",1305,1080,225,60,62,54
2019,Charlotte County,51037,"White, Not Hispanic or Latino ",3255,2392,863,181,180,135
2019,Chesterfield County,51041,"White, Not Hispanic or Latino ",83785,69078,14707,580,684,706
2019,Clarke County,51043,"White, Not Hispanic or Latino ",5031,3849,1182,170,217,218
2019,Craig County,51045,"White, Not Hispanic or Latino ",2290,1756,534,181,202,154
2019,Culpeper County,51047,"White, Not Hispanic or Latino ",13238,10214,3024,338,375,384
2019,Cumberland County,51049,"White, Not Hispanic or Latino ",2603,2042,561,151,169,148
2019,Dickenson County,51051,"White, Not Hispanic or Latino ",5744,4344,1400,233,227,196
2019,Dinwiddie County,51053,"White, Not Hispanic or Latino ",6583,5433,1150,289,263,200
2019,Essex County,51057,"White, Not Hispanic or Latino ",2649,2021,628,143,172,163
2019,Fairfax County,51059,"White, Not Hispanic or Latino ",232626,176038,56588,1263,1375,1276
2019,Fauquier County,51061,"White, Not Hispanic or Latino ",20825,16760,4065,379,424,418
2019,Floyd County,51063,"White, Not Hispanic or Latino ",6092,4965,1127,280,257,221
2019,Fluvanna County,51065,"White, Not Hispanic or Latino ",8454,7287,1167,207,265,208
2019,Franklin County,51067,"White, Not Hispanic or Latino ",20737,17396,3341,510,464,453
2019,Frederick County,51069,"White, Not Hispanic or Latino ",28005,21933,6072,469,528,513
2019,Giles County,51071,"White, Not Hispanic or Latino ",6667,5077,1590,233,246,205
2019,Gloucester County,51073,"White, Not Hispanic or Latino ",12742,10136,2606,316,408,359
2019,Goochland County,51075,"White, Not Hispanic or Latino ",6939,6052,887,243,237,207
2019,Grayson County,51077,"White, Not Hispanic or Latino ",6162,5108,1054,288,262,166
2019,Greene County,51079,"White, Not Hispanic or Latino ",6458,5041,1417,227,288,265
2019,Greensville County,51081,"White, Not Hispanic or Latino ",1748,1324,424,112,127,120
2019,Halifax County,51083,"White, Not Hispanic or Latino ",8817,7037,1780,348,310,256
2019,Hanover County,51085,"White, Not Hispanic or Latino ",33600,28385,5215,422,483,501
2019,Henrico County,51087,"White, Not Hispanic or Latino ",74547,53482,21065,760,922,861
2019,Henry County,51089,"White, Not Hispanic or Latino ",15185,11659,3526,434,372,406
2019,Highland County,51091,"White, Not Hispanic or Latino ",1069,885,184,77,82,71
2019,Isle of Wight County,51093,"White, Not Hispanic or Latino ",10521,8548,1973,246,319,281
2019,James City County,51095,"White, Not Hispanic or Latino ",23262,18812,4450,470,434,404
2019,King and Queen County,51097,"White, Not Hispanic or Latino ",2043,1730,313,122,125,132
2019,King George County,51099,"White, Not Hispanic or Latino ",7023,5771,1252,228,252,213
2019,King William County,51101,"White, Not Hispanic or Latino ",4839,4323,516,165,189,140
2019,Lancaster County,51103,"White, Not Hispanic or Latino ",3553,2888,665,199,187,152
2019,Lee County,51105,"White, Not Hispanic or Latino ",9052,6425,2627,354,300,318
2019,Loudoun County,51107,"White, Not Hispanic or Latino ",80946,65076,15870,681,808,728
2019,Louisa County,51109,"White, Not Hispanic or Latino ",11103,9061,2042,381,406,299
2019,Lunenburg County,51111,"White, Not Hispanic or Latino ",2596,2086,510,175,164,109
2019,Madison County,51113,"White, Not Hispanic or Latino ",4309,3179,1130,246,264,253
2019,Mathews County,51115,"White, Not Hispanic or Latino ",3310,2958,352,258,273,187
2019,Mecklenburg County,51117,"White, Not Hispanic or Latino ",7952,6321,1631,237,256,227
2019,Middlesex County,51119,"White, Not Hispanic or Latino ",3679,2992,687,222,207,153
2019,Montgomery County,51121,"White, Not Hispanic or Latino ",31023,18172,12851,581,613,667
2019,Nelson County,51125,"White, Not Hispanic or Latino ",5247,4135,1112,268,247,238
2019,New Kent County,51127,"White, Not Hispanic or Latino ",6514,5680,834,211,309,227
2019,Northampton County,51131,"White, Not Hispanic or Latino ",3126,2336,790,161,151,132
2019,Northumberland County,51133,"White, Not Hispanic or Latino ",4210,3828,382,240,207,134
2019,Nottoway County,51135,"White, Not Hispanic or Latino ",3290,2450,840,187,214,192
2019,Orange County,51137,"White, Not Hispanic or Latino ",11449,9279,2170,357,349,345
2019,Page County,51139,"White, Not Hispanic or Latino ",8972,6461,2511,292,323,363
2019,Patrick County,51141,"White, Not Hispanic or Latino ",7200,5730,1470,301,299,250
2019,Pittsylvania County,51143,"White, Not Hispanic or Latino ",20089,15648,4441,365,425,443
2019,Powhatan County,51145,"White, Not Hispanic or Latino ",9350,8549,801,248,324,230
2019,Prince Edward County,51147,"White, Not Hispanic or Latino ",4506,3190,1316,243,208,225
2019,Prince George County,51149,"White, Not Hispanic or Latino ",6995,5257,1738,312,240,261
2019,Prince William County,51153,"White, Not Hispanic or Latino ",71222,57275,13947,714,714,697
2019,Pulaski County,51155,"White, Not Hispanic or Latino ",13526,9773,3753,310,367,352
2019,Rappahannock County,51157,"White, Not Hispanic or Latino ",2661,2075,586,147,132,130
2019,Richmond County,51159,"White, Not Hispanic or Latino ",2131,1673,458,127,147,96
2019,Roanoke County,51161,"White, Not Hispanic or Latino ",34065,26459,7606,485,523,497
2019,Rockbridge County,51163,"White, Not Hispanic or Latino ",8760,6610,2150,352,362,391
2019,Rockingham County,51165,"White, Not Hispanic or Latino ",28823,21715,7108,414,469,448
2019,Russell County,51167,"White, Not Hispanic or Latino ",10605,8080,2525,358,331,342
2019,Scott County,51169,"White, Not Hispanic or Latino ",8648,6744,1904,275,275,219
2019,Shenandoah County,51171,"White, Not Hispanic or Latino ",15929,11592,4337,394,395,390
2019,Smyth County,51173,"White, Not Hispanic or Latino ",12132,8806,3326,332,332,336
2019,Southampton County,51175,"White, Not Hispanic or Latino ",4076,3260,816,165,197,169
2019,Spotsylvania County,51177,"White, Not Hispanic or Latino ",32017,26452,5565,430,508,471
2019,Stafford County,51179,"White, Not Hispanic or Latino ",30828,25383,5445,469,591,519
2019,Surry County,51181,"White, Not Hispanic or Latino ",1458,1187,271,84,103,88
2019,Sussex County,51183,"White, Not Hispanic or Latino ",1552,1277,275,106,113,77
2019,Tazewell County,51185,"White, Not Hispanic or Latino ",15893,12020,3873,434,470,426
2019,Warren County,51187,"White, Not Hispanic or Latino ",13302,10457,2845,328,379,328
2019,Washington County,51191,"White, Not Hispanic or Latino ",21651,16461,5190,391,401,413
2019,Westmoreland County,51193,"White, Not Hispanic or Latino ",5598,4240,1358,280,277,267
2019,Wise County,51195,"White, Not Hispanic or Latino ",14460,9720,4740,370,465,385
2019,Wythe County,51197,"White, Not Hispanic or Latino ",11444,9094,2350,331,379,347
2019,York County,51199,"White, Not Hispanic or Latino ",18859,14276,4583,460,459,420
2019,Alexandria city,51510,"White, Not Hispanic or Latino ",42403,23609,18794,576,608,678
2019,Bristol city,51520,"White, Not Hispanic or Latino ",6933,4230,2703,278,340,319
2019,Buena Vista city,51530,"White, Not Hispanic or Latino ",2243,1643,600,143,181,147
2019,Charlottesville city,51540,"White, Not Hispanic or Latino ",13473,6697,6776,336,354,427
2019,Chesapeake city,51550,"White, Not Hispanic or Latino ",51943,41402,10541,708,709,626
2019,Colonial Heights city,51570,"White, Not Hispanic or Latino ",5490,3965,1525,185,200,228
2019,Covington city,51580,"White, Not Hispanic or Latino ",2086,1560,526,136,147,132
2019,Danville city,51590,"White, Not Hispanic or Latino ",8544,5679,2865,288,247,290
2019,Emporia city,51595,"White, Not Hispanic or Latino ",577,361,216,108,94,77
2019,Fairfax city,51600,"White, Not Hispanic or Latino ",5304,4042,1262,181,179,164
2019,Falls Church city,51610,"White, Not Hispanic or Latino ",4143,2727,1416,192,171,200
2019,Franklin city,51620,"White, Not Hispanic or Latino ",1461,1174,287,136,142,139
2019,Fredericksburg city,51630,"White, Not Hispanic or Latino ",7124,2890,4234,289,199,330
2019,Galax city,51640,"White, Not Hispanic or Latino ",2283,1541,742,196,154,158
2019,Hampton city,51650,"White, Not Hispanic or Latino ",22419,15010,7409,574,581,590
2019,Harrisonburg city,51660,"White, Not Hispanic or Latino ",11998,5416,6582,334,307,381
2019,Hopewell city,51670,"White, Not Hispanic or Latino ",4679,2854,1825,243,256,309
2019,Lexington city,51678,"White, Not Hispanic or Latino ",1730,917,813,240,161,187
2019,Lynchburg city,51680,"White, Not Hispanic or Latino ",18490,10639,7851,458,419,427
2019,Manassas city,51683,"White, Not Hispanic or Latino ",6557,4822,1735,248,211,205
2019,Manassas Park city,51685,"White, Not Hispanic or Latino ",2093,1400,693,159,169,140
2019,Martinsville city,51690,"White, Not Hispanic or Latino ",2602,1979,623,165,165,162
2019,Newport News city,51700,"White, Not Hispanic or Latino ",32027,20491,11536,604,621,740
2019,Norfolk city,51710,"White, Not Hispanic or Latino ",42857,24472,18385,797,614,714
2019,Norton city,51720,"White, Not Hispanic or Latino ",1493,785,708,165,131,171
2019,Petersburg city,51730,"White, Not Hispanic or Latino ",2123,1065,1058,183,170,141
2019,Poquoson city,51735,"White, Not Hispanic or Latino ",4312,3520,792,122,177,165
2019,Portsmouth city,51740,"White, Not Hispanic or Latino ",15305,10543,4762,372,412,459
2019,Radford city,51750,"White, Not Hispanic or Latino ",5106,2451,2655,284,275,295
2019,Richmond city,51760,"White, Not Hispanic or Latino ",43171,23105,20066,858,569,811
2019,Roanoke city,51770,"White, Not Hispanic or Latino ",26556,15612,10944,598,568,652
2019,Salem city,51775,"White, Not Hispanic or Latino ",8831,6061,2770,287,281,334
2019,Staunton city,51790,"White, Not Hispanic or Latino ",9265,5461,3804,295,303,295
2019,Suffolk city,51800,"White, Not Hispanic or Latino ",17567,14125,3442,323,348,309
2019,Virginia Beach city,51810,"White, Not Hispanic or Latino ",114332,80425,33907,989,811,992
2019,Waynesboro city,51820,"White, Not Hispanic or Latino ",7233,4808,2425,290,281,278
2019,Williamsburg city,51830,"White, Not Hispanic or Latino ",3662,1995,1667,218,139,231
2019,Winchester city,51840,"White, Not Hispanic or Latino ",7841,4006,3835,353,343,421
2020,Accomack County,51001,"White, Not Hispanic or Latino ",9179,7127,2052,381,395,328
2020,Albemarle County,51003,"White, Not Hispanic or Latino ",34808,23942,10866,653,615,638
2020,Alleghany County,51005,"White, Not Hispanic or Latino ",6007,4849,1158,233,247,219
2020,Amelia County,51007,"White, Not Hispanic or Latino ",3714,3006,708,173,257,238
2020,Amherst County,51009,"White, Not Hispanic or Latino ",9470,7597,1873,312,347,288
2020,Appomattox County,51011,"White, Not Hispanic or Latino ",5057,4002,1055,210,287,285
2020,Arlington County,51013,"White, Not Hispanic or Latino ",71522,35255,36267,843,915,1247
2020,Augusta County,51015,"White, Not Hispanic or Latino ",28752,23089,5663,468,602,543
2020,Bath County,51017,"White, Not Hispanic or Latino ",1699,1417,282,186,191,134
2020,Bedford County,51019,"White, Not Hispanic or Latino ",28369,24275,4094,489,538,454
2020,Bland County,51021,"White, Not Hispanic or Latino ",2303,1919,384,207,207,110
2020,Botetourt County,51023,"White, Not Hispanic or Latino ",12414,10787,1627,321,335,269
2020,Brunswick County,51025,"White, Not Hispanic or Latino ",3010,2413,597,166,214,152
2020,Buchanan County,51027,"White, Not Hispanic or Latino ",8006,6521,1485,356,348,281
2020,Buckingham County,51029,"White, Not Hispanic or Latino ",3834,2915,919,172,231,188
2020,Campbell County,51031,"White, Not Hispanic or Latino ",18790,14089,4701,370,522,516
2020,Caroline County,51033,"White, Not Hispanic or Latino ",7469,6162,1307,428,413,273
2020,Carroll County,51035,"White, Not Hispanic or Latino ",11706,9335,2371,373,487,406
2020,Charles City County,51036,"White, Not Hispanic or Latino ",1379,1155,224,67,72,46
2020,Charlotte County,51037,"White, Not Hispanic or Latino ",3407,2386,1021,157,181,190
2020,Chesterfield County,51041,"White, Not Hispanic or Latino ",84503,70645,13858,794,904,815
2020,Clarke County,51043,"White, Not Hispanic or Latino ",5020,3929,1091,192,220,242
2020,Craig County,51045,"White, Not Hispanic or Latino ",2203,1575,628,213,231,199
2020,Culpeper County,51047,"White, Not Hispanic or Latino ",13359,10556,2803,370,399,367
2020,Cumberland County,51049,"White, Not Hispanic or Latino ",2652,2194,458,156,187,164
2020,Dickenson County,51051,"White, Not Hispanic or Latino ",5688,4264,1424,207,231,194
2020,Dinwiddie County,51053,"White, Not Hispanic or Latino ",6745,5508,1237,281,333,230
2020,Essex County,51057,"White, Not Hispanic or Latino ",2668,1993,675,184,218,168
2020,Fairfax County,51059,"White, Not Hispanic or Latino ",230059,173780,56279,1378,1454,1558
2020,Fauquier County,51061,"White, Not Hispanic or Latino ",20793,16573,4220,401,408,459
2020,Floyd County,51063,"White, Not Hispanic or Latino ",6303,5428,875,209,239,199
2020,Fluvanna County,51065,"White, Not Hispanic or Latino ",8474,7202,1272,256,326,292
2020,Franklin County,51067,"White, Not Hispanic or Latino ",20567,17113,3454,576,707,623
2020,Frederick County,51069,"White, Not Hispanic or Latino ",28648,22289,6359,440,649,558
2020,Giles County,51071,"White, Not Hispanic or Latino ",6455,5043,1412,282,295,241
2020,Gloucester County,51073,"White, Not Hispanic or Latino ",12531,10203,2328,341,405,338
2020,Goochland County,51075,"White, Not Hispanic or Latino ",7115,6342,773,230,234,165
2020,Grayson County,51077,"White, Not Hispanic or Latino ",6042,5116,926,271,258,197
2020,Greene County,51079,"White, Not Hispanic or Latino ",6389,5207,1182,253,342,256
2020,Greensville County,51081,"White, Not Hispanic or Latino ",1578,1186,392,118,113,111
2020,Halifax County,51083,"White, Not Hispanic or Latino ",8770,6991,1779,347,372,293
2020,Hanover County,51085,"White, Not Hispanic or Latino ",33444,28359,5085,477,609,486
2020,Henrico County,51087,"White, Not Hispanic or Latino ",74765,54568,20197,960,1298,1142
2020,Henry County,51089,"White, Not Hispanic or Latino ",15208,11467,3741,481,514,507
2020,Highland County,51091,"White, Not Hispanic or Latino ",977,852,125,107,113,53
2020,Isle of Wight County,51093,"White, Not Hispanic or Latino ",10503,8707,1796,267,361,328
2020,James City County,51095,"White, Not Hispanic or Latino ",23539,19168,4371,455,540,480
2020,King and Queen County,51097,"White, Not Hispanic or Latino ",2062,1791,271,122,131,104
2020,King George County,51099,"White, Not Hispanic or Latino ",7142,5596,1546,243,275,282
2020,King William County,51101,"White, Not Hispanic or Latino ",5001,4494,507,161,180,150
2020,Lancaster County,51103,"White, Not Hispanic or Latino ",3606,2893,713,206,190,179
2020,Lee County,51105,"White, Not Hispanic or Latino ",8772,6109,2663,647,557,422
2020,Loudoun County,51107,"White, Not Hispanic or Latino ",81807,65784,16023,764,860,762
2020,Louisa County,51109,"White, Not Hispanic or Latino ",11369,9241,2128,333,405,323
2020,Lunenburg County,51111,"White, Not Hispanic or Latino ",2685,2174,511,189,173,138
2020,Madison County,51113,"White, Not Hispanic or Latino ",4299,3321,978,236,287,266
2020,Mathews County,51115,"White, Not Hispanic or Latino ",3288,2883,405,246,263,176
2020,Mecklenburg County,51117,"White, Not Hispanic or Latino ",8258,6746,1512,271,273,253
2020,Middlesex County,51119,"White, Not Hispanic or Latino ",3830,3139,691,192,194,150
2020,Montgomery County,51121,"White, Not Hispanic or Latino ",30471,18035,12436,627,677,721
2020,Nelson County,51125,"White, Not Hispanic or Latino ",5125,4006,1119,344,306,310
2020,New Kent County,51127,"White, Not Hispanic or Latino ",6309,5708,601,231,278,204
2020,Northampton County,51131,"White, Not Hispanic or Latino ",3192,2273,919,167,171,173
2020,Northumberland County,51133,"White, Not Hispanic or Latino ",4210,3764,446,282,266,157
2020,Nottoway County,51135,"White, Not Hispanic or Latino ",3339,2620,719,238,239,199
2020,Orange County,51137,"White, Not Hispanic or Latino ",11389,9100,2289,343,338,367
2020,Page County,51139,"White, Not Hispanic or Latino ",9007,6544,2463,314,381,313
2020,Patrick County,51141,"White, Not Hispanic or Latino ",7235,5685,1550,291,312,280
2020,Pittsylvania County,51143,"White, Not Hispanic or Latino ",19772,15500,4272,360,446,425
2020,Powhatan County,51145,"White, Not Hispanic or Latino ",9272,8686,586,316,362,199
2020,Prince Edward County,51147,"White, Not Hispanic or Latino ",4442,3206,1236,268,257,256
2020,Prince George County,51149,"White, Not Hispanic or Latino ",7197,5617,1580,300,313,258
2020,Prince William County,51153,"White, Not Hispanic or Latino ",69295,56167,13128,909,832,840
2020,Pulaski County,51155,"White, Not Hispanic or Latino ",13504,9622,3882,388,393,403
2020,Rappahannock County,51157,"White, Not Hispanic or Latino ",2634,2059,575,179,154,148
2020,Richmond County,51159,"White, Not Hispanic or Latino ",2134,1514,620,184,215,176
2020,Roanoke County,51161,"White, Not Hispanic or Latino ",34135,26601,7534,513,752,703
2020,Rockbridge County,51163,"White, Not Hispanic or Latino ",8751,6625,2126,315,343,358
2020,Rockingham County,51165,"White, Not Hispanic or Latino ",28839,21765,7074,424,632,645
2020,Russell County,51167,"White, Not Hispanic or Latino ",10799,8080,2719,380,447,408
2020,Scott County,51169,"White, Not Hispanic or Latino ",8593,6858,1735,293,324,247
2020,Shenandoah County,51171,"White, Not Hispanic or Latino ",15994,11537,4457,440,502,476
2020,Smyth County,51173,"White, Not Hispanic or Latino ",12167,8670,3497,303,312,250
2020,Southampton County,51175,"White, Not Hispanic or Latino ",4172,3369,803,181,219,191
2020,Spotsylvania County,51177,"White, Not Hispanic or Latino ",32110,26833,5277,513,546,498
2020,Stafford County,51179,"White, Not Hispanic or Latino ",31013,25644,5369,465,548,550
2020,Surry County,51181,"White, Not Hispanic or Latino ",1544,1249,295,114,119,98
2020,Sussex County,51183,"White, Not Hispanic or Latino ",1652,1403,249,147,147,73
2020,Tazewell County,51185,"White, Not Hispanic or Latino ",15706,11927,3779,535,571,466
2020,Warren County,51187,"White, Not Hispanic or Latino ",13091,10007,3084,323,365,353
2020,Washington County,51191,"White, Not Hispanic or Latino ",21447,16392,5055,475,454,440
2020,Westmoreland County,51193,"White, Not Hispanic or Latino ",5703,4433,1270,297,352,251
2020,Wise County,51195,"White, Not Hispanic or Latino ",14386,10032,4354,396,495,432
2020,Wythe County,51197,"White, Not Hispanic or Latino ",11797,9302,2495,417,375,335
2020,York County,51199,"White, Not Hispanic or Latino ",18796,14387,4409,345,428,450
2020,Alexandria city,51510,"White, Not Hispanic or Latino ",42130,23744,18386,650,708,792
2020,Bristol city,51520,"White, Not Hispanic or Latino ",6823,4247,2576,237,307,308
2020,Buena Vista city,51530,"White, Not Hispanic or Latino ",2224,1441,783,172,180,201
2020,Charlottesville city,51540,"White, Not Hispanic or Latino ",13399,6222,7177,391,397,467
2020,Chesapeake city,51550,"White, Not Hispanic or Latino ",51796,41813,9983,834,916,703
2020,Colonial Heights city,51570,"White, Not Hispanic or Latino ",5542,4042,1500,227,239,214
2020,Covington city,51580,"White, Not Hispanic or Latino ",2054,1582,472,146,149,126
2020,Danville city,51590,"White, Not Hispanic or Latino ",8160,5439,2721,291,332,298
2020,Emporia city,51595,"White, Not Hispanic or Latino ",616,420,196,125,128,100
2020,Fairfax city,51600,"White, Not Hispanic or Latino ",5324,3861,1463,200,250,265
2020,Falls Church city,51610,"White, Not Hispanic or Latino ",4281,2726,1555,203,193,242
2020,Franklin city,51620,"White, Not Hispanic or Latino ",1404,1236,168,142,138,130
2020,Fredericksburg city,51630,"White, Not Hispanic or Latino ",7312,3200,4112,345,261,368
2020,Galax city,51640,"White, Not Hispanic or Latino ",2069,1495,574,202,218,150
2020,Hampton city,51650,"White, Not Hispanic or Latino ",21641,14775,6866,689,674,563
2020,Harrisonburg city,51660,"White, Not Hispanic or Latino ",11829,5195,6634,406,384,441
2020,Hopewell city,51670,"White, Not Hispanic or Latino ",4641,2825,1816,244,275,299
2020,Lexington city,51678,"White, Not Hispanic or Latino ",1651,892,759,211,194,162
2020,Lynchburg city,51680,"White, Not Hispanic or Latino ",17870,10744,7126,512,448,500
2020,Manassas city,51683,"White, Not Hispanic or Latino ",6844,5019,1825,276,288,281
2020,Manassas Park city,51685,"White, Not Hispanic or Latino ",1992,1252,740,225,238,221
2020,Martinsville city,51690,"White, Not Hispanic or Latino ",2551,2003,548,162,157,129
2020,Newport News city,51700,"White, Not Hispanic or Latino ",32174,20204,11970,617,749,738
2020,Norfolk city,51710,"White, Not Hispanic or Latino ",43484,24178,19306,679,694,841
2020,Norton city,51720,"White, Not Hispanic or Latino ",1805,963,842,203,199,220
2020,Petersburg city,51730,"White, Not Hispanic or Latino ",2092,932,1160,159,116,174
2020,Poquoson city,51735,"White, Not Hispanic or Latino ",4172,3447,725,148,192,184
2020,Portsmouth city,51740,"White, Not Hispanic or Latino ",15180,10527,4653,366,406,380
2020,Radford city,51750,"White, Not Hispanic or Latino ",5195,2617,2578,229,288,347
2020,Richmond city,51760,"White, Not Hispanic or Latino ",44348,23891,20457,827,793,887
2020,Roanoke city,51770,"White, Not Hispanic or Latino ",26365,15814,10551,596,629,752
2020,Salem city,51775,"White, Not Hispanic or Latino ",8536,5972,2564,312,311,383
2020,Staunton city,51790,"White, Not Hispanic or Latino ",9292,5621,3671,288,317,319
2020,Suffolk city,51800,"White, Not Hispanic or Latino ",18160,14754,3406,372,475,408
2020,Virginia Beach city,51810,"White, Not Hispanic or Latino ",114261,81529,32732,1114,1280,1259
2020,Waynesboro city,51820,"White, Not Hispanic or Latino ",7467,4926,2541,364,344,328
2020,Williamsburg city,51830,"White, Not Hispanic or Latino ",3460,2079,1381,229,208,272
2020,Winchester city,51840,"White, Not Hispanic or Latino ",8050,4022,4028,317,358,396
2021,Accomack County,51001,"White, Not Hispanic or Latino ",9283,7383,1900,308,345,313
2021,Albemarle County,51003,"White, Not Hispanic or Latino ",35464,24892,10572,679,651,759
2021,Alleghany County,51005,"White, Not Hispanic or Latino ",5908,4861,1047,203,261,190
2021,Amelia County,51007,"White, Not Hispanic or Latino ",3825,3082,743,193,317,284
2021,Amherst County,51009,"White, Not Hispanic or Latino ",9659,7613,2046,320,355,312
2021,Appomattox County,51011,"White, Not Hispanic or Latino ",5124,4120,1004,218,275,219
2021,Arlington County,51013,"White, Not Hispanic or Latino ",71591,34704,36887,965,916,1188
2021,Augusta County,51015,"White, Not Hispanic or Latino ",28240,22568,5672,491,731,670
2021,Bath County,51017,"White, Not Hispanic or Latino ",1765,1373,392,174,179,146
2021,Bedford County,51019,"White, Not Hispanic or Latino ",28995,24791,4204,462,508,422
2021,Bland County,51021,"White, Not Hispanic or Latino ",2245,1870,375,200,185,112
2021,Botetourt County,51023,"White, Not Hispanic or Latino ",12230,10632,1598,316,373,280
2021,Brunswick County,51025,"White, Not Hispanic or Latino ",2806,2321,485,182,171,149
2021,Buchanan County,51027,"White, Not Hispanic or Latino ",7166,5887,1279,340,379,219
2021,Buckingham County,51029,"White, Not Hispanic or Latino ",3619,2772,847,208,199,175
2021,Campbell County,51031,"White, Not Hispanic or Latino ",17905,13466,4439,437,500,548
2021,Caroline County,51033,"White, Not Hispanic or Latino ",7339,6242,1097,324,363,268
2021,Carroll County,51035,"White, Not Hispanic or Latino ",11771,9177,2594,366,424,364
2021,Charles City County,51036,"White, Not Hispanic or Latino ",1330,1118,212,63,64,52
2021,Charlotte County,51037,"White, Not Hispanic or Latino ",3362,2386,976,151,199,150
2021,Chesterfield County,51041,"White, Not Hispanic or Latino ",85574,71386,14188,818,971,813
2021,Clarke County,51043,"White, Not Hispanic or Latino ",5023,3862,1161,190,240,231
2021,Craig County,51045,"White, Not Hispanic or Latino ",1904,1509,395,191,209,190
2021,Culpeper County,51047,"White, Not Hispanic or Latino ",13483,10717,2766,417,451,368
2021,Cumberland County,51049,"White, Not Hispanic or Latino ",2536,2166,370,190,173,117
2021,Dickenson County,51051,"White, Not Hispanic or Latino ",5479,4237,1242,231,264,225
2021,Dinwiddie County,51053,"White, Not Hispanic or Latino ",6740,5393,1347,266,312,270
2021,Essex County,51057,"White, Not Hispanic or Latino ",2482,1762,720,156,188,163
2021,Fairfax County,51059,"White, Not Hispanic or Latino ",231292,174379,56913,1456,1387,1423
2021,Fauquier County,51061,"White, Not Hispanic or Latino ",21296,16892,4404,435,495,475
2021,Floyd County,51063,"White, Not Hispanic or Latino ",6323,5447,876,181,255,208
2021,Fluvanna County,51065,"White, Not Hispanic or Latino ",8269,7361,908,285,328,261
2021,Franklin County,51067,"White, Not Hispanic or Latino ",19850,16338,3512,516,627,663
2021,Frederick County,51069,"White, Not Hispanic or Latino ",28908,22029,6879,438,669,626
2021,Giles County,51071,"White, Not Hispanic or Latino ",6555,5088,1467,304,294,247
2021,Gloucester County,51073,"White, Not Hispanic or Latino ",12614,10181,2433,391,440,331
2021,Goochland County,51075,"White, Not Hispanic or Latino ",7761,6866,895,246,257,206
2021,Grayson County,51077,"White, Not Hispanic or Latino ",5756,4785,971,234,252,157
2021,Greene County,51079,"White, Not Hispanic or Latino ",6414,5111,1303,265,259,227
2021,Greensville County,51081,"White, Not Hispanic or Latino ",1515,1166,349,141,137,118
2021,Halifax County,51083,"White, Not Hispanic or Latino ",8570,6665,1905,305,317,287
2021,Hanover County,51085,"White, Not Hispanic or Latino ",34299,28972,5327,420,593,472
2021,Henrico County,51087,"White, Not Hispanic or Latino ",74563,54479,20084,1067,1108,1164
2021,Henry County,51089,"White, Not Hispanic or Latino ",15009,11321,3688,476,582,541
2021,Highland County,51091,"White, Not Hispanic or Latino ",967,807,160,87,90,62
2021,Isle of Wight County,51093,"White, Not Hispanic or Latino ",10770,9086,1684,293,295,313
2021,James City County,51095,"White, Not Hispanic or Latino ",23334,19100,4234,494,659,481
2021,King and Queen County,51097,"White, Not Hispanic or Latino ",2038,1711,327,110,130,108
2021,King George County,51099,"White, Not Hispanic or Latino ",7109,5459,1650,225,277,264
2021,King William County,51101,"White, Not Hispanic or Latino ",5220,4672,548,183,228,173
2021,Lancaster County,51103,"White, Not Hispanic or Latino ",3729,3091,638,189,175,167
2021,Lee County,51105,"White, Not Hispanic or Latino ",8116,5743,2373,367,375,337
2021,Loudoun County,51107,"White, Not Hispanic or Latino ",82244,65856,16388,799,875,812
2021,Louisa County,51109,"White, Not Hispanic or Latino ",11149,9306,1843,331,385,311
2021,Lunenburg County,51111,"White, Not Hispanic or Latino ",2574,1979,595,178,162,152
2021,Madison County,51113,"White, Not Hispanic or Latino ",4396,3536,860,247,279,202
2021,Mathews County,51115,"White, Not Hispanic or Latino ",3082,2675,407,238,209,156
2021,Mecklenburg County,51117,"White, Not Hispanic or Latino ",8448,6754,1694,224,297,303
2021,Middlesex County,51119,"White, Not Hispanic or Latino ",3633,3166,467,225,197,129
2021,Montgomery County,51121,"White, Not Hispanic or Latino ",30631,18229,12402,732,609,673
2021,Nelson County,51125,"White, Not Hispanic or Latino ",4909,3892,1017,317,270,280
2021,New Kent County,51127,"White, Not Hispanic or Latino ",6551,5906,645,264,292,197
2021,Northampton County,51131,"White, Not Hispanic or Latino ",3189,2333,856,134,168,160
2021,Northumberland County,51133,"White, Not Hispanic or Latino ",3918,3529,389,274,258,150
2021,Nottoway County,51135,"White, Not Hispanic or Latino ",3193,2637,556,221,234,164
2021,Orange County,51137,"White, Not Hispanic or Latino ",11164,9001,2163,386,491,407
2021,Page County,51139,"White, Not Hispanic or Latino ",8829,6300,2529,268,324,355
2021,Patrick County,51141,"White, Not Hispanic or Latino ",7115,5661,1454,310,337,261
2021,Pittsylvania County,51143,"White, Not Hispanic or Latino ",18825,14954,3871,382,540,453
2021,Powhatan County,51145,"White, Not Hispanic or Latino ",9621,8969,652,284,372,227
2021,Prince Edward County,51147,"White, Not Hispanic or Latino ",4369,2985,1384,272,216,269
2021,Prince George County,51149,"White, Not Hispanic or Latino ",7487,6154,1333,338,353,272
2021,Prince William County,51153,"White, Not Hispanic or Latino ",71331,57788,13543,749,891,850
2021,Pulaski County,51155,"White, Not Hispanic or Latino ",13453,9477,3976,384,406,446
2021,Rappahannock County,51157,"White, Not Hispanic or Latino ",2510,1898,612,139,197,152
2021,Richmond County,51159,"White, Not Hispanic or Latino ",1939,1455,484,157,193,168
2021,Roanoke County,51161,"White, Not Hispanic or Latino ",34763,27115,7648,445,568,601
2021,Rockbridge County,51163,"White, Not Hispanic or Latino ",8606,6609,1997,346,334,338
2021,Rockingham County,51165,"White, Not Hispanic or Latino ",28628,22037,6591,425,524,526
2021,Russell County,51167,"White, Not Hispanic or Latino ",10070,7643,2427,319,395,367
2021,Scott County,51169,"White, Not Hispanic or Latino ",8499,6858,1641,268,259,224
2021,Shenandoah County,51171,"White, Not Hispanic or Latino ",15931,11943,3988,294,421,434
2021,Smyth County,51173,"White, Not Hispanic or Latino ",12003,8431,3572,283,345,327
2021,Southampton County,51175,"White, Not Hispanic or Latino ",4180,3414,766,191,221,155
2021,Spotsylvania County,51177,"White, Not Hispanic or Latino ",33455,27704,5751,577,645,556
2021,Stafford County,51179,"White, Not Hispanic or Latino ",31075,25769,5306,522,598,584
2021,Surry County,51181,"White, Not Hispanic or Latino ",1565,1251,314,92,116,111
2021,Sussex County,51183,"White, Not Hispanic or Latino ",1616,1341,275,129,135,99
2021,Tazewell County,51185,"White, Not Hispanic or Latino ",15070,11442,3628,459,471,409
2021,Warren County,51187,"White, Not Hispanic or Latino ",13356,10331,3025,362,439,392
2021,Washington County,51191,"White, Not Hispanic or Latino ",21071,16041,5030,409,465,470
2021,Westmoreland County,51193,"White, Not Hispanic or Latino ",5434,4326,1108,317,318,266
2021,Wise County,51195,"White, Not Hispanic or Latino ",13607,9815,3792,437,422,382
2021,Wythe County,51197,"White, Not Hispanic or Latino ",11521,8997,2524,316,409,330
2021,York County,51199,"White, Not Hispanic or Latino ",18571,14377,4194,380,419,434
2021,Alexandria city,51510,"White, Not Hispanic or Latino ",43391,24002,19389,673,647,743
2021,Bristol city,51520,"White, Not Hispanic or Latino ",6544,4197,2347,279,319,303
2021,Buena Vista city,51530,"White, Not Hispanic or Latino ",2309,1317,992,162,202,225
2021,Charlottesville city,51540,"White, Not Hispanic or Latino ",13685,6481,7204,380,362,495
2021,Chesapeake city,51550,"White, Not Hispanic or Latino ",53071,43048,10023,758,854,790
2021,Colonial Heights city,51570,"White, Not Hispanic or Latino ",5618,4242,1376,219,257,204
2021,Covington city,51580,"White, Not Hispanic or Latino ",2171,1717,454,156,178,141
2021,Danville city,51590,"White, Not Hispanic or Latino ",8285,5508,2777,295,293,270
2021,Emporia city,51595,"White, Not Hispanic or Latino ",495,367,128,107,105,78
2021,Fairfax city,51600,"White, Not Hispanic or Latino ",5456,4052,1404,187,260,218
2021,Falls Church city,51610,"White, Not Hispanic or Latino ",4339,2654,1685,175,192,216
2021,Franklin city,51620,"White, Not Hispanic or Latino ",1305,1055,250,127,170,136
2021,Fredericksburg city,51630,"White, Not Hispanic or Latino ",7224,3178,4046,396,251,392
2021,Galax city,51640,"White, Not Hispanic or Latino ",2279,1692,587,226,204,171
2021,Hampton city,51650,"White, Not Hispanic or Latino ",22023,14965,7058,613,614,497
2021,Harrisonburg city,51660,"White, Not Hispanic or Latino ",11779,4961,6818,457,388,445
2021,Hopewell city,51670,"White, Not Hispanic or Latino ",4282,2827,1455,223,283,285
2021,Lexington city,51678,"White, Not Hispanic or Latino ",1625,897,728,265,201,181
2021,Lynchburg city,51680,"White, Not Hispanic or Latino ",18408,10793,7615,550,438,486
2021,Manassas city,51683,"White, Not Hispanic or Latino ",6977,5153,1824,280,329,270
2021,Manassas Park city,51685,"White, Not Hispanic or Latino ",2119,1358,761,176,219,194
2021,Martinsville city,51690,"White, Not Hispanic or Latino ",2565,2036,529,164,163,134
2021,Newport News city,51700,"White, Not Hispanic or Latino ",33507,21131,12376,624,628,800
2021,Norfolk city,51710,"White, Not Hispanic or Latino ",44123,24696,19427,1014,703,1068
2021,Norton city,51720,"White, Not Hispanic or Latino ",1504,852,652,153,166,163
2021,Petersburg city,51730,"White, Not Hispanic or Latino ",2381,1167,1214,183,144,192
2021,Poquoson city,51735,"White, Not Hispanic or Latino ",4218,3471,747,157,191,166
2021,Portsmouth city,51740,"White, Not Hispanic or Latino ",15662,10780,4882,476,468,489
2021,Radford city,51750,"White, Not Hispanic or Latino ",5010,2366,2644,212,225,292
2021,Richmond city,51760,"White, Not Hispanic or Latino ",47234,25164,22070,716,716,949
2021,Roanoke city,51770,"White, Not Hispanic or Latino ",26743,15993,10750,615,667,725
2021,Salem city,51775,"White, Not Hispanic or Latino ",8687,6076,2611,283,292,343
2021,Staunton city,51790,"White, Not Hispanic or Latino ",9656,5860,3796,269,313,316
2021,Suffolk city,51800,"White, Not Hispanic or Latino ",18032,14376,3656,373,458,421
2021,Virginia Beach city,51810,"White, Not Hispanic or Latino ",115653,83311,32342,967,1250,1159
2021,Waynesboro city,51820,"White, Not Hispanic or Latino ",7433,4964,2469,341,401,331
2021,Williamsburg city,51830,"White, Not Hispanic or Latino ",3579,2164,1415,262,189,276
2021,Winchester city,51840,"White, Not Hispanic or Latino ",8274,4264,4010,331,311,349
2010,Accomack County,51001,Hispanic or Latino ,659,83,576,164,77,164
2010,Albemarle County,51003,Hispanic or Latino ,1195,524,671,184,168,159
2010,Alleghany County,51005,Hispanic or Latino ,17,17,0,26,26,127
2010,Amelia County,51007,Hispanic or Latino ,47,22,25,54,37,38
2010,Amherst County,51009,Hispanic or Latino ,155,43,112,89,45,84
2010,Appomattox County,51011,Hispanic or Latino ,7,7,0,12,12,127
2010,Arlington County,51013,Hispanic or Latino ,9572,3062,6510,534,355,442
2010,Augusta County,51015,Hispanic or Latino ,422,289,133,112,92,100
2010,Bath County,51017,Hispanic or Latino ,0,0,0,127,127,127
2010,Bedford County,51019,Hispanic or Latino ,223,174,49,73,61,67
2010,Bland County,51021,Hispanic or Latino ,0,0,0,127,127,127
2010,Botetourt County,51023,Hispanic or Latino ,151,60,91,68,72,50
2010,Brunswick County,51025,Hispanic or Latino ,21,0,21,23,127,23
2010,Buchanan County,51027,Hispanic or Latino ,6,6,0,12,12,127
2010,Buckingham County,51029,Hispanic or Latino ,0,0,0,127,127,127
2010,Campbell County,51031,Hispanic or Latino ,300,152,148,130,111,125
2010,Caroline County,51033,Hispanic or Latino ,272,201,71,79,94,35
2010,Carroll County,51035,Hispanic or Latino ,208,0,208,187,127,187
2010,Charles City County,51036,Hispanic or Latino ,10,8,2,11,8,6
2010,Charlotte County,51037,Hispanic or Latino ,13,0,13,21,127,21
2010,Chesterfield County,51041,Hispanic or Latino ,5243,2666,2577,284,293,302
2010,Clarke County,51043,Hispanic or Latino ,143,85,58,28,51,37
2010,Craig County,51045,Hispanic or Latino ,0,0,0,127,127,127
2010,Culpeper County,51047,Hispanic or Latino ,837,382,455,156,119,113
2010,Cumberland County,51049,Hispanic or Latino ,98,98,0,128,128,127
2010,Dickenson County,51051,Hispanic or Latino ,3,3,0,5,5,127
2010,Dinwiddie County,51053,Hispanic or Latino ,169,65,104,92,64,124
2010,Essex County,51057,Hispanic or Latino ,94,15,79,28,17,40
2010,Fairfax County,51059,Hispanic or Latino ,40323,23056,17267,929,910,893
2010,Fauquier County,51061,Hispanic or Latino ,931,445,486,114,130,125
2010,Floyd County,51063,Hispanic or Latino ,133,41,92,62,18,57
2010,Fluvanna County,51065,Hispanic or Latino ,310,245,65,135,149,59
2010,Franklin County,51067,Hispanic or Latino ,362,112,250,86,71,94
2010,Frederick County,51069,Hispanic or Latino ,1268,732,536,177,170,241
2010,Giles County,51071,Hispanic or Latino ,43,32,11,26,29,17
2010,Gloucester County,51073,Hispanic or Latino ,298,249,49,97,102,56
2010,Goochland County,51075,Hispanic or Latino ,151,43,108,70,54,63
2010,Grayson County,51077,Hispanic or Latino ,57,54,3,34,35,7
2010,Greene County,51079,Hispanic or Latino ,165,65,100,43,66,96
2010,Greensville County,51081,Hispanic or Latino ,16,3,13,17,8,13
2010,Halifax County,51083,Hispanic or Latino ,152,95,57,56,34,58
2010,Hanover County,51085,Hispanic or Latino ,496,354,142,87,85,70
2010,Henrico County,51087,Hispanic or Latino ,3462,1186,2276,231,194,250
2010,Henry County,51089,Hispanic or Latino ,610,264,346,122,116,88
2010,Highland County,51091,Hispanic or Latino ,0,0,0,127,127,127
2010,Isle of Wight County,51093,Hispanic or Latino ,224,165,59,64,51,57
2010,James City County,51095,Hispanic or Latino ,582,302,280,108,131,85
2010,King and Queen County,51097,Hispanic or Latino ,33,14,19,24,22,25
2010,King George County,51099,Hispanic or Latino ,263,131,132,86,72,78
2010,King William County,51101,Hispanic or Latino ,87,50,37,36,42,42
2010,Lancaster County,51103,Hispanic or Latino ,27,24,3,25,24,5
2010,Lee County,51105,Hispanic or Latino ,60,34,26,43,35,30
2010,Loudoun County,51107,Hispanic or Latino ,8077,5394,2683,462,496,324
2010,Louisa County,51109,Hispanic or Latino ,137,87,50,50,61,32
2010,Lunenburg County,51111,Hispanic or Latino ,105,0,105,48,127,48
2010,Madison County,51113,Hispanic or Latino ,46,46,0,65,65,127
2010,Mathews County,51115,Hispanic or Latino ,14,0,14,17,127,17
2010,Mecklenburg County,51117,Hispanic or Latino ,118,43,75,74,40,58
2010,Middlesex County,51119,Hispanic or Latino ,30,23,7,36,41,13
2010,Montgomery County,51121,Hispanic or Latino ,652,185,467,139,91,119
2010,Nelson County,51125,Hispanic or Latino ,161,87,74,67,74,80
2010,New Kent County,51127,Hispanic or Latino ,29,29,0,33,33,127
2010,Northampton County,51131,Hispanic or Latino ,122,49,73,71,51,62
2010,Northumberland County,51133,Hispanic or Latino ,7,7,0,11,11,127
2010,Nottoway County,51135,Hispanic or Latino ,25,1,24,20,5,20
2010,Orange County,51137,Hispanic or Latino ,279,176,103,103,114,48
2010,Page County,51139,Hispanic or Latino ,68,30,38,48,46,33
2010,Patrick County,51141,Hispanic or Latino ,84,35,49,26,32,30
2010,Pittsylvania County,51143,Hispanic or Latino ,184,113,71,185,83,118
2010,Powhatan County,51145,Hispanic or Latino ,238,175,63,121,163,91
2010,Prince Edward County,51147,Hispanic or Latino ,76,22,54,60,26,55
2010,Prince George County,51149,Hispanic or Latino ,249,117,132,131,93,97
2010,Prince William County,51153,Hispanic or Latino ,18301,11856,6445,521,575,561
2010,Pulaski County,51155,Hispanic or Latino ,229,59,170,103,36,110
2010,Rappahannock County,51157,Hispanic or Latino ,83,13,70,85,17,82
2010,Richmond County,51159,Hispanic or Latino ,44,0,44,22,127,22
2010,Roanoke County,51161,Hispanic or Latino ,465,174,291,76,65,80
2010,Rockbridge County,51163,Hispanic or Latino ,14,4,10,15,6,14
2010,Rockingham County,51165,Hispanic or Latino ,1000,439,561,145,157,148
2010,Russell County,51167,Hispanic or Latino ,13,13,0,24,24,127
2010,Scott County,51169,Hispanic or Latino ,7,0,7,15,127,15
2010,Shenandoah County,51171,Hispanic or Latino ,528,277,251,95,90,129
2010,Smyth County,51173,Hispanic or Latino ,108,46,62,68,49,49
2010,Southampton County,51175,Hispanic or Latino ,54,9,45,58,16,55
2010,Spotsylvania County,51177,Hispanic or Latino ,2257,1921,336,242,281,144
2010,Stafford County,51179,Hispanic or Latino ,2531,1863,668,172,224,154
2010,Surry County,51181,Hispanic or Latino ,15,15,0,14,14,127
2010,Sussex County,51183,Hispanic or Latino ,24,0,24,26,127,26
2010,Tazewell County,51185,Hispanic or Latino ,25,25,0,23,23,127
2010,Warren County,51187,Hispanic or Latino ,307,143,164,102,102,93
2010,Washington County,51191,Hispanic or Latino ,235,154,81,109,118,64
2010,Westmoreland County,51193,Hispanic or Latino ,170,125,45,49,55,30
2010,Wise County,51195,Hispanic or Latino ,133,48,85,35,30,52
2010,Wythe County,51197,Hispanic or Latino ,38,32,6,17,16,20
2010,York County,51199,Hispanic or Latino ,482,262,220,245,132,144
2010,Alexandria city,51510,Hispanic or Latino ,6721,1903,4818,431,314,445
2010,Bedford County,51019,Hispanic or Latino ,53,53,0,69,69,127
2010,Bristol city,51520,Hispanic or Latino ,27,27,0,34,34,127
2010,Buena Vista city,51530,Hispanic or Latino ,13,13,0,24,24,127
2010,Charlottesville city,51540,Hispanic or Latino ,422,90,332,112,63,104
2010,Chesapeake city,51550,Hispanic or Latino ,2416,1383,1033,223,253,251
2010,Colonial Heights city,51570,Hispanic or Latino ,131,15,116,46,25,53
2010,Covington city,51580,Hispanic or Latino ,6,0,6,10,127,10
2010,Danville city,51590,Hispanic or Latino ,322,104,218,62,65,91
2010,Emporia city,51595,Hispanic or Latino ,38,0,38,40,127,40
2010,Fairfax city,51600,Hispanic or Latino ,804,482,322,105,99,115
2010,Falls Church city,51610,Hispanic or Latino ,344,148,196,102,91,88
2010,Franklin city,51620,Hispanic or Latino ,22,0,22,38,127,38
2010,Fredericksburg city,51630,Hispanic or Latino ,487,115,372,123,75,104
2010,Galax city,51640,Hispanic or Latino ,488,290,198,168,210,127
2010,Hampton city,51650,Hispanic or Latino ,2102,912,1190,254,240,254
2010,Harrisonburg city,51660,Hispanic or Latino ,1841,271,1570,197,118,228
2010,Hopewell city,51670,Hispanic or Latino ,385,123,262,93,104,130
2010,Lexington city,51678,Hispanic or Latino ,86,0,86,117,127,117
2010,Lynchburg city,51680,Hispanic or Latino ,586,200,386,164,80,134
2010,Manassas city,51683,Hispanic or Latino ,2407,1214,1193,215,223,228
2010,Manassas Park city,51685,Hispanic or Latino ,1087,951,136,140,127,71
2010,Martinsville city,51690,Hispanic or Latino ,139,25,114,79,42,61
2010,Newport News city,51700,Hispanic or Latino ,3413,1542,1871,352,296,335
2010,Norfolk city,51710,Hispanic or Latino ,4013,1029,2984,395,179,352
2010,Norton city,51720,Hispanic or Latino ,0,0,0,127,127,127
2010,Petersburg city,51730,Hispanic or Latino ,260,39,221,60,33,63
2010,Poquoson city,51735,Hispanic or Latino ,20,0,20,23,127,23
2010,Portsmouth city,51740,Hispanic or Latino ,700,441,259,166,118,139
2010,Radford city,51750,Hispanic or Latino ,59,10,49,37,20,37
2010,Richmond city,51760,Hispanic or Latino ,2881,666,2215,248,169,221
2010,Roanoke city,51770,Hispanic or Latino ,1352,343,1009,193,130,189
2010,Salem city,51775,Hispanic or Latino ,152,55,97,29,57,41
2010,Staunton city,51790,Hispanic or Latino ,121,40,81,57,49,54
2010,Suffolk city,51800,Hispanic or Latino ,674,494,180,153,159,115
2010,Virginia Beach city,51810,Hispanic or Latino ,7381,4072,3309,448,333,375
2010,Waynesboro city,51820,Hispanic or Latino ,384,52,332,145,46,163
2010,Williamsburg city,51830,Hispanic or Latino ,68,0,68,54,127,54
2010,Winchester city,51840,Hispanic or Latino ,772,228,544,135,98,127
2011,Accomack County,51001,Hispanic or Latino ,647,55,592,159,52,161
2011,Albemarle County,51003,Hispanic or Latino ,1221,497,724,230,160,208
2011,Alleghany County,51005,Hispanic or Latino ,43,23,20,40,25,32
2011,Amelia County,51007,Hispanic or Latino ,44,18,26,53,32,44
2011,Amherst County,51009,Hispanic or Latino ,122,62,60,69,65,55
2011,Appomattox County,51011,Hispanic or Latino ,10,10,0,16,16,95
2011,Arlington County,51013,Hispanic or Latino ,9704,3144,6560,484,410,540
2011,Augusta County,51015,Hispanic or Latino ,335,224,111,105,101,68
2011,Bath County,51017,Hispanic or Latino ,12,12,0,32,32,95
2011,Bedford County,51019,Hispanic or Latino ,219,171,48,71,63,69
2011,Bland County,51021,Hispanic or Latino ,0,0,0,95,95,95
2011,Botetourt County,51023,Hispanic or Latino ,102,52,50,50,44,48
2011,Brunswick County,51025,Hispanic or Latino ,40,20,20,41,31,26
2011,Buchanan County,51027,Hispanic or Latino ,15,8,7,22,15,16
2011,Buckingham County,51029,Hispanic or Latino ,0,0,0,95,95,95
2011,Campbell County,51031,Hispanic or Latino ,295,132,163,91,78,104
2011,Caroline County,51033,Hispanic or Latino ,252,187,65,73,77,33
2011,Carroll County,51035,Hispanic or Latino ,191,24,167,134,32,141
2011,Charles City County,51036,Hispanic or Latino ,6,4,2,11,9,4
2011,Charlotte County,51037,Hispanic or Latino ,8,0,8,12,95,12
2011,Chesterfield County,51041,Hispanic or Latino ,5536,2819,2717,242,306,298
2011,Clarke County,51043,Hispanic or Latino ,140,93,47,31,38,30
2011,Craig County,51045,Hispanic or Latino ,0,0,0,95,95,95
2011,Culpeper County,51047,Hispanic or Latino ,762,346,416,222,177,144
2011,Cumberland County,51049,Hispanic or Latino ,65,65,0,90,90,95
2011,Dickenson County,51051,Hispanic or Latino ,3,3,0,6,6,95
2011,Dinwiddie County,51053,Hispanic or Latino ,143,81,62,71,39,76
2011,Essex County,51057,Hispanic or Latino ,89,25,64,28,17,38
2011,Fairfax County,51059,Hispanic or Latino ,42045,22794,19251,961,966,1027
2011,Fauquier County,51061,Hispanic or Latino ,941,465,476,99,110,120
2011,Floyd County,51063,Hispanic or Latino ,127,28,99,89,20,95
2011,Fluvanna County,51065,Hispanic or Latino ,351,273,78,133,142,76
2011,Franklin County,51067,Hispanic or Latino ,368,132,236,99,88,109
2011,Frederick County,51069,Hispanic or Latino ,1349,773,576,217,213,244
2011,Giles County,51071,Hispanic or Latino ,42,26,16,16,24,20
2011,Gloucester County,51073,Hispanic or Latino ,344,239,105,107,116,87
2011,Goochland County,51075,Hispanic or Latino ,105,105,0,91,91,95
2011,Grayson County,51077,Hispanic or Latino ,63,59,4,43,45,8
2011,Greene County,51079,Hispanic or Latino ,155,81,74,50,65,86
2011,Greensville County,51081,Hispanic or Latino ,34,15,19,30,18,25
2011,Halifax County,51083,Hispanic or Latino ,123,78,45,45,29,51
2011,Hanover County,51085,Hispanic or Latino ,561,460,101,88,86,61
2011,Henrico County,51087,Hispanic or Latino ,3653,1304,2349,258,209,246
2011,Henry County,51089,Hispanic or Latino ,649,263,386,109,92,122
2011,Highland County,51091,Hispanic or Latino ,0,0,0,95,95,95
2011,Isle of Wight County,51093,Hispanic or Latino ,157,88,69,50,58,36
2011,James City County,51095,Hispanic or Latino ,801,375,426,158,123,174
2011,King and Queen County,51097,Hispanic or Latino ,40,17,23,19,18,22
2011,King George County,51099,Hispanic or Latino ,322,163,159,92,135,91
2011,King William County,51101,Hispanic or Latino ,125,74,51,58,75,40
2011,Lancaster County,51103,Hispanic or Latino ,64,23,41,26,34,35
2011,Lee County,51105,Hispanic or Latino ,44,38,6,82,71,15
2011,Loudoun County,51107,Hispanic or Latino ,8306,5025,3281,473,474,443
2011,Louisa County,51109,Hispanic or Latino ,166,110,56,63,78,41
2011,Lunenburg County,51111,Hispanic or Latino ,137,0,137,55,95,55
2011,Madison County,51113,Hispanic or Latino ,42,42,0,61,61,95
2011,Mathews County,51115,Hispanic or Latino ,11,0,11,17,95,17
2011,Mecklenburg County,51117,Hispanic or Latino ,96,44,52,67,48,48
2011,Middlesex County,51119,Hispanic or Latino ,19,12,7,18,16,9
2011,Montgomery County,51121,Hispanic or Latino ,672,209,463,136,91,126
2011,Nelson County,51125,Hispanic or Latino ,156,70,86,79,77,95
2011,New Kent County,51127,Hispanic or Latino ,48,48,0,44,44,95
2011,Northampton County,51131,Hispanic or Latino ,137,37,100,65,54,52
2011,Northumberland County,51133,Hispanic or Latino ,6,6,0,10,10,95
2011,Nottoway County,51135,Hispanic or Latino ,40,8,32,22,11,18
2011,Orange County,51137,Hispanic or Latino ,264,168,96,105,124,47
2011,Page County,51139,Hispanic or Latino ,68,38,30,30,33,29
2011,Patrick County,51141,Hispanic or Latino ,76,46,30,25,28,20
2011,Pittsylvania County,51143,Hispanic or Latino ,251,148,103,62,67,50
2011,Powhatan County,51145,Hispanic or Latino ,133,95,38,74,96,51
2011,Prince Edward County,51147,Hispanic or Latino ,149,44,105,90,51,69
2011,Prince George County,51149,Hispanic or Latino ,345,220,125,127,107,84
2011,Prince William County,51153,Hispanic or Latino ,18458,11605,6853,635,648,536
2011,Pulaski County,51155,Hispanic or Latino ,222,41,181,96,37,103
2011,Rappahannock County,51157,Hispanic or Latino ,123,26,97,104,27,101
2011,Richmond County,51159,Hispanic or Latino ,56,0,56,21,95,21
2011,Roanoke County,51161,Hispanic or Latino ,519,197,322,96,70,115
2011,Rockbridge County,51163,Hispanic or Latino ,12,6,6,31,15,20
2011,Rockingham County,51165,Hispanic or Latino ,998,445,553,128,121,163
2011,Russell County,51167,Hispanic or Latino ,12,12,0,21,21,95
2011,Scott County,51169,Hispanic or Latino ,20,15,5,30,25,10
2011,Shenandoah County,51171,Hispanic or Latino ,495,241,254,97,80,98
2011,Smyth County,51173,Hispanic or Latino ,155,78,77,60,56,56
2011,Southampton County,51175,Hispanic or Latino ,53,10,43,31,16,27
2011,Spotsylvania County,51177,Hispanic or Latino ,2348,1908,440,237,208,168
2011,Stafford County,51179,Hispanic or Latino ,2681,1869,812,182,214,169
2011,Surry County,51181,Hispanic or Latino ,18,10,8,17,18,7
2011,Sussex County,51183,Hispanic or Latino ,13,0,13,19,95,19
2011,Tazewell County,51185,Hispanic or Latino ,66,31,35,60,28,52
2011,Warren County,51187,Hispanic or Latino ,323,173,150,88,110,102
2011,Washington County,51191,Hispanic or Latino ,274,157,117,124,148,86
2011,Westmoreland County,51193,Hispanic or Latino ,138,83,55,37,36,31
2011,Wise County,51195,Hispanic or Latino ,112,50,62,43,27,49
2011,Wythe County,51197,Hispanic or Latino ,77,27,50,69,20,73
2011,York County,51199,Hispanic or Latino ,710,378,332,139,136,109
2011,Alexandria city,51510,Hispanic or Latino ,6890,1790,5100,420,292,421
2011,Bedford County,51019,Hispanic or Latino ,35,35,0,59,59,95
2011,Bristol city,51520,Hispanic or Latino ,43,14,29,45,23,38
2011,Buena Vista city,51530,Hispanic or Latino ,0,0,0,95,95,95
2011,Charlottesville city,51540,Hispanic or Latino ,432,142,290,77,65,86
2011,Chesapeake city,51550,Hispanic or Latino ,2458,1428,1030,239,274,207
2011,Colonial Heights city,51570,Hispanic or Latino ,139,11,128,64,21,64
2011,Covington city,51580,Hispanic or Latino ,0,0,0,95,95,95
2011,Danville city,51590,Hispanic or Latino ,324,83,241,64,36,74
2011,Emporia city,51595,Hispanic or Latino ,44,0,44,55,95,55
2011,Fairfax city,51600,Hispanic or Latino ,881,445,436,91,113,120
2011,Falls Church city,51610,Hispanic or Latino ,276,66,210,95,46,82
2011,Franklin city,51620,Hispanic or Latino ,17,0,17,28,95,28
2011,Fredericksburg city,51630,Hispanic or Latino ,628,132,496,133,89,139
2011,Galax city,51640,Hispanic or Latino ,397,214,183,176,181,138
2011,Hampton city,51650,Hispanic or Latino ,1932,888,1044,232,215,250
2011,Harrisonburg city,51660,Hispanic or Latino ,1880,366,1514,210,137,254
2011,Hopewell city,51670,Hispanic or Latino ,439,92,347,148,80,150
2011,Lexington city,51678,Hispanic or Latino ,53,0,53,82,95,82
2011,Lynchburg city,51680,Hispanic or Latino ,686,173,513,138,84,138
2011,Manassas city,51683,Hispanic or Latino ,2673,1288,1385,230,239,280
2011,Manassas Park city,51685,Hispanic or Latino ,1072,859,213,145,126,94
2011,Martinsville city,51690,Hispanic or Latino ,143,23,120,90,48,71
2011,Newport News city,51700,Hispanic or Latino ,3457,1450,2007,284,213,314
2011,Norfolk city,51710,Hispanic or Latino ,4072,1170,2902,420,216,394
2011,Norton city,51720,Hispanic or Latino ,0,0,0,95,95,95
2011,Petersburg city,51730,Hispanic or Latino ,317,45,272,69,19,62
2011,Poquoson city,51735,Hispanic or Latino ,33,17,16,23,21,20
2011,Portsmouth city,51740,Hispanic or Latino ,835,470,365,120,127,140
2011,Radford city,51750,Hispanic or Latino ,58,18,40,60,29,51
2011,Richmond city,51760,Hispanic or Latino ,3112,578,2534,266,149,228
2011,Roanoke city,51770,Hispanic or Latino ,1518,359,1159,159,113,161
2011,Salem city,51775,Hispanic or Latino ,99,42,57,79,52,54
2011,Staunton city,51790,Hispanic or Latino ,111,55,56,68,56,51
2011,Suffolk city,51800,Hispanic or Latino ,714,428,286,144,153,159
2011,Virginia Beach city,51810,Hispanic or Latino ,7813,4038,3775,371,342,414
2011,Waynesboro city,51820,Hispanic or Latino ,367,76,291,113,58,130
2011,Williamsburg city,51830,Hispanic or Latino ,176,0,176,103,95,103
2011,Winchester city,51840,Hispanic or Latino ,740,175,565,152,82,126
2012,Accomack County,51001,Hispanic or Latino ,750,122,628,130,104,138
2012,Albemarle County,51003,Hispanic or Latino ,1276,527,749,206,162,168
2012,Alleghany County,51005,Hispanic or Latino ,65,21,44,47,21,42
2012,Amelia County,51007,Hispanic or Latino ,0,0,0,19,19,19
2012,Amherst County,51009,Hispanic or Latino ,66,29,37,49,33,33
2012,Appomattox County,51011,Hispanic or Latino ,6,6,0,10,10,19
2012,Arlington County,51013,Hispanic or Latino ,9673,3148,6525,436,349,405
2012,Augusta County,51015,Hispanic or Latino ,294,164,130,82,71,80
2012,Bath County,51017,Hispanic or Latino ,20,20,0,34,34,12
2012,Bedford County,51019,Hispanic or Latino ,160,145,15,48,53,25
2012,Bland County,51021,Hispanic or Latino ,0,0,0,17,17,17
2012,Botetourt County,51023,Hispanic or Latino ,107,56,51,44,38,46
2012,Brunswick County,51025,Hispanic or Latino ,34,7,27,31,15,22
2012,Buchanan County,51027,Hispanic or Latino ,16,8,8,25,17,19
2012,Buckingham County,51029,Hispanic or Latino ,0,0,0,19,19,19
2012,Campbell County,51031,Hispanic or Latino ,277,135,142,93,64,111
2012,Caroline County,51033,Hispanic or Latino ,269,212,57,97,94,38
2012,Carroll County,51035,Hispanic or Latino ,162,24,138,136,38,125
2012,Charles City County,51036,Hispanic or Latino ,23,20,3,21,20,5
2012,Charlotte County,51037,Hispanic or Latino ,33,18,15,22,24,16
2012,Chesterfield County,51041,Hispanic or Latino ,5964,3170,2794,355,368,294
2012,Clarke County,51043,Hispanic or Latino ,154,100,54,46,42,54
2012,Craig County,51045,Hispanic or Latino ,0,0,0,17,17,17
2012,Culpeper County,51047,Hispanic or Latino ,834,341,493,196,157,127
2012,Cumberland County,51049,Hispanic or Latino ,56,49,7,70,70,11
2012,Dickenson County,51051,Hispanic or Latino ,15,5,10,18,10,15
2012,Dinwiddie County,51053,Hispanic or Latino ,129,78,51,51,49,55
2012,Essex County,51057,Hispanic or Latino ,91,27,64,31,21,45
2012,Fairfax County,51059,Hispanic or Latino ,43170,21970,21200,891,907,771
2012,Fauquier County,51061,Hispanic or Latino ,974,570,404,134,118,124
2012,Floyd County,51063,Hispanic or Latino ,113,34,79,68,21,73
2012,Fluvanna County,51065,Hispanic or Latino ,168,139,29,86,83,49
2012,Franklin County,51067,Hispanic or Latino ,435,166,269,79,88,121
2012,Frederick County,51069,Hispanic or Latino ,1441,950,491,203,192,227
2012,Giles County,51071,Hispanic or Latino ,39,15,24,23,22,25
2012,Gloucester County,51073,Hispanic or Latino ,297,202,95,75,65,47
2012,Goochland County,51075,Hispanic or Latino ,97,97,0,62,62,23
2012,Grayson County,51077,Hispanic or Latino ,95,83,12,47,52,18
2012,Greene County,51079,Hispanic or Latino ,197,117,80,58,79,85
2012,Greensville County,51081,Hispanic or Latino ,9,5,4,13,12,5
2012,Halifax County,51083,Hispanic or Latino ,149,89,60,58,30,45
2012,Hanover County,51085,Hispanic or Latino ,588,455,133,79,108,85
2012,Henrico County,51087,Hispanic or Latino ,3896,1500,2396,240,255,228
2012,Henry County,51089,Hispanic or Latino ,640,258,382,115,89,121
2012,Highland County,51091,Hispanic or Latino ,0,0,0,12,12,12
2012,Isle of Wight County,51093,Hispanic or Latino ,158,81,77,50,61,40
2012,James City County,51095,Hispanic or Latino ,812,376,436,169,141,201
2012,King and Queen County,51097,Hispanic or Latino ,52,24,28,20,24,20
2012,King George County,51099,Hispanic or Latino ,263,169,94,92,127,69
2012,King William County,51101,Hispanic or Latino ,77,39,38,23,35,34
2012,Lancaster County,51103,Hispanic or Latino ,43,6,37,51,9,48
2012,Lee County,51105,Hispanic or Latino ,29,25,4,81,66,17
2012,Loudoun County,51107,Hispanic or Latino ,9369,4875,4494,426,480,386
2012,Louisa County,51109,Hispanic or Latino ,166,89,77,47,45,43
2012,Lunenburg County,51111,Hispanic or Latino ,124,27,97,45,26,43
2012,Madison County,51113,Hispanic or Latino ,2,2,0,16,16,19
2012,Mathews County,51115,Hispanic or Latino ,11,0,11,14,17,14
2012,Mecklenburg County,51117,Hispanic or Latino ,158,108,50,75,61,39
2012,Middlesex County,51119,Hispanic or Latino ,30,18,12,24,25,13
2012,Montgomery County,51121,Hispanic or Latino ,786,179,607,111,80,120
2012,Nelson County,51125,Hispanic or Latino ,67,27,40,75,32,67
2012,New Kent County,51127,Hispanic or Latino ,41,41,0,42,42,19
2012,Northampton County,51131,Hispanic or Latino ,164,73,91,64,66,41
2012,Northumberland County,51133,Hispanic or Latino ,17,17,0,20,20,19
2012,Nottoway County,51135,Hispanic or Latino ,91,45,46,75,52,52
2012,Orange County,51137,Hispanic or Latino ,317,218,99,113,143,59
2012,Page County,51139,Hispanic or Latino ,100,35,65,34,39,29
2012,Patrick County,51141,Hispanic or Latino ,88,56,32,30,42,33
2012,Pittsylvania County,51143,Hispanic or Latino ,279,162,117,63,64,58
2012,Powhatan County,51145,Hispanic or Latino ,72,54,18,34,37,23
2012,Prince Edward County,51147,Hispanic or Latino ,119,62,57,68,70,53
2012,Prince George County,51149,Hispanic or Latino ,318,174,144,94,82,84
2012,Prince William County,51153,Hispanic or Latino ,18663,11240,7423,580,605,586
2012,Pulaski County,51155,Hispanic or Latino ,182,64,118,71,54,94
2012,Rappahannock County,51157,Hispanic or Latino ,101,76,25,71,87,27
2012,Richmond County,51159,Hispanic or Latino ,62,0,62,38,17,38
2012,Roanoke County,51161,Hispanic or Latino ,476,202,274,83,78,107
2012,Rockbridge County,51163,Hispanic or Latino ,20,9,11,28,14,20
2012,Rockingham County,51165,Hispanic or Latino ,966,545,421,110,128,141
2012,Russell County,51167,Hispanic or Latino ,53,11,42,88,20,85
2012,Scott County,51169,Hispanic or Latino ,25,25,0,42,42,23
2012,Shenandoah County,51171,Hispanic or Latino ,557,243,314,103,89,133
2012,Smyth County,51173,Hispanic or Latino ,139,69,70,56,48,42
2012,Southampton County,51175,Hispanic or Latino ,43,7,36,23,13,22
2012,Spotsylvania County,51177,Hispanic or Latino ,2436,1854,582,216,220,170
2012,Stafford County,51179,Hispanic or Latino ,2787,1821,966,196,198,173
2012,Surry County,51181,Hispanic or Latino ,19,11,8,19,22,7
2012,Sussex County,51183,Hispanic or Latino ,45,0,45,35,19,35
2012,Tazewell County,51185,Hispanic or Latino ,98,36,62,42,44,66
2012,Warren County,51187,Hispanic or Latino ,301,161,140,83,87,73
2012,Washington County,51191,Hispanic or Latino ,258,186,72,74,51,66
2012,Westmoreland County,51193,Hispanic or Latino ,129,110,19,43,45,26
2012,Wise County,51195,Hispanic or Latino ,63,22,41,34,23,26
2012,Wythe County,51197,Hispanic or Latino ,55,20,35,53,12,54
2012,York County,51199,Hispanic or Latino ,769,407,362,158,135,164
2012,Alexandria city,51510,Hispanic or Latino ,7469,1877,5592,438,337,395
2012,Bedford County,51019,Hispanic or Latino ,22,22,0,35,35,17
2012,Bristol city,51520,Hispanic or Latino ,53,11,42,50,18,47
2012,Buena Vista city,51530,Hispanic or Latino ,20,0,20,33,17,33
2012,Charlottesville city,51540,Hispanic or Latino ,507,148,359,123,74,100
2012,Chesapeake city,51550,Hispanic or Latino ,2703,1431,1272,266,229,277
2012,Colonial Heights city,51570,Hispanic or Latino ,127,36,91,68,34,55
2012,Covington city,51580,Hispanic or Latino ,0,0,0,17,17,17
2012,Danville city,51590,Hispanic or Latino ,348,102,246,69,49,81
2012,Emporia city,51595,Hispanic or Latino ,41,0,41,37,17,37
2012,Fairfax city,51600,Hispanic or Latino ,928,521,407,115,114,119
2012,Falls Church city,51610,Hispanic or Latino ,244,81,163,88,35,86
2012,Franklin city,51620,Hispanic or Latino ,31,20,11,43,31,19
2012,Fredericksburg city,51630,Hispanic or Latino ,811,213,598,151,112,175
2012,Galax city,51640,Hispanic or Latino ,298,150,148,138,120,110
2012,Hampton city,51650,Hispanic or Latino ,1826,828,998,215,204,220
2012,Harrisonburg city,51660,Hispanic or Latino ,2060,377,1683,198,120,238
2012,Hopewell city,51670,Hispanic or Latino ,350,80,270,103,66,116
2012,Lexington city,51678,Hispanic or Latino ,35,0,35,58,17,58
2012,Lynchburg city,51680,Hispanic or Latino ,583,107,476,166,84,151
2012,Manassas city,51683,Hispanic or Latino ,2767,1299,1468,234,233,277
2012,Manassas Park city,51685,Hispanic or Latino ,1040,813,227,152,149,113
2012,Martinsville city,51690,Hispanic or Latino ,218,42,176,125,79,104
2012,Newport News city,51700,Hispanic or Latino ,3702,1603,2099,360,240,311
2012,Norfolk city,51710,Hispanic or Latino ,4136,1107,3029,448,200,405
2012,Norton city,51720,Hispanic or Latino ,19,0,19,31,12,31
2012,Petersburg city,51730,Hispanic or Latino ,280,44,236,69,27,63
2012,Poquoson city,51735,Hispanic or Latino ,35,27,8,28,25,15
2012,Portsmouth city,51740,Hispanic or Latino ,895,443,452,122,111,137
2012,Radford city,51750,Hispanic or Latino ,70,11,59,45,22,38
2012,Richmond city,51760,Hispanic or Latino ,3273,533,2740,273,149,271
2012,Roanoke city,51770,Hispanic or Latino ,1512,370,1142,176,136,182
2012,Salem city,51775,Hispanic or Latino ,141,50,91,44,39,53
2012,Staunton city,51790,Hispanic or Latino ,116,42,74,57,43,41
2012,Suffolk city,51800,Hispanic or Latino ,724,457,267,135,129,123
2012,Virginia Beach city,51810,Hispanic or Latino ,8076,3849,4227,402,347,347
2012,Waynesboro city,51820,Hispanic or Latino ,296,121,175,108,82,131
2012,Williamsburg city,51830,Hispanic or Latino ,169,0,169,73,19,73
2012,Winchester city,51840,Hispanic or Latino ,804,190,614,145,74,157
2013,Accomack County,51001,Hispanic or Latino ,734,97,637,162,97,160
2013,Albemarle County,51003,Hispanic or Latino ,1349,597,752,214,161,154
2013,Alleghany County,51005,Hispanic or Latino ,68,31,37,26,34,30
2013,Amelia County,51007,Hispanic or Latino ,0,0,0,19,19,19
2013,Amherst County,51009,Hispanic or Latino ,99,34,65,41,34,37
2013,Appomattox County,51011,Hispanic or Latino ,15,15,0,16,16,19
2013,Arlington County,51013,Hispanic or Latino ,10047,2997,7050,501,284,477
2013,Augusta County,51015,Hispanic or Latino ,321,177,144,92,80,85
2013,Bath County,51017,Hispanic or Latino ,48,48,0,55,55,12
2013,Bedford County,51019,Hispanic or Latino ,203,183,20,56,62,30
2013,Bland County,51021,Hispanic or Latino ,0,0,0,17,17,17
2013,Botetourt County,51023,Hispanic or Latino ,99,74,25,36,34,29
2013,Brunswick County,51025,Hispanic or Latino ,28,6,22,27,18,17
2013,Buchanan County,51027,Hispanic or Latino ,43,22,21,40,34,38
2013,Buckingham County,51029,Hispanic or Latino ,33,33,0,44,44,19
2013,Campbell County,51031,Hispanic or Latino ,318,226,92,76,71,73
2013,Caroline County,51033,Hispanic or Latino ,250,181,69,102,98,62
2013,Carroll County,51035,Hispanic or Latino ,146,82,64,51,79,58
2013,Charles City County,51036,Hispanic or Latino ,40,37,3,16,17,5
2013,Charlotte County,51037,Hispanic or Latino ,32,18,14,22,23,15
2013,Chesterfield County,51041,Hispanic or Latino ,6248,3239,3009,359,370,374
2013,Clarke County,51043,Hispanic or Latino ,157,101,56,43,36,50
2013,Craig County,51045,Hispanic or Latino ,0,0,0,17,17,17
2013,Culpeper County,51047,Hispanic or Latino ,834,406,428,192,171,140
2013,Cumberland County,51049,Hispanic or Latino ,63,55,8,76,75,13
2013,Dickenson County,51051,Hispanic or Latino ,7,0,7,13,19,13
2013,Dinwiddie County,51053,Hispanic or Latino ,113,90,23,69,65,37
2013,Essex County,51057,Hispanic or Latino ,94,49,45,39,24,44
2013,Fairfax County,51059,Hispanic or Latino ,44077,21549,22528,920,863,900
2013,Fauquier County,51061,Hispanic or Latino ,1002,580,422,115,101,137
2013,Floyd County,51063,Hispanic or Latino ,133,38,95,75,27,76
2013,Fluvanna County,51065,Hispanic or Latino ,198,170,28,120,116,44
2013,Franklin County,51067,Hispanic or Latino ,412,138,274,92,72,119
2013,Frederick County,51069,Hispanic or Latino ,1416,1045,371,209,205,123
2013,Giles County,51071,Hispanic or Latino ,18,18,0,22,22,19
2013,Gloucester County,51073,Hispanic or Latino ,279,170,109,77,51,58
2013,Goochland County,51075,Hispanic or Latino ,117,117,0,75,75,23
2013,Grayson County,51077,Hispanic or Latino ,118,94,24,42,52,23
2013,Greene County,51079,Hispanic or Latino ,218,157,61,104,121,58
2013,Greensville County,51081,Hispanic or Latino ,16,16,0,26,26,19
2013,Halifax County,51083,Hispanic or Latino ,130,61,69,65,26,75
2013,Hanover County,51085,Hispanic or Latino ,503,390,113,89,100,64
2013,Henrico County,51087,Hispanic or Latino ,4158,1632,2526,302,259,285
2013,Henry County,51089,Hispanic or Latino ,638,260,378,104,101,141
2013,Highland County,51091,Hispanic or Latino ,0,0,0,12,12,12
2013,Isle of Wight County,51093,Hispanic or Latino ,132,71,61,43,59,35
2013,James City County,51095,Hispanic or Latino ,920,448,472,203,169,236
2013,King and Queen County,51097,Hispanic or Latino ,66,41,25,20,28,29
2013,King George County,51099,Hispanic or Latino ,344,193,151,69,128,104
2013,King William County,51101,Hispanic or Latino ,33,9,24,32,14,33
2013,Lancaster County,51103,Hispanic or Latino ,32,4,28,15,9,17
2013,Lee County,51105,Hispanic or Latino ,27,20,7,104,75,31
2013,Loudoun County,51107,Hispanic or Latino ,9536,4855,4681,432,432,504
2013,Louisa County,51109,Hispanic or Latino ,237,157,80,57,84,47
2013,Lunenburg County,51111,Hispanic or Latino ,93,28,65,31,28,31
2013,Madison County,51113,Hispanic or Latino ,4,4,0,18,18,19
2013,Mathews County,51115,Hispanic or Latino ,0,0,0,17,17,17
2013,Mecklenburg County,51117,Hispanic or Latino ,140,99,41,63,58,34
2013,Middlesex County,51119,Hispanic or Latino ,29,27,2,27,27,5
2013,Montgomery County,51121,Hispanic or Latino ,720,167,553,131,77,150
2013,Nelson County,51125,Hispanic or Latino ,82,35,47,85,46,74
2013,New Kent County,51127,Hispanic or Latino ,91,91,0,63,63,19
2013,Northampton County,51131,Hispanic or Latino ,206,106,100,68,61,47
2013,Northumberland County,51133,Hispanic or Latino ,18,18,0,21,21,19
2013,Nottoway County,51135,Hispanic or Latino ,109,65,44,66,60,47
2013,Orange County,51137,Hispanic or Latino ,274,158,116,73,66,52
2013,Page County,51139,Hispanic or Latino ,108,27,81,42,25,50
2013,Patrick County,51141,Hispanic or Latino ,89,34,55,33,52,37
2013,Pittsylvania County,51143,Hispanic or Latino ,280,155,125,70,61,82
2013,Powhatan County,51145,Hispanic or Latino ,89,69,20,58,58,34
2013,Prince Edward County,51147,Hispanic or Latino ,60,54,6,44,40,14
2013,Prince George County,51149,Hispanic or Latino ,469,164,305,103,73,132
2013,Prince William County,51153,Hispanic or Latino ,19895,11239,8656,574,591,568
2013,Pulaski County,51155,Hispanic or Latino ,166,77,89,58,56,57
2013,Rappahannock County,51157,Hispanic or Latino ,59,37,22,47,48,27
2013,Richmond County,51159,Hispanic or Latino ,81,1,80,40,4,39
2013,Roanoke County,51161,Hispanic or Latino ,592,274,318,113,103,115
2013,Rockbridge County,51163,Hispanic or Latino ,73,48,25,34,40,28
2013,Rockingham County,51165,Hispanic or Latino ,956,539,417,120,141,170
2013,Russell County,51167,Hispanic or Latino ,19,0,19,36,23,36
2013,Scott County,51169,Hispanic or Latino ,66,66,0,36,36,23
2013,Shenandoah County,51171,Hispanic or Latino ,566,175,391,116,83,157
2013,Smyth County,51173,Hispanic or Latino ,142,75,67,50,43,36
2013,Southampton County,51175,Hispanic or Latino ,48,9,39,27,15,25
2013,Spotsylvania County,51177,Hispanic or Latino ,2337,1688,649,210,209,179
2013,Stafford County,51179,Hispanic or Latino ,2992,1743,1249,190,223,209
2013,Surry County,51181,Hispanic or Latino ,26,15,11,24,28,7
2013,Sussex County,51183,Hispanic or Latino ,14,3,11,22,7,18
2013,Tazewell County,51185,Hispanic or Latino ,91,25,66,45,39,61
2013,Warren County,51187,Hispanic or Latino ,363,209,154,90,87,71
2013,Washington County,51191,Hispanic or Latino ,243,147,96,85,64,72
2013,Westmoreland County,51193,Hispanic or Latino ,133,108,25,47,59,28
2013,Wise County,51195,Hispanic or Latino ,60,19,41,32,19,26
2013,Wythe County,51197,Hispanic or Latino ,92,22,70,71,21,73
2013,York County,51199,Hispanic or Latino ,811,384,427,152,95,130
2013,Alexandria city,51510,Hispanic or Latino ,7395,1669,5726,469,262,471
2013,Bedford County,51019,Hispanic or Latino ,0,0,0,17,17,17
2013,Bristol city,51520,Hispanic or Latino ,46,0,46,52,19,52
2013,Buena Vista city,51530,Hispanic or Latino ,19,0,19,39,17,39
2013,Charlottesville city,51540,Hispanic or Latino ,636,168,468,111,72,114
2013,Chesapeake city,51550,Hispanic or Latino ,3081,1809,1272,307,300,322
2013,Colonial Heights city,51570,Hispanic or Latino ,158,93,65,66,54,48
2013,Covington city,51580,Hispanic or Latino ,24,0,24,37,17,37
2013,Danville city,51590,Hispanic or Latino ,352,87,265,67,40,74
2013,Emporia city,51595,Hispanic or Latino ,21,0,21,31,17,31
2013,Fairfax city,51600,Hispanic or Latino ,926,493,433,123,118,132
2013,Falls Church city,51610,Hispanic or Latino ,251,88,163,75,59,78
2013,Franklin city,51620,Hispanic or Latino ,69,50,19,56,49,29
2013,Fredericksburg city,51630,Hispanic or Latino ,788,217,571,178,120,179
2013,Galax city,51640,Hispanic or Latino ,256,130,126,134,116,108
2013,Hampton city,51650,Hispanic or Latino ,1768,863,905,213,161,206
2013,Harrisonburg city,51660,Hispanic or Latino ,2164,525,1639,195,162,220
2013,Hopewell city,51670,Hispanic or Latino ,455,186,269,116,102,129
2013,Lexington city,51678,Hispanic or Latino ,79,22,57,77,37,70
2013,Lynchburg city,51680,Hispanic or Latino ,593,156,437,215,90,207
2013,Manassas city,51683,Hispanic or Latino ,2720,1204,1516,244,219,255
2013,Manassas Park city,51685,Hispanic or Latino ,1077,710,367,151,149,134
2013,Martinsville city,51690,Hispanic or Latino ,142,68,74,48,60,35
2013,Newport News city,51700,Hispanic or Latino ,3805,1588,2217,310,227,288
2013,Norfolk city,51710,Hispanic or Latino ,4455,1239,3216,361,257,333
2013,Norton city,51720,Hispanic or Latino ,29,0,29,44,12,44
2013,Petersburg city,51730,Hispanic or Latino ,288,54,234,69,39,68
2013,Poquoson city,51735,Hispanic or Latino ,44,35,9,34,32,14
2013,Portsmouth city,51740,Hispanic or Latino ,931,428,503,153,159,162
2013,Radford city,51750,Hispanic or Latino ,78,15,63,49,27,44
2013,Richmond city,51760,Hispanic or Latino ,3495,692,2803,280,169,274
2013,Roanoke city,51770,Hispanic or Latino ,1536,399,1137,203,164,174
2013,Salem city,51775,Hispanic or Latino ,140,40,100,40,43,44
2013,Staunton city,51790,Hispanic or Latino ,96,19,77,39,32,43
2013,Suffolk city,51800,Hispanic or Latino ,714,458,256,142,120,143
2013,Virginia Beach city,51810,Hispanic or Latino ,8475,3990,4485,411,335,438
2013,Waynesboro city,51820,Hispanic or Latino ,166,51,115,70,55,79
2013,Williamsburg city,51830,Hispanic or Latino ,185,16,169,57,22,53
2013,Winchester city,51840,Hispanic or Latino ,842,207,635,147,95,157
2014,Accomack County,51001,Hispanic or Latino ,725,168,557,128,116,149
2014,Albemarle County,51003,Hispanic or Latino ,1383,601,782,179,143,176
2014,Alleghany County,51005,Hispanic or Latino ,70,33,37,37,26,36
2014,Amelia County,51007,Hispanic or Latino ,0,0,0,19,19,19
2014,Amherst County,51009,Hispanic or Latino ,187,113,74,46,70,61
2014,Appomattox County,51011,Hispanic or Latino ,20,20,0,23,23,19
2014,Arlington County,51013,Hispanic or Latino ,10525,3058,7467,523,407,477
2014,Augusta County,51015,Hispanic or Latino ,376,175,201,100,89,86
2014,Bath County,51017,Hispanic or Latino ,48,48,0,58,58,12
2014,Bedford County,51019,Hispanic or Latino ,253,197,56,73,90,59
2014,Bland County,51021,Hispanic or Latino ,3,3,0,15,15,17
2014,Botetourt County,51023,Hispanic or Latino ,91,64,27,31,37,27
2014,Brunswick County,51025,Hispanic or Latino ,46,9,37,26,18,15
2014,Buchanan County,51027,Hispanic or Latino ,36,18,18,47,29,34
2014,Buckingham County,51029,Hispanic or Latino ,44,31,13,50,45,25
2014,Campbell County,51031,Hispanic or Latino ,346,212,134,71,90,55
2014,Caroline County,51033,Hispanic or Latino ,283,227,56,110,118,51
2014,Carroll County,51035,Hispanic or Latino ,145,92,53,45,68,43
2014,Charles City County,51036,Hispanic or Latino ,41,37,4,17,18,6
2014,Charlotte County,51037,Hispanic or Latino ,28,15,13,22,18,13
2014,Chesterfield County,51041,Hispanic or Latino ,6533,3489,3044,321,296,323
2014,Clarke County,51043,Hispanic or Latino ,153,75,78,63,39,73
2014,Craig County,51045,Hispanic or Latino ,0,0,0,17,17,17
2014,Culpeper County,51047,Hispanic or Latino ,1052,465,587,171,159,158
2014,Cumberland County,51049,Hispanic or Latino ,10,0,10,16,17,16
2014,Dickenson County,51051,Hispanic or Latino ,17,11,6,22,18,11
2014,Dinwiddie County,51053,Hispanic or Latino ,115,96,19,94,87,28
2014,Essex County,51057,Hispanic or Latino ,52,32,20,30,20,30
2014,Fairfax County,51059,Hispanic or Latino ,45120,21383,23737,856,845,797
2014,Fauquier County,51061,Hispanic or Latino ,1020,610,410,112,100,131
2014,Floyd County,51063,Hispanic or Latino ,109,31,78,46,28,42
2014,Fluvanna County,51065,Hispanic or Latino ,196,166,30,79,73,47
2014,Franklin County,51067,Hispanic or Latino ,352,122,230,98,87,117
2014,Frederick County,51069,Hispanic or Latino ,1402,852,550,155,189,128
2014,Giles County,51071,Hispanic or Latino ,31,31,0,41,41,19
2014,Gloucester County,51073,Hispanic or Latino ,334,239,95,105,80,59
2014,Goochland County,51075,Hispanic or Latino ,112,103,9,56,56,14
2014,Grayson County,51077,Hispanic or Latino ,139,99,40,45,49,30
2014,Greene County,51079,Hispanic or Latino ,209,155,54,67,78,62
2014,Greensville County,51081,Hispanic or Latino ,18,18,0,27,27,19
2014,Halifax County,51083,Hispanic or Latino ,180,88,92,43,52,70
2014,Hanover County,51085,Hispanic or Latino ,560,391,169,77,102,91
2014,Henrico County,51087,Hispanic or Latino ,4560,1856,2704,296,272,329
2014,Henry County,51089,Hispanic or Latino ,688,309,379,115,100,160
2014,Highland County,51091,Hispanic or Latino ,0,0,0,12,12,12
2014,Isle of Wight County,51093,Hispanic or Latino ,145,75,70,50,68,37
2014,James City County,51095,Hispanic or Latino ,1021,441,580,196,156,218
2014,King and Queen County,51097,Hispanic or Latino ,43,13,30,21,20,21
2014,King George County,51099,Hispanic or Latino ,387,221,166,123,151,104
2014,King William County,51101,Hispanic or Latino ,20,7,13,26,13,20
2014,Lancaster County,51103,Hispanic or Latino ,35,0,35,21,19,21
2014,Lee County,51105,Hispanic or Latino ,23,19,4,118,95,27
2014,Loudoun County,51107,Hispanic or Latino ,10365,5338,5027,496,452,483
2014,Louisa County,51109,Hispanic or Latino ,249,138,111,53,72,55
2014,Lunenburg County,51111,Hispanic or Latino ,115,32,83,30,26,32
2014,Madison County,51113,Hispanic or Latino ,8,8,0,18,18,19
2014,Mathews County,51115,Hispanic or Latino ,6,6,0,14,14,17
2014,Mecklenburg County,51117,Hispanic or Latino ,193,142,51,48,52,36
2014,Middlesex County,51119,Hispanic or Latino ,26,19,7,19,20,10
2014,Montgomery County,51121,Hispanic or Latino ,743,173,570,146,95,154
2014,Nelson County,51125,Hispanic or Latino ,116,60,56,74,84,68
2014,New Kent County,51127,Hispanic or Latino ,67,67,0,60,60,19
2014,Northampton County,51131,Hispanic or Latino ,187,75,112,67,59,43
2014,Northumberland County,51133,Hispanic or Latino ,19,19,0,19,19,19
2014,Nottoway County,51135,Hispanic or Latino ,218,93,125,65,84,106
2014,Orange County,51137,Hispanic or Latino ,256,153,103,66,56,50
2014,Page County,51139,Hispanic or Latino ,94,25,69,39,30,50
2014,Patrick County,51141,Hispanic or Latino ,109,19,90,60,31,44
2014,Pittsylvania County,51143,Hispanic or Latino ,379,167,212,95,74,94
2014,Powhatan County,51145,Hispanic or Latino ,79,58,21,33,28,30
2014,Prince Edward County,51147,Hispanic or Latino ,52,43,9,43,35,21
2014,Prince George County,51149,Hispanic or Latino ,565,218,347,135,95,149
2014,Prince William County,51153,Hispanic or Latino ,20531,11712,8819,619,676,674
2014,Pulaski County,51155,Hispanic or Latino ,126,81,45,39,45,29
2014,Rappahannock County,51157,Hispanic or Latino ,56,26,30,41,38,24
2014,Richmond County,51159,Hispanic or Latino ,72,1,71,32,4,32
2014,Roanoke County,51161,Hispanic or Latino ,646,272,374,129,79,138
2014,Rockbridge County,51163,Hispanic or Latino ,77,43,34,36,42,24
2014,Rockingham County,51165,Hispanic or Latino ,1013,570,443,103,122,98
2014,Russell County,51167,Hispanic or Latino ,49,16,33,54,18,50
2014,Scott County,51169,Hispanic or Latino ,75,75,0,47,47,22
2014,Shenandoah County,51171,Hispanic or Latino ,655,182,473,103,76,108
2014,Smyth County,51173,Hispanic or Latino ,126,71,55,63,44,40
2014,Southampton County,51175,Hispanic or Latino ,51,8,43,31,15,29
2014,Spotsylvania County,51177,Hispanic or Latino ,2502,1666,836,220,259,184
2014,Stafford County,51179,Hispanic or Latino ,3242,1864,1378,243,209,222
2014,Surry County,51181,Hispanic or Latino ,11,1,10,17,4,16
2014,Sussex County,51183,Hispanic or Latino ,29,7,22,23,10,20
2014,Tazewell County,51185,Hispanic or Latino ,63,13,50,31,12,32
2014,Warren County,51187,Hispanic or Latino ,399,217,182,98,100,84
2014,Washington County,51191,Hispanic or Latino ,267,121,146,71,58,82
2014,Westmoreland County,51193,Hispanic or Latino ,107,83,24,45,43,27
2014,Wise County,51195,Hispanic or Latino ,58,13,45,40,12,33
2014,Wythe County,51197,Hispanic or Latino ,66,15,51,35,18,39
2014,York County,51199,Hispanic or Latino ,771,301,470,147,109,114
2014,Alexandria city,51510,Hispanic or Latino ,7548,1705,5843,464,273,500
2014,Bristol city,51520,Hispanic or Latino ,28,0,28,31,19,31
2014,Buena Vista city,51530,Hispanic or Latino ,24,0,24,40,17,40
2014,Charlottesville city,51540,Hispanic or Latino ,580,124,456,117,56,95
2014,Chesapeake city,51550,Hispanic or Latino ,3324,1954,1370,297,289,238
2014,Colonial Heights city,51570,Hispanic or Latino ,177,97,80,65,54,51
2014,Covington city,51580,Hispanic or Latino ,15,0,15,23,17,23
2014,Danville city,51590,Hispanic or Latino ,326,111,215,58,43,73
2014,Emporia city,51595,Hispanic or Latino ,12,0,12,23,17,23
2014,Fairfax city,51600,Hispanic or Latino ,915,493,422,114,111,136
2014,Falls Church city,51610,Hispanic or Latino ,271,95,176,71,53,60
2014,Franklin city,51620,Hispanic or Latino ,33,33,0,41,41,17
2014,Fredericksburg city,51630,Hispanic or Latino ,801,167,634,167,108,173
2014,Galax city,51640,Hispanic or Latino ,278,124,154,102,93,97
2014,Hampton city,51650,Hispanic or Latino ,1828,813,1015,237,157,214
2014,Harrisonburg city,51660,Hispanic or Latino ,2301,520,1781,184,155,195
2014,Hopewell city,51670,Hispanic or Latino ,523,153,370,103,91,114
2014,Lexington city,51678,Hispanic or Latino ,35,19,16,43,32,26
2014,Lynchburg city,51680,Hispanic or Latino ,558,155,403,199,99,186
2014,Manassas city,51683,Hispanic or Latino ,2806,1316,1490,263,207,272
2014,Manassas Park city,51685,Hispanic or Latino ,1019,597,422,146,144,136
2014,Martinsville city,51690,Hispanic or Latino ,129,50,79,54,55,32
2014,Newport News city,51700,Hispanic or Latino ,3953,1605,2348,313,244,302
2014,Norfolk city,51710,Hispanic or Latino ,4560,1211,3349,375,223,338
2014,Norton city,51720,Hispanic or Latino ,25,0,25,36,12,36
2014,Petersburg city,51730,Hispanic or Latino ,345,94,251,78,49,85
2014,Poquoson city,51735,Hispanic or Latino ,57,46,11,34,32,18
2014,Portsmouth city,51740,Hispanic or Latino ,1083,464,619,183,140,201
2014,Radford city,51750,Hispanic or Latino ,69,12,57,53,20,51
2014,Richmond city,51760,Hispanic or Latino ,3446,627,2819,272,155,242
2014,Roanoke city,51770,Hispanic or Latino ,1497,504,993,185,143,186
2014,Salem city,51775,Hispanic or Latino ,171,60,111,58,70,46
2014,Staunton city,51790,Hispanic or Latino ,107,18,89,41,34,44
2014,Suffolk city,51800,Hispanic or Latino ,745,504,241,126,109,109
2014,Virginia Beach city,51810,Hispanic or Latino ,8803,4228,4575,497,361,442
2014,Waynesboro city,51820,Hispanic or Latino ,246,163,83,129,90,117
2014,Williamsburg city,51830,Hispanic or Latino ,180,29,151,75,27,65
2014,Winchester city,51840,Hispanic or Latino ,1038,307,731,150,117,156
2015,Accomack County,51001,Hispanic or Latino ,698,256,442,112,142,125
2015,Albemarle County,51003,Hispanic or Latino ,1378,576,802,233,170,207
2015,Alleghany County,51005,Hispanic or Latino ,63,23,40,22,20,23
2015,Amelia County,51007,Hispanic or Latino ,0,0,0,19,19,19
2015,Amherst County,51009,Hispanic or Latino ,148,65,83,37,59,48
2015,Appomattox County,51011,Hispanic or Latino ,34,10,24,30,15,29
2015,Arlington County,51013,Hispanic or Latino ,11357,3462,7895,555,393,563
2015,Augusta County,51015,Hispanic or Latino ,356,149,207,79,62,54
2015,Bath County,51017,Hispanic or Latino ,54,54,0,64,64,12
2015,Bedford County,51019,Hispanic or Latino ,318,271,47,101,121,56
2015,Bland County,51021,Hispanic or Latino ,18,18,0,23,23,17
2015,Botetourt County,51023,Hispanic or Latino ,73,54,19,26,27,24
2015,Brunswick County,51025,Hispanic or Latino ,41,13,28,20,17,13
2015,Buchanan County,51027,Hispanic or Latino ,19,0,19,35,22,35
2015,Buckingham County,51029,Hispanic or Latino ,39,34,5,21,21,12
2015,Campbell County,51031,Hispanic or Latino ,347,190,157,86,76,68
2015,Caroline County,51033,Hispanic or Latino ,333,307,26,118,90,39
2015,Carroll County,51035,Hispanic or Latino ,122,87,35,43,60,39
2015,Charles City County,51036,Hispanic or Latino ,40,40,0,19,19,17
2015,Charlotte County,51037,Hispanic or Latino ,6,4,2,8,7,5
2015,Chesterfield County,51041,Hispanic or Latino ,6687,3813,2874,327,352,345
2015,Clarke County,51043,Hispanic or Latino ,122,62,60,68,42,78
2015,Craig County,51045,Hispanic or Latino ,0,0,0,17,17,17
2015,Culpeper County,51047,Hispanic or Latino ,1068,482,586,163,142,142
2015,Cumberland County,51049,Hispanic or Latino ,12,0,12,20,17,20
2015,Dickenson County,51051,Hispanic or Latino ,18,12,6,18,15,11
2015,Dinwiddie County,51053,Hispanic or Latino ,145,128,17,60,51,28
2015,Essex County,51057,Hispanic or Latino ,9,9,0,14,14,19
2015,Fairfax County,51059,Hispanic or Latino ,45394,21805,23589,943,772,831
2015,Fauquier County,51061,Hispanic or Latino ,1088,720,368,103,94,119
2015,Floyd County,51063,Hispanic or Latino ,114,42,72,31,37,38
2015,Fluvanna County,51065,Hispanic or Latino ,202,184,18,80,83,34
2015,Franklin County,51067,Hispanic or Latino ,385,74,311,100,84,123
2015,Frederick County,51069,Hispanic or Latino ,1485,965,520,164,201,142
2015,Giles County,51071,Hispanic or Latino ,25,14,11,26,17,20
2015,Gloucester County,51073,Hispanic or Latino ,323,191,132,106,86,67
2015,Goochland County,51075,Hispanic or Latino ,110,86,24,59,52,27
2015,Grayson County,51077,Hispanic or Latino ,129,52,77,29,31,39
2015,Greene County,51079,Hispanic or Latino ,238,160,78,70,75,77
2015,Greensville County,51081,Hispanic or Latino ,38,24,14,79,35,73
2015,Halifax County,51083,Hispanic or Latino ,178,93,85,43,51,71
2015,Hanover County,51085,Hispanic or Latino ,569,402,167,89,97,93
2015,Henrico County,51087,Hispanic or Latino ,4831,1849,2982,374,262,350
2015,Henry County,51089,Hispanic or Latino ,706,391,315,110,79,127
2015,Highland County,51091,Hispanic or Latino ,0,0,0,12,12,12
2015,Isle of Wight County,51093,Hispanic or Latino ,158,97,61,50,80,45
2015,James City County,51095,Hispanic or Latino ,1032,380,652,206,172,227
2015,King and Queen County,51097,Hispanic or Latino ,46,12,34,24,17,20
2015,King George County,51099,Hispanic or Latino ,404,304,100,95,151,94
2015,King William County,51101,Hispanic or Latino ,31,20,11,35,23,20
2015,Lancaster County,51103,Hispanic or Latino ,38,0,38,17,19,17
2015,Lee County,51105,Hispanic or Latino ,25,20,5,117,94,26
2015,Loudoun County,51107,Hispanic or Latino ,11373,5893,5480,473,503,430
2015,Louisa County,51109,Hispanic or Latino ,246,129,117,54,63,55
2015,Lunenburg County,51111,Hispanic or Latino ,112,41,71,31,33,35
2015,Madison County,51113,Hispanic or Latino ,31,19,12,18,18,18
2015,Mathews County,51115,Hispanic or Latino ,20,20,0,23,23,17
2015,Mecklenburg County,51117,Hispanic or Latino ,196,148,48,49,49,36
2015,Middlesex County,51119,Hispanic or Latino ,25,20,5,22,21,8
2015,Montgomery County,51121,Hispanic or Latino ,745,215,530,117,99,128
2015,Nelson County,51125,Hispanic or Latino ,93,13,80,48,28,57
2015,New Kent County,51127,Hispanic or Latino ,54,54,0,61,61,22
2015,Northampton County,51131,Hispanic or Latino ,206,124,82,64,64,33
2015,Northumberland County,51133,Hispanic or Latino ,18,18,0,17,17,19
2015,Nottoway County,51135,Hispanic or Latino ,219,50,169,67,55,78
2015,Orange County,51137,Hispanic or Latino ,276,152,124,59,71,58
2015,Page County,51139,Hispanic or Latino ,92,24,68,34,20,35
2015,Patrick County,51141,Hispanic or Latino ,187,51,136,89,84,78
2015,Pittsylvania County,51143,Hispanic or Latino ,391,155,236,82,42,81
2015,Powhatan County,51145,Hispanic or Latino ,88,74,14,38,36,22
2015,Prince Edward County,51147,Hispanic or Latino ,37,28,9,50,44,17
2015,Prince George County,51149,Hispanic or Latino ,742,263,479,149,134,170
2015,Prince William County,51153,Hispanic or Latino ,21319,12391,8928,648,584,633
2015,Pulaski County,51155,Hispanic or Latino ,137,85,52,37,45,39
2015,Rappahannock County,51157,Hispanic or Latino ,83,9,74,47,20,46
2015,Richmond County,51159,Hispanic or Latino ,112,1,111,40,3,40
2015,Roanoke County,51161,Hispanic or Latino ,659,318,341,116,106,104
2015,Rockbridge County,51163,Hispanic or Latino ,79,60,19,35,46,26
2015,Rockingham County,51165,Hispanic or Latino ,1074,610,464,93,142,136
2015,Russell County,51167,Hispanic or Latino ,121,58,63,75,75,46
2015,Scott County,51169,Hispanic or Latino ,88,88,0,49,49,22
2015,Shenandoah County,51171,Hispanic or Latino ,829,249,580,131,77,151
2015,Smyth County,51173,Hispanic or Latino ,138,92,46,50,46,33
2015,Southampton County,51175,Hispanic or Latino ,44,0,44,31,19,31
2015,Spotsylvania County,51177,Hispanic or Latino ,2549,1444,1105,242,256,201
2015,Stafford County,51179,Hispanic or Latino ,3684,2048,1636,219,246,254
2015,Surry County,51181,Hispanic or Latino ,21,6,15,12,11,12
2015,Sussex County,51183,Hispanic or Latino ,18,7,11,22,12,18
2015,Tazewell County,51185,Hispanic or Latino ,73,18,55,31,19,32
2015,Warren County,51187,Hispanic or Latino ,408,202,206,100,116,110
2015,Washington County,51191,Hispanic or Latino ,255,112,143,71,43,75
2015,Westmoreland County,51193,Hispanic or Latino ,144,124,20,74,68,27
2015,Wise County,51195,Hispanic or Latino ,72,42,30,34,35,25
2015,Wythe County,51197,Hispanic or Latino ,84,32,52,43,24,49
2015,York County,51199,Hispanic or Latino ,942,419,523,206,126,148
2015,Alexandria city,51510,Hispanic or Latino ,7591,1745,5846,479,248,451
2015,Bristol city,51520,Hispanic or Latino ,60,0,60,68,19,68
2015,Buena Vista city,51530,Hispanic or Latino ,24,0,24,40,17,40
2015,Charlottesville city,51540,Hispanic or Latino ,647,192,455,103,75,89
2015,Chesapeake city,51550,Hispanic or Latino ,3391,1886,1505,293,313,301
2015,Colonial Heights city,51570,Hispanic or Latino ,251,134,117,51,57,64
2015,Covington city,51580,Hispanic or Latino ,30,0,30,44,17,44
2015,Danville city,51590,Hispanic or Latino ,383,123,260,76,44,83
2015,Emporia city,51595,Hispanic or Latino ,47,0,47,52,17,52
2015,Fairfax city,51600,Hispanic or Latino ,967,525,442,119,140,128
2015,Falls Church city,51610,Hispanic or Latino ,339,132,207,68,58,65
2015,Franklin city,51620,Hispanic or Latino ,54,48,6,53,52,10
2015,Fredericksburg city,51630,Hispanic or Latino ,822,194,628,152,83,156
2015,Galax city,51640,Hispanic or Latino ,210,100,110,99,72,83
2015,Hampton city,51650,Hispanic or Latino ,1915,850,1065,209,165,210
2015,Harrisonburg city,51660,Hispanic or Latino ,2347,570,1777,190,154,183
2015,Hopewell city,51670,Hispanic or Latino ,538,189,349,100,113,116
2015,Lexington city,51678,Hispanic or Latino ,49,14,35,51,25,41
2015,Lynchburg city,51680,Hispanic or Latino ,536,105,431,162,79,157
2015,Manassas city,51683,Hispanic or Latino ,2855,1185,1670,276,273,286
2015,Manassas Park city,51685,Hispanic or Latino ,1169,675,494,121,142,129
2015,Martinsville city,51690,Hispanic or Latino ,118,15,103,34,21,34
2015,Newport News city,51700,Hispanic or Latino ,4171,1665,2506,307,194,279
2015,Norfolk city,51710,Hispanic or Latino ,4931,1453,3478,449,251,375
2015,Norton city,51720,Hispanic or Latino ,31,0,31,35,12,35
2015,Petersburg city,51730,Hispanic or Latino ,415,140,275,104,68,101
2015,Poquoson city,51735,Hispanic or Latino ,39,32,7,26,25,11
2015,Portsmouth city,51740,Hispanic or Latino ,1050,420,630,173,124,182
2015,Radford city,51750,Hispanic or Latino ,66,10,56,52,18,48
2015,Richmond city,51760,Hispanic or Latino ,3244,594,2650,252,138,228
2015,Roanoke city,51770,Hispanic or Latino ,1696,581,1115,246,162,280
2015,Salem city,51775,Hispanic or Latino ,184,88,96,78,86,36
2015,Staunton city,51790,Hispanic or Latino ,122,64,58,45,45,48
2015,Suffolk city,51800,Hispanic or Latino ,897,630,267,123,116,103
2015,Virginia Beach city,51810,Hispanic or Latino ,9397,4328,5069,396,376,472
2015,Waynesboro city,51820,Hispanic or Latino ,335,116,219,95,104,149
2015,Williamsburg city,51830,Hispanic or Latino ,177,22,155,86,22,79
2015,Winchester city,51840,Hispanic or Latino ,1034,222,812,171,102,180
2016,Accomack County,51001,Hispanic or Latino ,669,274,395,126,137,100
2016,Albemarle County,51003,Hispanic or Latino ,1352,556,796,169,145,138
2016,Alleghany County,51005,Hispanic or Latino ,76,24,52,20,20,29
2016,Amelia County,51007,Hispanic or Latino ,21,21,0,36,36,19
2016,Amherst County,51009,Hispanic or Latino ,158,65,93,48,60,71
2016,Appomattox County,51011,Hispanic or Latino ,37,9,28,26,11,26
2016,Arlington County,51013,Hispanic or Latino ,11617,3713,7904,583,447,492
2016,Augusta County,51015,Hispanic or Latino ,398,158,240,108,69,103
2016,Bath County,51017,Hispanic or Latino ,16,16,0,27,27,12
2016,Bedford County,51019,Hispanic or Latino ,362,269,93,80,74,69
2016,Bland County,51021,Hispanic or Latino ,9,9,0,34,34,17
2016,Botetourt County,51023,Hispanic or Latino ,93,66,27,29,36,34
2016,Brunswick County,51025,Hispanic or Latino ,40,6,34,23,12,17
2016,Buchanan County,51027,Hispanic or Latino ,18,0,18,28,22,28
2016,Buckingham County,51029,Hispanic or Latino ,46,33,13,24,26,29
2016,Campbell County,51031,Hispanic or Latino ,381,181,200,85,96,87
2016,Caroline County,51033,Hispanic or Latino ,322,292,30,104,75,49
2016,Carroll County,51035,Hispanic or Latino ,161,82,79,51,52,61
2016,Charles City County,51036,Hispanic or Latino ,74,74,0,15,15,17
2016,Charlotte County,51037,Hispanic or Latino ,12,10,2,13,12,4
2016,Chesterfield County,51041,Hispanic or Latino ,6880,3912,2968,333,322,354
2016,Clarke County,51043,Hispanic or Latino ,154,71,83,93,59,87
2016,Craig County,51045,Hispanic or Latino ,0,0,0,17,17,17
2016,Culpeper County,51047,Hispanic or Latino ,1123,441,682,149,139,116
2016,Cumberland County,51049,Hispanic or Latino ,15,0,15,23,17,23
2016,Dickenson County,51051,Hispanic or Latino ,15,10,5,16,16,8
2016,Dinwiddie County,51053,Hispanic or Latino ,219,84,135,60,69,57
2016,Essex County,51057,Hispanic or Latino ,8,8,0,14,14,19
2016,Fairfax County,51059,Hispanic or Latino ,45294,21821,23473,918,797,815
2016,Fauquier County,51061,Hispanic or Latino ,1155,707,448,112,114,138
2016,Floyd County,51063,Hispanic or Latino ,112,53,59,41,45,33
2016,Fluvanna County,51065,Hispanic or Latino ,206,152,54,97,95,65
2016,Franklin County,51067,Hispanic or Latino ,400,70,330,116,77,149
2016,Frederick County,51069,Hispanic or Latino ,1530,1024,506,143,169,138
2016,Giles County,51071,Hispanic or Latino ,46,5,41,32,10,33
2016,Gloucester County,51073,Hispanic or Latino ,298,185,113,94,91,80
2016,Goochland County,51075,Hispanic or Latino ,140,109,31,57,53,36
2016,Grayson County,51077,Hispanic or Latino ,85,45,40,31,26,20
2016,Greene County,51079,Hispanic or Latino ,307,177,130,95,146,93
2016,Greensville County,51081,Hispanic or Latino ,25,0,25,41,19,41
2016,Halifax County,51083,Hispanic or Latino ,207,105,102,39,47,53
2016,Hanover County,51085,Hispanic or Latino ,662,445,217,100,119,109
2016,Henrico County,51087,Hispanic or Latino ,4861,2034,2827,380,280,326
2016,Henry County,51089,Hispanic or Latino ,759,365,394,112,80,132
2016,Highland County,51091,Hispanic or Latino ,0,0,0,12,12,12
2016,Isle of Wight County,51093,Hispanic or Latino ,202,131,71,71,66,69
2016,James City County,51095,Hispanic or Latino ,977,453,524,191,214,155
2016,King and Queen County,51097,Hispanic or Latino ,41,9,32,29,18,20
2016,King George County,51099,Hispanic or Latino ,365,240,125,123,122,112
2016,King William County,51101,Hispanic or Latino ,36,23,13,31,27,18
2016,Lancaster County,51103,Hispanic or Latino ,42,0,42,29,19,29
2016,Lee County,51105,Hispanic or Latino ,12,8,4,23,15,11
2016,Loudoun County,51107,Hispanic or Latino ,12231,6783,5448,474,486,454
2016,Louisa County,51109,Hispanic or Latino ,255,109,146,63,42,70
2016,Lunenburg County,51111,Hispanic or Latino ,124,55,69,27,37,37
2016,Madison County,51113,Hispanic or Latino ,34,23,11,19,22,17
2016,Mathews County,51115,Hispanic or Latino ,19,19,0,24,24,17
2016,Mecklenburg County,51117,Hispanic or Latino ,217,161,56,57,52,37
2016,Middlesex County,51119,Hispanic or Latino ,11,4,7,15,8,11
2016,Montgomery County,51121,Hispanic or Latino ,785,253,532,142,93,158
2016,Nelson County,51125,Hispanic or Latino ,98,19,79,51,28,54
2016,New Kent County,51127,Hispanic or Latino ,54,54,0,55,55,22
2016,Northampton County,51131,Hispanic or Latino ,228,160,68,79,61,46
2016,Northumberland County,51133,Hispanic or Latino ,18,18,0,16,16,19
2016,Nottoway County,51135,Hispanic or Latino ,134,0,134,39,19,39
2016,Orange County,51137,Hispanic or Latino ,313,202,111,52,65,50
2016,Page County,51139,Hispanic or Latino ,87,12,75,45,11,45
2016,Patrick County,51141,Hispanic or Latino ,135,14,121,42,20,46
2016,Pittsylvania County,51143,Hispanic or Latino ,448,215,233,54,73,65
2016,Powhatan County,51145,Hispanic or Latino ,105,98,7,48,51,11
2016,Prince Edward County,51147,Hispanic or Latino ,25,20,5,83,64,22
2016,Prince George County,51149,Hispanic or Latino ,758,236,522,145,110,142
2016,Prince William County,51153,Hispanic or Latino ,22337,12907,9430,571,582,604
2016,Pulaski County,51155,Hispanic or Latino ,141,60,81,37,45,39
2016,Rappahannock County,51157,Hispanic or Latino ,66,9,57,35,15,35
2016,Richmond County,51159,Hispanic or Latino ,101,26,75,36,26,37
2016,Roanoke County,51161,Hispanic or Latino ,684,314,370,98,113,131
2016,Rockbridge County,51163,Hispanic or Latino ,57,47,10,31,36,17
2016,Rockingham County,51165,Hispanic or Latino ,1138,571,567,96,128,124
2016,Russell County,51167,Hispanic or Latino ,120,48,72,63,48,49
2016,Scott County,51169,Hispanic or Latino ,63,63,0,27,27,22
2016,Shenandoah County,51171,Hispanic or Latino ,880,255,625,194,146,251
2016,Smyth County,51173,Hispanic or Latino ,147,74,73,58,40,44
2016,Southampton County,51175,Hispanic or Latino ,39,2,37,28,5,28
2016,Spotsylvania County,51177,Hispanic or Latino ,2477,1527,950,222,233,168
2016,Stafford County,51179,Hispanic or Latino ,3965,2251,1714,256,281,278
2016,Surry County,51181,Hispanic or Latino ,6,6,0,8,8,17
2016,Sussex County,51183,Hispanic or Latino ,45,15,30,46,25,40
2016,Tazewell County,51185,Hispanic or Latino ,70,30,40,35,30,34
2016,Warren County,51187,Hispanic or Latino ,409,200,209,120,95,104
2016,Washington County,51191,Hispanic or Latino ,216,91,125,62,40,64
2016,Westmoreland County,51193,Hispanic or Latino ,166,142,24,71,72,29
2016,Wise County,51195,Hispanic or Latino ,42,29,13,37,33,14
2016,Wythe County,51197,Hispanic or Latino ,39,32,7,32,29,10
2016,York County,51199,Hispanic or Latino ,884,405,479,193,172,153
2016,Alexandria city,51510,Hispanic or Latino ,7579,1548,6031,398,297,357
2016,Bristol city,51520,Hispanic or Latino ,15,0,15,30,19,30
2016,Buena Vista city,51530,Hispanic or Latino ,22,0,22,39,17,39
2016,Charlottesville city,51540,Hispanic or Latino ,663,202,461,116,89,92
2016,Chesapeake city,51550,Hispanic or Latino ,3628,1964,1664,300,258,283
2016,Colonial Heights city,51570,Hispanic or Latino ,314,139,175,67,60,86
2016,Covington city,51580,Hispanic or Latino ,27,0,27,41,17,41
2016,Danville city,51590,Hispanic or Latino ,362,128,234,71,55,80
2016,Emporia city,51595,Hispanic or Latino ,40,0,40,45,17,45
2016,Fairfax city,51600,Hispanic or Latino ,979,557,422,116,137,148
2016,Falls Church city,51610,Hispanic or Latino ,332,144,188,76,57,82
2016,Franklin city,51620,Hispanic or Latino ,40,30,10,34,32,15
2016,Fredericksburg city,51630,Hispanic or Latino ,810,177,633,179,101,164
2016,Galax city,51640,Hispanic or Latino ,215,115,100,91,78,81
2016,Hampton city,51650,Hispanic or Latino ,2010,912,1098,231,170,211
2016,Harrisonburg city,51660,Hispanic or Latino ,2513,612,1901,211,155,244
2016,Hopewell city,51670,Hispanic or Latino ,565,174,391,115,109,145
2016,Lexington city,51678,Hispanic or Latino ,55,16,39,52,29,40
2016,Lynchburg city,51680,Hispanic or Latino ,550,77,473,137,53,149
2016,Manassas city,51683,Hispanic or Latino ,2929,1052,1877,210,183,249
2016,Manassas Park city,51685,Hispanic or Latino ,1208,645,563,146,189,158
2016,Martinsville city,51690,Hispanic or Latino ,154,27,127,36,24,34
2016,Newport News city,51700,Hispanic or Latino ,4221,1770,2451,278,248,290
2016,Norfolk city,51710,Hispanic or Latino ,4997,1381,3616,439,253,389
2016,Norton city,51720,Hispanic or Latino ,31,0,31,32,12,32
2016,Petersburg city,51730,Hispanic or Latino ,382,141,241,104,64,111
2016,Poquoson city,51735,Hispanic or Latino ,48,30,18,32,26,20
2016,Portsmouth city,51740,Hispanic or Latino ,1072,387,685,198,102,186
2016,Radford city,51750,Hispanic or Latino ,54,11,43,47,12,46
2016,Richmond city,51760,Hispanic or Latino ,3278,524,2754,278,90,280
2016,Roanoke city,51770,Hispanic or Latino ,1851,642,1209,271,216,340
2016,Salem city,51775,Hispanic or Latino ,195,87,108,72,78,52
2016,Staunton city,51790,Hispanic or Latino ,108,49,59,48,35,46
2016,Suffolk city,51800,Hispanic or Latino ,911,621,290,136,111,127
2016,Virginia Beach city,51810,Hispanic or Latino ,9724,4538,5186,448,366,408
2016,Waynesboro city,51820,Hispanic or Latino ,377,98,279,137,94,176
2016,Williamsburg city,51830,Hispanic or Latino ,241,39,202,86,32,80
2016,Winchester city,51840,Hispanic or Latino ,1222,206,1016,158,81,165
2017,Accomack County,51001,Hispanic or Latino ,561,260,301,134,101,101
2017,Albemarle County,51003,Hispanic or Latino ,1534,659,875,191,160,193
2017,Alleghany County,51005,Hispanic or Latino ,81,42,39,18,27,33
2017,Amelia County,51007,Hispanic or Latino ,18,18,0,33,33,19
2017,Amherst County,51009,Hispanic or Latino ,171,84,87,57,67,78
2017,Appomattox County,51011,Hispanic or Latino ,32,1,31,24,3,24
2017,Arlington County,51013,Hispanic or Latino ,12020,3593,8427,586,377,523
2017,Augusta County,51015,Hispanic or Latino ,369,143,226,109,61,88
2017,Bath County,51017,Hispanic or Latino ,33,33,0,46,46,12
2017,Bedford County,51019,Hispanic or Latino ,361,283,78,98,84,68
2017,Bland County,51021,Hispanic or Latino ,7,7,0,50,50,17
2017,Botetourt County,51023,Hispanic or Latino ,99,55,44,25,40,40
2017,Brunswick County,51025,Hispanic or Latino ,51,23,28,28,24,21
2017,Buchanan County,51027,Hispanic or Latino ,12,0,12,22,22,22
2017,Buckingham County,51029,Hispanic or Latino ,74,57,17,27,27,25
2017,Campbell County,51031,Hispanic or Latino ,422,213,209,85,86,87
2017,Caroline County,51033,Hispanic or Latino ,278,263,15,100,93,33
2017,Carroll County,51035,Hispanic or Latino ,168,110,58,46,56,51
2017,Charles City County,51036,Hispanic or Latino ,74,74,0,15,15,17
2017,Charlotte County,51037,Hispanic or Latino ,25,10,15,16,10,21
2017,Chesterfield County,51041,Hispanic or Latino ,7085,3997,3088,288,323,387
2017,Clarke County,51043,Hispanic or Latino ,135,101,34,58,54,50
2017,Craig County,51045,Hispanic or Latino ,0,0,0,17,17,17
2017,Culpeper County,51047,Hispanic or Latino ,1086,577,509,162,147,136
2017,Cumberland County,51049,Hispanic or Latino ,0,0,0,17,17,17
2017,Dickenson County,51051,Hispanic or Latino ,21,21,0,19,19,19
2017,Dinwiddie County,51053,Hispanic or Latino ,232,71,161,61,60,71
2017,Essex County,51057,Hispanic or Latino ,62,13,49,36,30,35
2017,Fairfax County,51059,Hispanic or Latino ,45566,22454,23112,817,947,868
2017,Fauquier County,51061,Hispanic or Latino ,1181,634,547,103,118,144
2017,Floyd County,51063,Hispanic or Latino ,115,45,70,39,54,38
2017,Fluvanna County,51065,Hispanic or Latino ,159,67,92,66,47,72
2017,Franklin County,51067,Hispanic or Latino ,235,35,200,136,42,129
2017,Frederick County,51069,Hispanic or Latino ,1586,1153,433,150,189,142
2017,Giles County,51071,Hispanic or Latino ,70,16,54,25,22,32
2017,Gloucester County,51073,Hispanic or Latino ,371,235,136,104,94,104
2017,Goochland County,51075,Hispanic or Latino ,155,109,46,54,60,33
2017,Grayson County,51077,Hispanic or Latino ,91,47,44,32,29,24
2017,Greene County,51079,Hispanic or Latino ,264,192,72,78,73,75
2017,Greensville County,51081,Hispanic or Latino ,48,0,48,56,19,56
2017,Halifax County,51083,Hispanic or Latino ,208,130,78,50,54,59
2017,Hanover County,51085,Hispanic or Latino ,692,469,223,119,142,102
2017,Henrico County,51087,Hispanic or Latino ,4952,1783,3169,335,286,333
2017,Henry County,51089,Hispanic or Latino ,791,399,392,143,105,174
2017,Highland County,51091,Hispanic or Latino ,0,0,0,12,12,12
2017,Isle of Wight County,51093,Hispanic or Latino ,208,125,83,69,56,78
2017,James City County,51095,Hispanic or Latino ,1160,529,631,148,183,174
2017,King and Queen County,51097,Hispanic or Latino ,27,0,27,22,17,22
2017,King George County,51099,Hispanic or Latino ,363,278,85,93,101,90
2017,King William County,51101,Hispanic or Latino ,10,10,0,15,15,19
2017,Lancaster County,51103,Hispanic or Latino ,58,0,58,37,19,37
2017,Lee County,51105,Hispanic or Latino ,10,3,7,16,5,14
2017,Loudoun County,51107,Hispanic or Latino ,12872,7419,5453,487,496,392
2017,Louisa County,51109,Hispanic or Latino ,297,158,139,59,47,64
2017,Lunenburg County,51111,Hispanic or Latino ,117,35,82,30,26,36
2017,Madison County,51113,Hispanic or Latino ,49,31,18,27,35,24
2017,Mathews County,51115,Hispanic or Latino ,24,24,0,27,27,17
2017,Mecklenburg County,51117,Hispanic or Latino ,139,91,48,65,59,36
2017,Middlesex County,51119,Hispanic or Latino ,18,6,12,22,10,20
2017,Montgomery County,51121,Hispanic or Latino ,745,339,406,107,100,131
2017,Nelson County,51125,Hispanic or Latino ,223,49,174,76,55,88
2017,New Kent County,51127,Hispanic or Latino ,108,65,43,78,55,65
2017,Northampton County,51131,Hispanic or Latino ,247,165,82,58,56,50
2017,Northumberland County,51133,Hispanic or Latino ,23,23,0,28,28,19
2017,Nottoway County,51135,Hispanic or Latino ,159,9,150,55,21,50
2017,Orange County,51137,Hispanic or Latino ,357,232,125,67,65,58
2017,Page County,51139,Hispanic or Latino ,36,7,29,33,12,33
2017,Patrick County,51141,Hispanic or Latino ,116,18,98,45,19,48
2017,Pittsylvania County,51143,Hispanic or Latino ,475,190,285,85,64,69
2017,Powhatan County,51145,Hispanic or Latino ,177,177,0,69,69,22
2017,Prince Edward County,51147,Hispanic or Latino ,131,59,72,84,48,73
2017,Prince George County,51149,Hispanic or Latino ,711,256,455,152,87,133
2017,Prince William County,51153,Hispanic or Latino ,23478,14356,9122,631,737,752
2017,Pulaski County,51155,Hispanic or Latino ,150,36,114,50,31,46
2017,Rappahannock County,51157,Hispanic or Latino ,47,8,39,42,14,39
2017,Richmond County,51159,Hispanic or Latino ,110,32,78,45,29,43
2017,Roanoke County,51161,Hispanic or Latino ,813,413,400,100,99,147
2017,Rockbridge County,51163,Hispanic or Latino ,84,70,14,36,41,20
2017,Rockingham County,51165,Hispanic or Latino ,1280,640,640,150,142,166
2017,Russell County,51167,Hispanic or Latino ,179,109,70,88,64,63
2017,Scott County,51169,Hispanic or Latino ,36,36,0,32,32,22
2017,Shenandoah County,51171,Hispanic or Latino ,597,204,393,107,61,130
2017,Smyth County,51173,Hispanic or Latino ,183,95,88,61,54,60
2017,Southampton County,51175,Hispanic or Latino ,45,14,31,28,15,31
2017,Spotsylvania County,51177,Hispanic or Latino ,2734,1715,1019,219,194,176
2017,Stafford County,51179,Hispanic or Latino ,4461,2603,1858,274,318,284
2017,Surry County,51181,Hispanic or Latino ,31,29,2,28,28,4
2017,Sussex County,51183,Hispanic or Latino ,74,24,50,47,36,49
2017,Tazewell County,51185,Hispanic or Latino ,70,27,43,25,27,30
2017,Warren County,51187,Hispanic or Latino ,414,170,244,130,89,104
2017,Washington County,51191,Hispanic or Latino ,205,50,155,69,19,69
2017,Westmoreland County,51193,Hispanic or Latino ,193,114,79,93,75,51
2017,Wise County,51195,Hispanic or Latino ,23,18,5,29,24,11
2017,Wythe County,51197,Hispanic or Latino ,37,32,5,30,29,8
2017,York County,51199,Hispanic or Latino ,922,419,503,201,139,170
2017,Alexandria city,51510,Hispanic or Latino ,7677,1608,6069,426,250,405
2017,Bristol city,51520,Hispanic or Latino ,7,7,0,13,13,19
2017,Buena Vista city,51530,Hispanic or Latino ,0,0,0,17,17,17
2017,Charlottesville city,51540,Hispanic or Latino ,680,193,487,114,82,110
2017,Chesapeake city,51550,Hispanic or Latino ,3674,2032,1642,275,279,278
2017,Colonial Heights city,51570,Hispanic or Latino ,338,148,190,53,60,82
2017,Covington city,51580,Hispanic or Latino ,60,30,30,53,38,41
2017,Danville city,51590,Hispanic or Latino ,374,127,247,74,65,92
2017,Emporia city,51595,Hispanic or Latino ,61,20,41,46,31,35
2017,Fairfax city,51600,Hispanic or Latino ,1014,575,439,113,116,120
2017,Falls Church city,51610,Hispanic or Latino ,394,130,264,95,76,80
2017,Franklin city,51620,Hispanic or Latino ,34,19,15,35,25,26
2017,Fredericksburg city,51630,Hispanic or Latino ,756,235,521,192,110,182
2017,Galax city,51640,Hispanic or Latino ,254,119,135,107,87,88
2017,Hampton city,51650,Hispanic or Latino ,2237,1097,1140,225,183,198
2017,Harrisonburg city,51660,Hispanic or Latino ,2349,568,1781,198,146,209
2017,Hopewell city,51670,Hispanic or Latino ,554,208,346,120,120,121
2017,Lexington city,51678,Hispanic or Latino ,69,24,45,62,39,48
2017,Lynchburg city,51680,Hispanic or Latino ,592,115,477,120,77,114
2017,Manassas city,51683,Hispanic or Latino ,2949,1303,1646,233,200,257
2017,Manassas Park city,51685,Hispanic or Latino ,1288,772,516,136,165,128
2017,Martinsville city,51690,Hispanic or Latino ,178,32,146,37,28,45
2017,Newport News city,51700,Hispanic or Latino ,4301,1820,2481,372,258,323
2017,Norfolk city,51710,Hispanic or Latino ,5246,1484,3762,345,245,307
2017,Norton city,51720,Hispanic or Latino ,13,0,13,23,12,23
2017,Petersburg city,51730,Hispanic or Latino ,382,187,195,95,78,90
2017,Poquoson city,51735,Hispanic or Latino ,39,28,11,26,26,16
2017,Portsmouth city,51740,Hispanic or Latino ,1144,426,718,194,135,196
2017,Radford city,51750,Hispanic or Latino ,37,6,31,39,6,37
2017,Richmond city,51760,Hispanic or Latino ,3169,529,2640,285,123,270
2017,Roanoke city,51770,Hispanic or Latino ,1704,683,1021,268,205,258
2017,Salem city,51775,Hispanic or Latino ,200,55,145,91,76,68
2017,Staunton city,51790,Hispanic or Latino ,167,76,91,61,66,56
2017,Suffolk city,51800,Hispanic or Latino ,950,607,343,142,126,119
2017,Virginia Beach city,51810,Hispanic or Latino ,9747,4694,5053,490,361,475
2017,Waynesboro city,51820,Hispanic or Latino ,406,76,330,125,65,157
2017,Williamsburg city,51830,Hispanic or Latino ,262,39,223,99,27,100
2017,Winchester city,51840,Hispanic or Latino ,1224,264,960,167,106,149
2018,Accomack County,51001,Hispanic or Latino ,606,285,321,147,109,99
2018,Albemarle County,51003,Hispanic or Latino ,1624,671,953,180,141,131
2018,Alleghany County,51005,Hispanic or Latino ,64,30,34,37,32,29
2018,Amelia County,51007,Hispanic or Latino ,54,54,0,45,45,19
2018,Amherst County,51009,Hispanic or Latino ,176,135,41,59,56,45
2018,Appomattox County,51011,Hispanic or Latino ,75,24,51,29,20,27
2018,Arlington County,51013,Hispanic or Latino ,12412,3744,8668,582,394,505
2018,Augusta County,51015,Hispanic or Latino ,357,135,222,93,61,85
2018,Bath County,51017,Hispanic or Latino ,0,0,0,12,12,12
2018,Bedford County,51019,Hispanic or Latino ,440,349,91,92,93,59
2018,Bland County,51021,Hispanic or Latino ,10,10,0,13,13,17
2018,Botetourt County,51023,Hispanic or Latino ,93,18,75,36,19,31
2018,Brunswick County,51025,Hispanic or Latino ,111,73,38,32,47,31
2018,Buchanan County,51027,Hispanic or Latino ,21,0,21,28,22,28
2018,Buckingham County,51029,Hispanic or Latino ,63,50,13,38,26,25
2018,Campbell County,51031,Hispanic or Latino ,445,142,303,97,62,109
2018,Caroline County,51033,Hispanic or Latino ,286,203,83,115,106,77
2018,Carroll County,51035,Hispanic or Latino ,171,122,49,49,43,47
2018,Charles City County,51036,Hispanic or Latino ,62,55,7,15,19,10
2018,Charlotte County,51037,Hispanic or Latino ,25,9,16,13,8,16
2018,Chesterfield County,51041,Hispanic or Latino ,7254,4162,3092,325,343,322
2018,Clarke County,51043,Hispanic or Latino ,125,125,0,44,44,19
2018,Craig County,51045,Hispanic or Latino ,0,0,0,17,17,17
2018,Culpeper County,51047,Hispanic or Latino ,1162,645,517,135,135,161
2018,Cumberland County,51049,Hispanic or Latino ,0,0,0,17,17,17
2018,Dickenson County,51051,Hispanic or Latino ,25,24,1,16,16,2
2018,Dinwiddie County,51053,Hispanic or Latino ,255,93,162,76,82,113
2018,Essex County,51057,Hispanic or Latino ,53,0,53,35,19,35
2018,Fairfax County,51059,Hispanic or Latino ,45729,22846,22883,878,721,708
2018,Fauquier County,51061,Hispanic or Latino ,1329,717,612,145,165,196
2018,Floyd County,51063,Hispanic or Latino ,122,78,44,55,61,37
2018,Fluvanna County,51065,Hispanic or Latino ,169,59,110,66,57,76
2018,Franklin County,51067,Hispanic or Latino ,344,103,241,141,121,132
2018,Frederick County,51069,Hispanic or Latino ,1732,1193,539,148,212,149
2018,Giles County,51071,Hispanic or Latino ,88,25,63,22,28,42
2018,Gloucester County,51073,Hispanic or Latino ,373,236,137,129,114,121
2018,Goochland County,51075,Hispanic or Latino ,183,129,54,67,71,36
2018,Grayson County,51077,Hispanic or Latino ,86,40,46,30,22,26
2018,Greene County,51079,Hispanic or Latino ,299,219,80,103,82,87
2018,Greensville County,51081,Hispanic or Latino ,20,1,19,15,3,15
2018,Halifax County,51083,Hispanic or Latino ,208,151,57,60,52,54
2018,Hanover County,51085,Hispanic or Latino ,814,572,242,132,128,99
2018,Henrico County,51087,Hispanic or Latino ,4999,1879,3120,386,297,340
2018,Henry County,51089,Hispanic or Latino ,731,408,323,149,101,153
2018,Highland County,51091,Hispanic or Latino ,0,0,0,12,12,12
2018,Isle of Wight County,51093,Hispanic or Latino ,333,159,174,102,69,101
2018,James City County,51095,Hispanic or Latino ,1273,640,633,219,203,210
2018,King and Queen County,51097,Hispanic or Latino ,18,0,18,14,17,14
2018,King George County,51099,Hispanic or Latino ,347,319,28,125,135,28
2018,King William County,51101,Hispanic or Latino ,32,32,0,37,37,19
2018,Lancaster County,51103,Hispanic or Latino ,9,0,9,16,19,16
2018,Lee County,51105,Hispanic or Latino ,3,3,0,6,6,22
2018,Loudoun County,51107,Hispanic or Latino ,13324,7871,5453,455,496,416
2018,Louisa County,51109,Hispanic or Latino ,305,152,153,61,50,66
2018,Lunenburg County,51111,Hispanic or Latino ,119,34,85,33,28,42
2018,Madison County,51113,Hispanic or Latino ,58,26,32,33,40,27
2018,Mathews County,51115,Hispanic or Latino ,17,17,0,29,29,17
2018,Mecklenburg County,51117,Hispanic or Latino ,154,87,67,53,55,34
2018,Middlesex County,51119,Hispanic or Latino ,61,7,54,64,14,65
2018,Montgomery County,51121,Hispanic or Latino ,741,382,359,116,108,134
2018,Nelson County,51125,Hispanic or Latino ,265,76,189,72,75,66
2018,New Kent County,51127,Hispanic or Latino ,187,129,58,105,96,61
2018,Northampton County,51131,Hispanic or Latino ,209,133,76,80,59,56
2018,Northumberland County,51133,Hispanic or Latino ,31,31,0,31,31,19
2018,Nottoway County,51135,Hispanic or Latino ,175,6,169,45,12,45
2018,Orange County,51137,Hispanic or Latino ,331,223,108,57,67,67
2018,Page County,51139,Hispanic or Latino ,44,17,27,32,16,32
2018,Patrick County,51141,Hispanic or Latino ,133,33,100,46,38,48
2018,Pittsylvania County,51143,Hispanic or Latino ,480,194,286,78,64,93
2018,Powhatan County,51145,Hispanic or Latino ,194,135,59,59,83,51
2018,Prince Edward County,51147,Hispanic or Latino ,149,81,68,95,48,69
2018,Prince George County,51149,Hispanic or Latino ,571,211,360,142,92,125
2018,Prince William County,51153,Hispanic or Latino ,24543,15897,8646,669,758,672
2018,Pulaski County,51155,Hispanic or Latino ,137,28,109,49,22,51
2018,Rappahannock County,51157,Hispanic or Latino ,30,4,26,35,8,33
2018,Richmond County,51159,Hispanic or Latino ,153,60,93,43,32,48
2018,Roanoke County,51161,Hispanic or Latino ,730,331,399,131,110,152
2018,Rockbridge County,51163,Hispanic or Latino ,82,66,16,54,53,38
2018,Rockingham County,51165,Hispanic or Latino ,1372,899,473,137,147,159
2018,Russell County,51167,Hispanic or Latino ,136,72,64,85,57,61
2018,Scott County,51169,Hispanic or Latino ,44,44,0,34,34,22
2018,Shenandoah County,51171,Hispanic or Latino ,654,280,374,132,84,134
2018,Smyth County,51173,Hispanic or Latino ,203,96,107,47,58,48
2018,Southampton County,51175,Hispanic or Latino ,60,23,37,48,29,39
2018,Spotsylvania County,51177,Hispanic or Latino ,3069,1926,1143,230,249,193
2018,Stafford County,51179,Hispanic or Latino ,4918,3123,1795,281,369,295
2018,Surry County,51181,Hispanic or Latino ,30,29,1,28,29,2
2018,Sussex County,51183,Hispanic or Latino ,127,75,52,63,49,43
2018,Tazewell County,51185,Hispanic or Latino ,87,51,36,47,37,36
2018,Warren County,51187,Hispanic or Latino ,372,191,181,126,120,102
2018,Washington County,51191,Hispanic or Latino ,197,50,147,68,17,67
2018,Westmoreland County,51193,Hispanic or Latino ,262,161,101,107,102,63
2018,Wise County,51195,Hispanic or Latino ,60,36,24,40,36,28
2018,Wythe County,51197,Hispanic or Latino ,27,27,0,26,26,22
2018,York County,51199,Hispanic or Latino ,1028,459,569,177,142,144
2018,Alexandria city,51510,Hispanic or Latino ,8015,1740,6275,367,261,335
2018,Bristol city,51520,Hispanic or Latino ,7,7,0,13,13,19
2018,Buena Vista city,51530,Hispanic or Latino ,0,0,0,17,17,17
2018,Charlottesville city,51540,Hispanic or Latino ,669,161,508,107,75,98
2018,Chesapeake city,51550,Hispanic or Latino ,4010,2197,1813,279,281,315
2018,Colonial Heights city,51570,Hispanic or Latino ,332,80,252,66,43,69
2018,Covington city,51580,Hispanic or Latino ,63,44,19,50,42,30
2018,Danville city,51590,Hispanic or Latino ,363,180,183,76,89,74
2018,Emporia city,51595,Hispanic or Latino ,61,20,41,45,31,38
2018,Fairfax city,51600,Hispanic or Latino ,1103,739,364,140,156,113
2018,Falls Church city,51610,Hispanic or Latino ,428,140,288,111,79,99
2018,Franklin city,51620,Hispanic or Latino ,52,15,37,50,24,48
2018,Fredericksburg city,51630,Hispanic or Latino ,595,235,360,143,119,121
2018,Galax city,51640,Hispanic or Latino ,258,161,97,91,95,81
2018,Hampton city,51650,Hispanic or Latino ,2448,960,1488,220,191,238
2018,Harrisonburg city,51660,Hispanic or Latino ,2359,551,1808,218,176,216
2018,Hopewell city,51670,Hispanic or Latino ,580,148,432,149,85,145
2018,Lexington city,51678,Hispanic or Latino ,42,0,42,54,17,54
2018,Lynchburg city,51680,Hispanic or Latino ,705,261,444,131,98,129
2018,Manassas city,51683,Hispanic or Latino ,3184,1567,1617,210,219,245
2018,Manassas Park city,51685,Hispanic or Latino ,1306,781,525,169,185,140
2018,Martinsville city,51690,Hispanic or Latino ,185,57,128,49,40,56
2018,Newport News city,51700,Hispanic or Latino ,4537,1853,2684,296,267,313
2018,Norfolk city,51710,Hispanic or Latino ,5503,1581,3922,358,289,314
2018,Norton city,51720,Hispanic or Latino ,18,0,18,29,12,29
2018,Petersburg city,51730,Hispanic or Latino ,392,218,174,78,87,75
2018,Poquoson city,51735,Hispanic or Latino ,82,41,41,59,34,46
2018,Portsmouth city,51740,Hispanic or Latino ,1179,487,692,207,117,186
2018,Radford city,51750,Hispanic or Latino ,24,4,20,29,6,28
2018,Richmond city,51760,Hispanic or Latino ,3235,523,2712,262,131,213
2018,Roanoke city,51770,Hispanic or Latino ,1591,774,817,212,173,213
2018,Salem city,51775,Hispanic or Latino ,271,82,189,129,86,105
2018,Staunton city,51790,Hispanic or Latino ,175,65,110,49,46,44
2018,Suffolk city,51800,Hispanic or Latino ,1224,771,453,155,125,150
2018,Virginia Beach city,51810,Hispanic or Latino ,10399,4859,5540,449,396,404
2018,Waynesboro city,51820,Hispanic or Latino ,332,71,261,142,61,129
2018,Williamsburg city,51830,Hispanic or Latino ,218,76,142,89,44,78
2018,Winchester city,51840,Hispanic or Latino ,1259,234,1025,157,119,173
2019,Accomack County,51001,Hispanic or Latino ,565,196,369,171,112,133
2019,Albemarle County,51003,Hispanic or Latino ,1598,640,958,190,136,167
2019,Alleghany County,51005,Hispanic or Latino ,65,36,29,16,22,27
2019,Amelia County,51007,Hispanic or Latino ,73,73,0,50,50,19
2019,Amherst County,51009,Hispanic or Latino ,219,125,94,80,75,65
2019,Appomattox County,51011,Hispanic or Latino ,113,69,44,44,46,30
2019,Arlington County,51013,Hispanic or Latino ,12593,3939,8654,538,437,558
2019,Augusta County,51015,Hispanic or Latino ,335,146,189,97,60,78
2019,Bath County,51017,Hispanic or Latino ,0,0,0,12,12,12
2019,Bedford County,51019,Hispanic or Latino ,498,408,90,79,93,61
2019,Bland County,51021,Hispanic or Latino ,13,13,0,22,22,17
2019,Botetourt County,51023,Hispanic or Latino ,100,58,42,68,53,43
2019,Brunswick County,51025,Hispanic or Latino ,141,115,26,39,41,33
2019,Buchanan County,51027,Hispanic or Latino ,26,0,26,49,23,49
2019,Buckingham County,51029,Hispanic or Latino ,119,105,14,67,64,17
2019,Campbell County,51031,Hispanic or Latino ,432,152,280,91,96,79
2019,Caroline County,51033,Hispanic or Latino ,326,182,144,89,97,94
2019,Carroll County,51035,Hispanic or Latino ,185,128,57,80,77,70
2019,Charles City County,51036,Hispanic or Latino ,58,50,8,15,19,11
2019,Charlotte County,51037,Hispanic or Latino ,26,3,23,16,11,9
2019,Chesterfield County,51041,Hispanic or Latino ,7623,4287,3336,367,357,349
2019,Clarke County,51043,Hispanic or Latino ,151,151,0,44,44,19
2019,Craig County,51045,Hispanic or Latino ,0,0,0,17,17,17
2019,Culpeper County,51047,Hispanic or Latino ,1084,641,443,178,129,174
2019,Cumberland County,51049,Hispanic or Latino ,0,0,0,17,17,17
2019,Dickenson County,51051,Hispanic or Latino ,9,8,1,9,9,2
2019,Dinwiddie County,51053,Hispanic or Latino ,197,69,128,98,68,90
2019,Essex County,51057,Hispanic or Latino ,53,0,53,35,19,35
2019,Fairfax County,51059,Hispanic or Latino ,46711,22881,23830,986,974,977
2019,Fauquier County,51061,Hispanic or Latino ,1416,796,620,156,144,167
2019,Floyd County,51063,Hispanic or Latino ,155,56,99,110,45,104
2019,Fluvanna County,51065,Hispanic or Latino ,169,66,103,64,58,73
2019,Franklin County,51067,Hispanic or Latino ,403,136,267,103,112,110
2019,Frederick County,51069,Hispanic or Latino ,1804,1322,482,160,166,150
2019,Giles County,51071,Hispanic or Latino ,89,29,60,19,25,35
2019,Gloucester County,51073,Hispanic or Latino ,360,213,147,149,100,130
2019,Goochland County,51075,Hispanic or Latino ,220,117,103,78,83,53
2019,Grayson County,51077,Hispanic or Latino ,84,48,36,41,29,29
2019,Greene County,51079,Hispanic or Latino ,236,160,76,93,62,89
2019,Greensville County,51081,Hispanic or Latino ,33,10,23,21,21,14
2019,Halifax County,51083,Hispanic or Latino ,207,166,41,82,83,48
2019,Hanover County,51085,Hispanic or Latino ,952,548,404,133,152,149
2019,Henrico County,51087,Hispanic or Latino ,5276,1975,3301,364,292,289
2019,Henry County,51089,Hispanic or Latino ,757,376,381,189,146,153
2019,Highland County,51091,Hispanic or Latino ,0,0,0,12,12,12
2019,Isle of Wight County,51093,Hispanic or Latino ,273,134,139,60,84,81
2019,James City County,51095,Hispanic or Latino ,1294,839,455,218,206,160
2019,King and Queen County,51097,Hispanic or Latino ,12,5,7,13,8,13
2019,King George County,51099,Hispanic or Latino ,387,294,93,103,104,79
2019,King William County,51101,Hispanic or Latino ,45,45,0,48,48,19
2019,Lancaster County,51103,Hispanic or Latino ,26,14,12,28,22,17
2019,Lee County,51105,Hispanic or Latino ,2,2,0,5,5,23
2019,Loudoun County,51107,Hispanic or Latino ,13681,8138,5543,495,485,494
2019,Louisa County,51109,Hispanic or Latino ,296,168,128,66,44,61
2019,Lunenburg County,51111,Hispanic or Latino ,160,47,113,121,71,97
2019,Madison County,51113,Hispanic or Latino ,63,30,33,38,46,27
2019,Mathews County,51115,Hispanic or Latino ,94,94,0,73,73,17
2019,Mecklenburg County,51117,Hispanic or Latino ,209,86,123,68,46,60
2019,Middlesex County,51119,Hispanic or Latino ,100,31,69,73,38,76
2019,Montgomery County,51121,Hispanic or Latino ,768,420,348,111,98,122
2019,Nelson County,51125,Hispanic or Latino ,260,50,210,106,63,85
2019,New Kent County,51127,Hispanic or Latino ,227,158,69,80,79,60
2019,Northampton County,51131,Hispanic or Latino ,225,154,71,69,58,55
2019,Northumberland County,51133,Hispanic or Latino ,35,35,0,45,45,19
2019,Nottoway County,51135,Hispanic or Latino ,156,25,131,45,25,56
2019,Orange County,51137,Hispanic or Latino ,376,259,117,62,65,67
2019,Page County,51139,Hispanic or Latino ,51,20,31,39,23,35
2019,Patrick County,51141,Hispanic or Latino ,140,105,35,50,59,37
2019,Pittsylvania County,51143,Hispanic or Latino ,474,247,227,88,80,86
2019,Powhatan County,51145,Hispanic or Latino ,180,116,64,70,76,54
2019,Prince Edward County,51147,Hispanic or Latino ,146,90,56,83,61,55
2019,Prince George County,51149,Hispanic or Latino ,636,270,366,132,104,117
2019,Prince William County,51153,Hispanic or Latino ,25631,16518,9113,626,670,546
2019,Pulaski County,51155,Hispanic or Latino ,150,47,103,48,44,48
2019,Rappahannock County,51157,Hispanic or Latino ,39,7,32,42,14,40
2019,Richmond County,51159,Hispanic or Latino ,163,50,113,56,28,55
2019,Roanoke County,51161,Hispanic or Latino ,758,489,269,115,130,101
2019,Rockbridge County,51163,Hispanic or Latino ,159,122,37,61,56,60
2019,Rockingham County,51165,Hispanic or Latino ,1321,828,493,146,133,164
2019,Russell County,51167,Hispanic or Latino ,127,72,55,94,87,66
2019,Scott County,51169,Hispanic or Latino ,33,33,0,26,26,23
2019,Shenandoah County,51171,Hispanic or Latino ,730,371,359,133,98,143
2019,Smyth County,51173,Hispanic or Latino ,217,129,88,52,54,34
2019,Southampton County,51175,Hispanic or Latino ,54,26,28,46,30,38
2019,Spotsylvania County,51177,Hispanic or Latino ,3325,2112,1213,256,292,310
2019,Stafford County,51179,Hispanic or Latino ,5013,3358,1655,275,380,329
2019,Surry County,51181,Hispanic or Latino ,20,19,1,20,20,2
2019,Sussex County,51183,Hispanic or Latino ,103,55,48,43,44,36
2019,Tazewell County,51185,Hispanic or Latino ,68,45,23,61,44,38
2019,Warren County,51187,Hispanic or Latino ,404,190,214,123,107,105
2019,Washington County,51191,Hispanic or Latino ,143,28,115,73,33,71
2019,Westmoreland County,51193,Hispanic or Latino ,298,195,103,70,105,82
2019,Wise County,51195,Hispanic or Latino ,50,28,22,36,33,24
2019,Wythe County,51197,Hispanic or Latino ,39,39,0,38,38,23
2019,York County,51199,Hispanic or Latino ,1239,626,613,162,153,170
2019,Alexandria city,51510,Hispanic or Latino ,8091,1850,6241,388,270,408
2019,Bristol city,51520,Hispanic or Latino ,34,34,0,43,43,19
2019,Buena Vista city,51530,Hispanic or Latino ,25,0,25,39,17,39
2019,Charlottesville city,51540,Hispanic or Latino ,727,243,484,102,103,123
2019,Chesapeake city,51550,Hispanic or Latino ,3976,2220,1756,286,284,257
2019,Colonial Heights city,51570,Hispanic or Latino ,369,84,285,77,50,81
2019,Covington city,51580,Hispanic or Latino ,51,31,20,37,26,29
2019,Danville city,51590,Hispanic or Latino ,448,233,215,89,107,91
2019,Emporia city,51595,Hispanic or Latino ,101,19,82,67,25,65
2019,Fairfax city,51600,Hispanic or Latino ,1176,704,472,130,107,123
2019,Falls Church city,51610,Hispanic or Latino ,458,178,280,147,97,122
2019,Franklin city,51620,Hispanic or Latino ,61,17,44,57,26,51
2019,Fredericksburg city,51630,Hispanic or Latino ,563,183,380,143,110,99
2019,Galax city,51640,Hispanic or Latino ,220,171,49,74,81,44
2019,Hampton city,51650,Hispanic or Latino ,2384,1023,1361,246,220,255
2019,Harrisonburg city,51660,Hispanic or Latino ,2483,677,1806,208,171,226
2019,Hopewell city,51670,Hispanic or Latino ,621,298,323,132,124,154
2019,Lexington city,51678,Hispanic or Latino ,42,0,42,53,17,53
2019,Lynchburg city,51680,Hispanic or Latino ,855,305,550,141,100,147
2019,Manassas city,51683,Hispanic or Latino ,3323,1774,1549,207,240,262
2019,Manassas Park city,51685,Hispanic or Latino ,1381,839,542,178,195,144
2019,Martinsville city,51690,Hispanic or Latino ,181,83,98,39,41,52
2019,Newport News city,51700,Hispanic or Latino ,4839,2052,2787,262,203,316
2019,Norfolk city,51710,Hispanic or Latino ,5356,1702,3654,404,285,337
2019,Norton city,51720,Hispanic or Latino ,12,0,12,19,12,19
2019,Petersburg city,51730,Hispanic or Latino ,460,219,241,95,104,84
2019,Poquoson city,51735,Hispanic or Latino ,85,47,38,44,37,43
2019,Portsmouth city,51740,Hispanic or Latino ,1222,520,702,222,127,170
2019,Radford city,51750,Hispanic or Latino ,31,8,23,36,9,34
2019,Richmond city,51760,Hispanic or Latino ,3392,654,2738,303,152,272
2019,Roanoke city,51770,Hispanic or Latino ,1682,653,1029,209,186,197
2019,Salem city,51775,Hispanic or Latino ,164,0,164,67,23,67
2019,Staunton city,51790,Hispanic or Latino ,148,71,77,48,43,45
2019,Suffolk city,51800,Hispanic or Latino ,1314,728,586,186,135,175
2019,Virginia Beach city,51810,Hispanic or Latino ,10863,5191,5672,405,419,448
2019,Waynesboro city,51820,Hispanic or Latino ,412,94,318,153,66,154
2019,Williamsburg city,51830,Hispanic or Latino ,251,41,210,99,32,85
2019,Winchester city,51840,Hispanic or Latino ,1205,177,1028,188,86,185
2020,Accomack County,51001,Hispanic or Latino ,689,251,438,169,106,152
2020,Albemarle County,51003,Hispanic or Latino ,1727,737,990,186,163,158
2020,Alleghany County,51005,Hispanic or Latino ,33,24,9,24,20,16
2020,Amelia County,51007,Hispanic or Latino ,128,128,0,95,95,20
2020,Amherst County,51009,Hispanic or Latino ,226,159,67,71,58,60
2020,Appomattox County,51011,Hispanic or Latino ,92,47,45,31,39,36
2020,Arlington County,51013,Hispanic or Latino ,12797,3675,9122,618,411,694
2020,Augusta County,51015,Hispanic or Latino ,412,277,135,84,89,75
2020,Bath County,51017,Hispanic or Latino ,0,0,0,13,13,13
2020,Bedford County,51019,Hispanic or Latino ,493,327,166,92,89,99
2020,Bland County,51021,Hispanic or Latino ,0,0,0,18,18,18
2020,Botetourt County,51023,Hispanic or Latino ,145,75,70,73,62,60
2020,Brunswick County,51025,Hispanic or Latino ,193,168,25,54,56,43
2020,Buchanan County,51027,Hispanic or Latino ,48,0,48,54,24,54
2020,Buckingham County,51029,Hispanic or Latino ,69,50,19,60,59,12
2020,Campbell County,51031,Hispanic or Latino ,459,156,303,90,89,86
2020,Caroline County,51033,Hispanic or Latino ,286,154,132,84,86,90
2020,Carroll County,51035,Hispanic or Latino ,268,170,98,68,104,85
2020,Charles City County,51036,Hispanic or Latino ,63,54,9,16,20,13
2020,Charlotte County,51037,Hispanic or Latino ,36,3,33,17,12,13
2020,Chesterfield County,51041,Hispanic or Latino ,8162,4362,3800,424,429,449
2020,Clarke County,51043,Hispanic or Latino ,141,141,0,41,41,20
2020,Craig County,51045,Hispanic or Latino ,0,0,0,18,18,18
2020,Culpeper County,51047,Hispanic or Latino ,1119,670,449,209,182,154
2020,Cumberland County,51049,Hispanic or Latino ,0,0,0,18,18,18
2020,Dickenson County,51051,Hispanic or Latino ,11,10,1,13,14,2
2020,Dinwiddie County,51053,Hispanic or Latino ,273,117,156,100,94,85
2020,Essex County,51057,Hispanic or Latino ,66,24,42,50,20,55
2020,Fairfax County,51059,Hispanic or Latino ,47939,25102,22837,1139,926,891
2020,Fauquier County,51061,Hispanic or Latino ,1611,832,779,197,200,174
2020,Floyd County,51063,Hispanic or Latino ,118,62,56,87,54,70
2020,Fluvanna County,51065,Hispanic or Latino ,129,50,79,69,58,66
2020,Franklin County,51067,Hispanic or Latino ,305,126,179,102,89,91
2020,Frederick County,51069,Hispanic or Latino ,1796,1394,402,193,190,131
2020,Giles County,51071,Hispanic or Latino ,53,13,40,26,17,27
2020,Gloucester County,51073,Hispanic or Latino ,440,303,137,173,127,118
2020,Goochland County,51075,Hispanic or Latino ,146,101,45,76,83,27
2020,Grayson County,51077,Hispanic or Latino ,73,58,15,43,38,17
2020,Greene County,51079,Hispanic or Latino ,340,269,71,63,74,43
2020,Greensville County,51081,Hispanic or Latino ,25,14,11,23,17,14
2020,Halifax County,51083,Hispanic or Latino ,212,183,29,80,83,35
2020,Hanover County,51085,Hispanic or Latino ,1149,702,447,164,189,155
2020,Henrico County,51087,Hispanic or Latino ,5584,2085,3499,435,314,439
2020,Henry County,51089,Hispanic or Latino ,702,401,301,152,151,111
2020,Highland County,51091,Hispanic or Latino ,0,0,0,13,13,13
2020,Isle of Wight County,51093,Hispanic or Latino ,369,165,204,75,98,108
2020,James City County,51095,Hispanic or Latino ,1441,978,463,225,203,220
2020,King and Queen County,51097,Hispanic or Latino ,14,11,3,13,12,7
2020,King George County,51099,Hispanic or Latino ,393,303,90,102,95,72
2020,King William County,51101,Hispanic or Latino ,83,83,0,74,74,20
2020,Lancaster County,51103,Hispanic or Latino ,67,67,0,43,43,20
2020,Lee County,51105,Hispanic or Latino ,3,3,0,8,8,24
2020,Loudoun County,51107,Hispanic or Latino ,14231,8487,5744,426,574,613
2020,Louisa County,51109,Hispanic or Latino ,335,179,156,84,69,88
2020,Lunenburg County,51111,Hispanic or Latino ,117,36,81,81,49,66
2020,Madison County,51113,Hispanic or Latino ,99,79,20,81,95,35
2020,Mathews County,51115,Hispanic or Latino ,69,69,0,45,45,18
2020,Mecklenburg County,51117,Hispanic or Latino ,201,42,159,62,37,64
2020,Middlesex County,51119,Hispanic or Latino ,145,34,111,87,35,78
2020,Montgomery County,51121,Hispanic or Latino ,943,357,586,131,130,168
2020,Nelson County,51125,Hispanic or Latino ,271,84,187,66,65,97
2020,New Kent County,51127,Hispanic or Latino ,365,227,138,161,141,119
2020,Northampton County,51131,Hispanic or Latino ,270,170,100,64,69,71
2020,Northumberland County,51133,Hispanic or Latino ,63,63,0,71,71,20
2020,Nottoway County,51135,Hispanic or Latino ,156,35,121,58,32,76
2020,Orange County,51137,Hispanic or Latino ,533,461,72,145,129,68
2020,Page County,51139,Hispanic or Latino ,82,62,20,39,42,25
2020,Patrick County,51141,Hispanic or Latino ,184,109,75,58,62,72
2020,Pittsylvania County,51143,Hispanic or Latino ,415,208,207,79,80,67
2020,Powhatan County,51145,Hispanic or Latino ,190,138,52,75,86,45
2020,Prince Edward County,51147,Hispanic or Latino ,65,30,35,80,43,47
2020,Prince George County,51149,Hispanic or Latino ,649,266,383,148,98,113
2020,Prince William County,51153,Hispanic or Latino ,27339,17895,9444,714,857,756
2020,Pulaski County,51155,Hispanic or Latino ,165,69,96,48,53,52
2020,Rappahannock County,51157,Hispanic or Latino ,23,23,0,28,28,18
2020,Richmond County,51159,Hispanic or Latino ,156,55,101,48,44,55
2020,Roanoke County,51161,Hispanic or Latino ,803,396,407,163,136,179
2020,Rockbridge County,51163,Hispanic or Latino ,191,156,35,79,90,66
2020,Rockingham County,51165,Hispanic or Latino ,1439,937,502,181,168,194
2020,Russell County,51167,Hispanic or Latino ,66,41,25,103,77,52
2020,Scott County,51169,Hispanic or Latino ,30,30,0,30,30,24
2020,Shenandoah County,51171,Hispanic or Latino ,816,369,447,114,108,139
2020,Smyth County,51173,Hispanic or Latino ,217,115,102,45,65,40
2020,Southampton County,51175,Hispanic or Latino ,75,72,3,50,50,5
2020,Spotsylvania County,51177,Hispanic or Latino ,3704,2649,1055,246,280,255
2020,Stafford County,51179,Hispanic or Latino ,5034,3327,1707,354,369,373
2020,Surry County,51181,Hispanic or Latino ,61,39,22,41,51,22
2020,Sussex County,51183,Hispanic or Latino ,113,57,56,36,37,44
2020,Tazewell County,51185,Hispanic or Latino ,45,45,0,50,50,27
2020,Warren County,51187,Hispanic or Latino ,576,389,187,132,144,96
2020,Washington County,51191,Hispanic or Latino ,163,91,72,72,67,59
2020,Westmoreland County,51193,Hispanic or Latino ,357,229,128,104,116,87
2020,Wise County,51195,Hispanic or Latino ,101,16,85,106,28,107
2020,Wythe County,51197,Hispanic or Latino ,70,62,8,56,53,19
2020,York County,51199,Hispanic or Latino ,1377,879,498,201,204,144
2020,Alexandria city,51510,Hispanic or Latino ,8116,1762,6354,468,306,502
2020,Bristol city,51520,Hispanic or Latino ,57,13,44,76,22,72
2020,Buena Vista city,51530,Hispanic or Latino ,13,0,13,29,18,29
2020,Charlottesville city,51540,Hispanic or Latino ,794,189,605,140,108,135
2020,Chesapeake city,51550,Hispanic or Latino ,4250,2543,1707,427,390,402
2020,Colonial Heights city,51570,Hispanic or Latino ,406,190,216,78,84,103
2020,Covington city,51580,Hispanic or Latino ,74,54,20,56,49,30
2020,Danville city,51590,Hispanic or Latino ,596,313,283,88,126,77
2020,Emporia city,51595,Hispanic or Latino ,97,17,80,63,23,64
2020,Fairfax city,51600,Hispanic or Latino ,1325,859,466,139,138,134
2020,Falls Church city,51610,Hispanic or Latino ,489,178,311,169,129,175
2020,Franklin city,51620,Hispanic or Latino ,100,12,88,76,31,73
2020,Fredericksburg city,51630,Hispanic or Latino ,657,277,380,147,129,104
2020,Galax city,51640,Hispanic or Latino ,281,171,110,85,62,80
2020,Hampton city,51650,Hispanic or Latino ,2601,1207,1394,281,307,268
2020,Harrisonburg city,51660,Hispanic or Latino ,2662,830,1832,205,180,250
2020,Hopewell city,51670,Hispanic or Latino ,687,336,351,168,144,135
2020,Lexington city,51678,Hispanic or Latino ,15,0,15,25,18,25
2020,Lynchburg city,51680,Hispanic or Latino ,991,420,571,116,128,129
2020,Manassas city,51683,Hispanic or Latino ,3236,2075,1161,250,272,232
2020,Manassas Park city,51685,Hispanic or Latino ,1258,734,524,202,162,173
2020,Martinsville city,51690,Hispanic or Latino ,204,95,109,47,54,60
2020,Newport News city,51700,Hispanic or Latino ,5008,2196,2812,262,253,327
2020,Norfolk city,51710,Hispanic or Latino ,5637,1900,3737,401,293,382
2020,Norton city,51720,Hispanic or Latino ,0,0,0,13,13,13
2020,Petersburg city,51730,Hispanic or Latino ,483,112,371,96,69,105
2020,Poquoson city,51735,Hispanic or Latino ,165,66,99,89,45,95
2020,Portsmouth city,51740,Hispanic or Latino ,1474,543,931,236,151,246
2020,Radford city,51750,Hispanic or Latino ,63,33,30,39,41,29
2020,Richmond city,51760,Hispanic or Latino ,3720,864,2856,346,271,300
2020,Roanoke city,51770,Hispanic or Latino ,1846,481,1365,243,203,236
2020,Salem city,51775,Hispanic or Latino ,247,54,193,75,52,88
2020,Staunton city,51790,Hispanic or Latino ,174,45,129,63,38,64
2020,Suffolk city,51800,Hispanic or Latino ,1149,628,521,156,138,147
2020,Virginia Beach city,51810,Hispanic or Latino ,11757,5777,5980,567,571,577
2020,Waynesboro city,51820,Hispanic or Latino ,440,144,296,154,94,124
2020,Williamsburg city,51830,Hispanic or Latino ,178,26,152,83,30,80
2020,Winchester city,51840,Hispanic or Latino ,1116,271,845,201,145,181
2021,Accomack County,51001,Hispanic or Latino ,794,274,520,139,123,190
2021,Albemarle County,51003,Hispanic or Latino ,1847,764,1083,246,173,235
2021,Alleghany County,51005,Hispanic or Latino ,28,28,0,20,20,21
2021,Amelia County,51007,Hispanic or Latino ,116,116,0,48,48,21
2021,Amherst County,51009,Hispanic or Latino ,257,144,113,83,62,75
2021,Appomattox County,51011,Hispanic or Latino ,89,50,39,51,36,46
2021,Arlington County,51013,Hispanic or Latino ,12939,3673,9266,666,468,640
2021,Augusta County,51015,Hispanic or Latino ,549,313,236,119,104,120
2021,Bath County,51017,Hispanic or Latino ,0,0,0,13,13,13
2021,Bedford County,51019,Hispanic or Latino ,469,303,166,107,81,99
2021,Bland County,51021,Hispanic or Latino ,0,0,0,19,19,19
2021,Botetourt County,51023,Hispanic or Latino ,158,92,66,71,57,75
2021,Brunswick County,51025,Hispanic or Latino ,92,81,11,66,62,19
2021,Buchanan County,51027,Hispanic or Latino ,24,18,6,18,15,11
2021,Buckingham County,51029,Hispanic or Latino ,96,59,37,38,41,23
2021,Campbell County,51031,Hispanic or Latino ,506,232,274,105,133,91
2021,Caroline County,51033,Hispanic or Latino ,371,181,190,115,117,118
2021,Carroll County,51035,Hispanic or Latino ,210,191,19,86,88,31
2021,Charles City County,51036,Hispanic or Latino ,54,45,9,13,17,13
2021,Charlotte County,51037,Hispanic or Latino ,50,17,33,40,41,12
2021,Chesterfield County,51041,Hispanic or Latino ,8863,4915,3948,440,437,398
2021,Clarke County,51043,Hispanic or Latino ,153,118,35,59,52,41
2021,Craig County,51045,Hispanic or Latino ,0,0,0,13,13,13
2021,Culpeper County,51047,Hispanic or Latino ,1211,771,440,200,190,162
2021,Cumberland County,51049,Hispanic or Latino ,0,0,0,19,19,19
2021,Dickenson County,51051,Hispanic or Latino ,21,14,7,17,18,11
2021,Dinwiddie County,51053,Hispanic or Latino ,192,171,21,142,139,27
2021,Essex County,51057,Hispanic or Latino ,69,19,50,39,15,43
2021,Fairfax County,51059,Hispanic or Latino ,50583,26678,23905,1041,1058,1145
2021,Fauquier County,51061,Hispanic or Latino ,1818,1013,805,193,185,163
2021,Floyd County,51063,Hispanic or Latino ,133,48,85,105,30,101
2021,Fluvanna County,51065,Hispanic or Latino ,165,116,49,91,74,63
2021,Franklin County,51067,Hispanic or Latino ,370,119,251,116,55,121
2021,Frederick County,51069,Hispanic or Latino ,1902,1274,628,192,262,211
2021,Giles County,51071,Hispanic or Latino ,53,18,35,30,20,35
2021,Gloucester County,51073,Hispanic or Latino ,386,264,122,142,146,109
2021,Goochland County,51075,Hispanic or Latino ,210,155,55,78,104,44
2021,Grayson County,51077,Hispanic or Latino ,131,114,17,53,54,18
2021,Greene County,51079,Hispanic or Latino ,177,124,53,69,53,36
2021,Greensville County,51081,Hispanic or Latino ,15,8,7,14,10,9
2021,Halifax County,51083,Hispanic or Latino ,159,135,24,63,57,40
2021,Hanover County,51085,Hispanic or Latino ,1163,691,472,203,212,152
2021,Henrico County,51087,Hispanic or Latino ,5757,2214,3543,431,347,381
2021,Henry County,51089,Hispanic or Latino ,649,406,243,137,159,105
2021,Highland County,51091,Hispanic or Latino ,0,0,0,13,13,13
2021,Isle of Wight County,51093,Hispanic or Latino ,415,206,209,84,90,85
2021,James City County,51095,Hispanic or Latino ,1470,1099,371,235,232,134
2021,King and Queen County,51097,Hispanic or Latino ,24,18,6,21,17,10
2021,King George County,51099,Hispanic or Latino ,421,329,92,123,109,85
2021,King William County,51101,Hispanic or Latino ,87,87,0,58,58,21
2021,Lancaster County,51103,Hispanic or Latino ,75,75,0,43,43,21
2021,Lee County,51105,Hispanic or Latino ,39,7,32,38,9,40
2021,Loudoun County,51107,Hispanic or Latino ,14835,9014,5821,508,559,516
2021,Louisa County,51109,Hispanic or Latino ,290,202,88,95,89,62
2021,Lunenburg County,51111,Hispanic or Latino ,113,36,77,65,50,55
2021,Madison County,51113,Hispanic or Latino ,121,109,12,89,93,19
2021,Mathews County,51115,Hispanic or Latino ,44,44,0,32,32,19
2021,Mecklenburg County,51117,Hispanic or Latino ,193,37,156,79,30,75
2021,Middlesex County,51119,Hispanic or Latino ,175,51,124,93,52,101
2021,Montgomery County,51121,Hispanic or Latino ,919,311,608,175,120,145
2021,Nelson County,51125,Hispanic or Latino ,278,126,152,87,70,103
2021,New Kent County,51127,Hispanic or Latino ,338,196,142,111,88,104
2021,Northampton County,51131,Hispanic or Latino ,353,153,200,114,76,121
2021,Northumberland County,51133,Hispanic or Latino ,117,88,29,106,92,57
2021,Nottoway County,51135,Hispanic or Latino ,173,110,63,50,55,56
2021,Orange County,51137,Hispanic or Latino ,609,455,154,163,127,135
2021,Page County,51139,Hispanic or Latino ,149,148,1,45,46,3
2021,Patrick County,51141,Hispanic or Latino ,182,120,62,70,64,58
2021,Pittsylvania County,51143,Hispanic or Latino ,443,200,243,71,86,75
2021,Powhatan County,51145,Hispanic or Latino ,191,120,71,75,93,57
2021,Prince Edward County,51147,Hispanic or Latino ,78,34,44,121,59,72
2021,Prince George County,51149,Hispanic or Latino ,769,287,482,185,114,159
2021,Prince William County,51153,Hispanic or Latino ,29343,19528,9815,770,845,852
2021,Pulaski County,51155,Hispanic or Latino ,156,80,76,50,43,47
2021,Rappahannock County,51157,Hispanic or Latino ,36,36,0,30,30,19
2021,Richmond County,51159,Hispanic or Latino ,213,72,141,94,84,85
2021,Roanoke County,51161,Hispanic or Latino ,892,492,400,158,133,198
2021,Rockbridge County,51163,Hispanic or Latino ,142,111,31,56,54,30
2021,Rockingham County,51165,Hispanic or Latino ,1558,1095,463,181,168,160
2021,Russell County,51167,Hispanic or Latino ,25,25,0,46,46,25
2021,Scott County,51169,Hispanic or Latino ,16,11,5,25,21,8
2021,Shenandoah County,51171,Hispanic or Latino ,926,366,560,121,103,128
2021,Smyth County,51173,Hispanic or Latino ,241,128,113,58,69,39
2021,Southampton County,51175,Hispanic or Latino ,107,104,3,78,81,8
2021,Spotsylvania County,51177,Hispanic or Latino ,4198,2985,1213,315,298,290
2021,Stafford County,51179,Hispanic or Latino ,5511,3619,1892,355,402,381
2021,Surry County,51181,Hispanic or Latino ,56,32,24,39,49,22
2021,Sussex County,51183,Hispanic or Latino ,124,65,59,39,35,54
2021,Tazewell County,51185,Hispanic or Latino ,30,30,0,30,30,28
2021,Warren County,51187,Hispanic or Latino ,652,358,294,167,140,127
2021,Washington County,51191,Hispanic or Latino ,225,165,60,90,84,64
2021,Westmoreland County,51193,Hispanic or Latino ,472,227,245,128,125,135
2021,Wise County,51195,Hispanic or Latino ,61,26,35,53,28,56
2021,Wythe County,51197,Hispanic or Latino ,88,59,29,55,44,35
2021,York County,51199,Hispanic or Latino ,1598,791,807,194,221,175
2021,Alexandria city,51510,Hispanic or Latino ,8617,2184,6433,515,316,566
2021,Bristol city,51520,Hispanic or Latino ,202,60,142,108,41,135
2021,Buena Vista city,51530,Hispanic or Latino ,23,0,23,44,19,44
2021,Charlottesville city,51540,Hispanic or Latino ,789,194,595,130,115,114
2021,Chesapeake city,51550,Hispanic or Latino ,4323,2793,1530,350,364,331
2021,Colonial Heights city,51570,Hispanic or Latino ,417,181,236,70,88,107
2021,Covington city,51580,Hispanic or Latino ,66,39,27,59,40,40
2021,Danville city,51590,Hispanic or Latino ,637,325,312,97,143,119
2021,Emporia city,51595,Hispanic or Latino ,117,34,83,60,44,51
2021,Fairfax city,51600,Hispanic or Latino ,1466,820,646,159,170,161
2021,Falls Church city,51610,Hispanic or Latino ,437,160,277,110,92,98
2021,Franklin city,51620,Hispanic or Latino ,88,23,65,58,43,55
2021,Fredericksburg city,51630,Hispanic or Latino ,701,252,449,117,120,113
2021,Galax city,51640,Hispanic or Latino ,299,108,191,87,58,81
2021,Hampton city,51650,Hispanic or Latino ,2945,1260,1685,310,296,337
2021,Harrisonburg city,51660,Hispanic or Latino ,2791,852,1939,197,236,246
2021,Hopewell city,51670,Hispanic or Latino ,672,401,271,101,127,116
2021,Lexington city,51678,Hispanic or Latino ,50,18,32,49,27,41
2021,Lynchburg city,51680,Hispanic or Latino ,974,359,615,145,121,181
2021,Manassas city,51683,Hispanic or Latino ,3415,2307,1108,248,266,247
2021,Manassas Park city,51685,Hispanic or Latino ,1623,926,697,195,181,237
2021,Martinsville city,51690,Hispanic or Latino ,204,119,85,44,76,60
2021,Newport News city,51700,Hispanic or Latino ,5529,2467,3062,321,281,405
2021,Norfolk city,51710,Hispanic or Latino ,6095,1982,4113,471,321,437
2021,Norton city,51720,Hispanic or Latino ,0,0,0,13,13,13
2021,Petersburg city,51730,Hispanic or Latino ,537,170,367,92,88,124
2021,Poquoson city,51735,Hispanic or Latino ,151,73,78,95,47,91
2021,Portsmouth city,51740,Hispanic or Latino ,1598,777,821,193,172,207
2021,Radford city,51750,Hispanic or Latino ,112,27,85,63,32,66
2021,Richmond city,51760,Hispanic or Latino ,4628,1132,3496,321,275,333
2021,Roanoke city,51770,Hispanic or Latino ,2053,578,1475,200,176,217
2021,Salem city,51775,Hispanic or Latino ,249,75,174,74,52,82
2021,Staunton city,51790,Hispanic or Latino ,206,80,126,94,72,78
2021,Suffolk city,51800,Hispanic or Latino ,1385,873,512,156,155,170
2021,Virginia Beach city,51810,Hispanic or Latino ,12779,6344,6435,628,542,645
2021,Waynesboro city,51820,Hispanic or Latino ,632,292,340,144,107,141
2021,Williamsburg city,51830,Hispanic or Latino ,188,28,160,80,30,72
2021,Winchester city,51840,Hispanic or Latino ,1160,295,865,179,161,180
