year,locality,fips,race,est_all,est_owner,est_renter,moe_all,moe_owner,moe_renter
2010,Alabama,01,All,1821210,1295320,525890,5620,6640,4436
2010,Alaska,02,All,248248,160622,87626,1590,1682,1473
2010,Arizona,04,All,2326468,1568513,757955,7863,9416,5191
2010,Arkansas,05,All,1117154,756358,360796,4134,5730,3841
2010,California,06,All,12392852,7112050,5280802,22329,38732,20084
2010,Colorado,08,All,1918959,1296670,622289,5137,7548,4779
2010,Connecticut,09,All,1359218,939984,419234,2943,3901,3151
2010,Delaware,10,All,331639,244005,87634,1553,1963,1717
2010,District of Columbia,11,All,257317,111879,145438,1314,1617,1854
2010,Florida,12,All,7152844,4986629,2166215,25315,30282,10897
2010,Georgia,13,All,3468704,2331778,1136926,10407,14290,7301
2010,Hawaii,15,All,442267,262419,179848,1869,2610,2508
2010,Idaho,16,All,570283,404844,165439,2353,2571,2517
2010,Illinois,17,All,4769951,3300691,1469260,10573,15022,7825
2010,Indiana,18,All,2465402,1763781,701621,8128,10001,4786
2010,Iowa,19,All,1215954,889912,326042,3695,4614,2776
2010,Kansas,20,All,1101672,765049,336623,3620,4793,3389
2010,Kentucky,21,All,1676708,1171606,505102,5778,7076,4690
2010,Louisiana,22,All,1641165,1120015,521150,4814,6566,4697
2010,Maine,23,All,551125,402907,148218,2028,2686,2403
2010,Maryland,24,All,2121047,1464162,656885,4993,7374,4393
2010,Massachusetts,25,All,2512552,1608474,904078,5217,8057,5473
2010,Michigan,26,All,3843997,2852374,991623,10905,13228,5935
2010,Minnesota,27,All,2085917,1548127,537790,5466,6170,3039
2010,Mississippi,28,All,1081052,765685,315367,3748,4854,3319
2010,Missouri,29,All,2349955,1645022,704933,6352,8629,5162
2010,Montana,30,All,401328,277023,124305,1784,2200,1926
2010,Nebraska,31,All,711771,488034,223737,2613,3111,2293
2010,Nevada,32,All,979621,589050,390571,4292,5354,3187
2010,New Hampshire,33,All,513804,373237,140567,1978,2581,2011
2010,New Jersey,34,All,3176069,2126279,1049790,6296,10307,6596
2010,New Mexico,35,All,756112,526585,229527,2759,3824,2986
2010,New York,36,All,7205740,3977188,3228552,12418,17493,10448
2010,North Carolina,37,All,3626179,2468489,1157690,9539,13214,7059
2010,North Dakota,38,All,276642,184117,92525,1348,1471,1379
2010,Ohio,39,All,4552270,3149052,1403218,11259,15929,7539
2010,Oklahoma,40,All,1421705,969959,451746,4773,5787,3922
2010,Oregon,41,All,1499267,956144,543123,3846,5778,3408
2010,Pennsylvania,42,All,4940581,3508612,1431969,8826,14835,8986
2010,Rhode Island,44,All,410305,256545,153760,1765,2218,1898
2010,South Carolina,45,All,1741994,1217502,524492,6110,7586,4621
2010,South Dakota,46,All,315468,217250,98218,1738,1854,1489
2010,Tennessee,47,All,2443475,1699986,743489,6737,9740,6246
2010,Texas,48,All,8539206,5537188,3002018,17705,26806,12787
2010,Utah,49,All,859158,611498,247660,2763,4012,2692
2010,Vermont,50,All,256612,183162,73450,1197,1486,1333
2010,Virginia,51,All,2974481,2048209,926272,9637,12669,5823
2010,Washington,53,All,2577375,1669396,907979,5947,8874,5793
2010,West Virginia,54,All,740874,552855,188019,2731,3190,2807
2010,Wisconsin,55,All,2274611,1580608,694003,10182,10409,3561
2010,Wyoming,56,All,217688,152806,64882,1271,1578,1554
2010,Puerto Rico,72,All,1227039,888755,338284,3433,3429,3026
2011,Alabama,01,All,1831269,1294557,536712,6588,7449,4845
2011,Alaska,02,All,252920,162646,90274,1108,1521,1550
2011,Arizona,04,All,2344215,1560581,783634,8563,10298,6366
2011,Arkansas,05,All,1121386,756915,364471,4189,5051,3302
2011,California,06,All,12433172,7055642,5377530,22372,38013,19595
2011,Colorado,08,All,1941193,1295906,645287,5005,7722,4896
2011,Connecticut,09,All,1360115,937339,422776,3316,4501,3649
2011,Delaware,10,All,332837,242808,90029,1738,1826,1630
2011,District of Columbia,11,All,260136,111381,148755,1572,1525,1895
2011,Florida,12,All,7140096,4928508,2211588,26268,30925,9999
2011,Georgia,13,All,3490754,2332685,1158069,10839,13857,6671
2011,Hawaii,15,All,445513,261487,184026,2039,2753,2418
2011,Idaho,16,All,575497,406513,168984,2256,3074,2245
2011,Illinois,17,All,4773002,3279571,1493431,11359,15516,8364
2011,Indiana,18,All,2472870,1758192,714678,7194,9218,5001
2011,Iowa,19,All,1219137,890161,328976,3658,4348,2644
2011,Kansas,20,All,1104479,761874,342605,3939,4912,3007
2011,Kentucky,21,All,1681085,1168223,512862,5999,7407,4264
2011,Louisiana,22,All,1675097,1136619,538478,4498,6486,4476
2011,Maine,23,All,551601,400881,150720,2170,2282,2304
2011,Maryland,24,All,2128377,1461708,666669,5413,8215,5352
2011,Massachusetts,25,All,2522409,1604473,917936,4911,7753,5728
2011,Michigan,26,All,3825182,2812607,1012575,10705,13452,5804
2011,Minnesota,27,All,2094265,1542370,551895,5691,6690,3459
2011,Mississippi,28,All,1085062,766280,318782,3884,5485,3705
2011,Missouri,29,All,2354104,1636705,717399,6302,8111,5320
2011,Montana,30,All,403495,277913,125582,1965,2511,1986
2011,Nebraska,31,All,715703,488808,226895,2227,2946,2155
2011,Nevada,32,All,986741,582671,404070,4363,5276,3841
2011,New Hampshire,33,All,514869,373342,141527,1627,2318,1994
2011,New Jersey,34,All,3180854,2117923,1062931,6154,10329,6945
2011,New Mexico,35,All,762002,530162,231840,2771,3744,3017
2011,New York,36,All,7215687,3955232,3260455,12387,18033,9801
2011,North Carolina,37,All,3664119,2483743,1180376,10139,13439,6577
2011,North Dakota,38,All,278669,185422,93247,1413,1679,1410
2011,Ohio,39,All,4554007,3126406,1427601,11819,15833,7820
2011,Oklahoma,40,All,1432735,971958,460777,4527,4984,3549
2011,Oregon,41,All,1509554,951848,557706,3623,5944,4346
2011,Pennsylvania,42,All,4952566,3498381,1454185,9681,14656,8267
2011,Rhode Island,44,All,410475,254843,155632,1906,2625,2123
2011,South Carolina,45,All,1758732,1226873,531859,6067,7930,5473
2011,South Dakota,46,All,318466,218894,99572,1681,1838,1712
2011,Tennessee,47,All,2457997,1697062,760935,7240,10248,5841
2011,Texas,48,All,8667807,5586467,3081340,18866,29120,13892
2011,Utah,49,All,871358,616459,254899,2763,3954,2850
2011,Vermont,50,All,256711,183235,73476,1178,1276,1221
2011,Virginia,51,All,2991025,2046845,944180,8371,11768,6100
2011,Washington,53,All,2602568,1676249,926319,6193,8789,5051
2011,West Virginia,54,All,740080,549784,190296,2924,3477,2703
2011,Wisconsin,55,All,2279738,1574719,705019,9509,9398,3713
2011,Wyoming,56,All,219628,154888,64740,1260,1409,1375
2011,Puerto Rico,72,All,1230093,879333,350760,3882,3741,3228
2012,Alabama,01,All,1837576,1289324,548252,5762,6948,4296
2012,Alaska,02,All,252991,162891,90100,1316,1648,1423
2012,Arizona,04,All,2357158,1544719,812439,8210,9001,5494
2012,Arkansas,05,All,1128797,758814,369983,4114,5067,3924
2012,California,06,All,12466331,6978397,5487934,22603,37912,19137
2012,Colorado,08,All,1962753,1293951,668802,5257,7462,5035
2012,Connecticut,09,All,1360184,929560,430624,3254,4125,3459
2012,Delaware,10,All,334076,242788,91288,1667,2110,1812
2012,District of Columbia,11,All,261192,110853,150339,1566,1505,1834
2012,Florida,12,All,7147013,4865400,2281613,25266,29099,9501
2012,Georgia,13,All,3508477,2315287,1193190,10358,13905,7470
2012,Hawaii,15,All,447453,260268,187185,1918,2617,2616
2012,Idaho,16,All,577648,404863,172785,2248,2988,2428
2012,Illinois,17,All,4774275,3248521,1525754,11692,15690,8115
2012,Indiana,18,All,2478846,1749798,729048,6570,9151,5352
2012,Iowa,19,All,1223509,888331,335178,3819,4923,3083
2012,Kansas,20,All,1109391,756782,352609,3369,4281,3150
2012,Kentucky,21,All,1691716,1162207,529509,5160,7304,4389
2012,Louisiana,22,All,1696499,1142965,553534,4736,6678,4929
2012,Maine,23,All,553208,398593,154615,1937,2671,2411
2012,Maryland,24,All,2138806,1456472,682334,4791,7283,4596
2012,Massachusetts,25,All,2525694,1595959,929735,5174,7765,5085
2012,Michigan,26,All,3818931,2780213,1038718,9420,11691,5226
2012,Minnesota,27,All,2101875,1534719,567156,4843,5624,2938
2012,Mississippi,28,All,1087791,760513,327278,4787,5661,3675
2012,Missouri,29,All,2358270,1626389,731881,6239,8065,4831
2012,Montana,30,All,405508,277816,127692,1562,2000,1616
2012,Nebraska,31,All,721026,487740,233286,2566,3398,2509
2012,Nevada,32,All,992896,574281,418615,4496,5613,3425
2012,New Hampshire,33,All,516845,372021,144824,1886,2148,1991
2012,New Jersey,34,All,3186878,2108166,1078712,6182,10428,6723
2012,New Mexico,35,All,763844,526495,237349,2469,3673,2928
2012,New York,36,All,7230896,3940688,3290208,10206,16805,10185
2012,North Carolina,37,All,3693221,2477360,1215861,10521,13171,6264
2012,North Dakota,38,All,282667,187567,95100,1454,1653,1422
2012,Ohio,39,All,4555709,3098283,1457426,12250,16809,7561
2012,Oklahoma,40,All,1439292,971017,468275,3830,5246,3784
2012,Oregon,41,All,1512718,945824,566894,4455,5847,4654
2012,Pennsylvania,42,All,4959633,3478602,1481031,9716,13912,7666
2012,Rhode Island,44,All,410639,251217,159422,1840,2414,2145
2012,South Carolina,45,All,1768255,1228200,540055,6584,7713,5079
2012,South Dakota,46,All,320467,219882,100585,1449,1818,1587
2012,Tennessee,47,All,2468841,1687700,781141,7308,10071,5852
2012,Texas,48,All,8782598,5609007,3173591,17197,27322,15088
2012,Utah,49,All,880873,620475,260398,2335,3806,2770
2012,Vermont,50,All,256830,182744,74086,1395,1529,1365
2012,Virginia,51,All,3006219,2038207,968012,8230,11329,6095
2012,Washington,53,All,2619995,1671388,948607,5330,7981,5568
2012,West Virginia,54,All,742674,547370,195304,2728,3342,2474
2012,Wisconsin,55,All,2286339,1568375,717964,8155,8703,3968
2012,Wyoming,56,All,221479,155659,65820,1524,1659,1398
2012,Puerto Rico,72,All,1217584,861531,356053,3157,3135,3106
2013,Alabama,01,All,1838683,1281604,557079,5863,7354,4978
2013,Alaska,02,All,251899,160803,91096,1331,1505,1556
2013,Arizona,04,All,2370289,1527475,842814,8769,9095,6366
2013,Arkansas,05,All,1129723,753793,375930,4304,5190,3489
2013,California,06,All,12542460,6939104,5603356,20542,35627,19367
2013,Colorado,08,All,1977591,1292645,684946,4762,6869,5079
2013,Connecticut,09,All,1355849,919488,436361,3506,4857,3608
2013,Delaware,10,All,335707,243223,92484,1773,1906,1574
2013,District of Columbia,11,All,263649,111070,152579,1588,1697,2010
2013,Florida,12,All,7158980,4806997,2351983,25790,29484,8867
2013,Georgia,13,All,3518097,2292030,1226067,10972,14459,7382
2013,Hawaii,15,All,449771,259270,190501,1783,2333,2091
2013,Idaho,16,All,579797,404734,175063,2551,3109,2560
2013,Illinois,17,All,4772723,3220038,1552685,11056,15145,6626
2013,Indiana,18,All,2481793,1736481,745312,6580,8786,4849
2013,Iowa,19,All,1226547,885942,340605,3433,4454,2885
2013,Kansas,20,All,1110440,749737,360703,3304,3690,2815
2013,Kentucky,21,All,1694996,1159188,535808,5311,6863,3677
2013,Louisiana,22,All,1707852,1143500,564352,5031,7060,4443
2013,Maine,23,All,553823,397512,156311,2219,2611,2266
2013,Maryland,24,All,2146240,1450893,695347,5641,7766,4831
2013,Massachusetts,25,All,2530147,1585259,944888,5224,7920,5924
2013,Michigan,26,All,3823280,2757062,1066218,8829,11552,5472
2013,Minnesota,27,All,2107232,1528272,578960,5485,6676,3458
2013,Mississippi,28,All,1088073,755132,332941,4665,5433,4053
2013,Missouri,29,All,2360131,1613941,746190,6252,8048,4584
2013,Montana,30,All,405525,276939,128586,2059,2112,1495
2013,Nebraska,31,All,725787,486533,239254,2583,3334,2598
2013,Nevada,32,All,999016,566921,432095,4087,4999,3658
2013,New Hampshire,33,All,518245,370173,148072,2172,2554,2113
2013,New Jersey,34,All,3186418,2091065,1095353,6092,9549,6170
2013,New Mexico,35,All,761938,523344,238594,3017,3680,2953
2013,New York,36,All,7234743,3923505,3311238,12096,17153,9680
2013,North Carolina,37,All,3715565,2466388,1249177,9398,12778,7587
2013,North Dakota,38,All,287270,189805,97465,1270,1478,1511
2013,Ohio,39,All,4557655,3074792,1482863,12660,16404,7474
2013,Oklahoma,40,All,1444081,968736,475345,3776,4698,3323
2013,Oregon,41,All,1516456,940143,576313,4721,6347,4826
2013,Pennsylvania,42,All,4958427,3462512,1495915,8583,12951,7985
2013,Rhode Island,44,All,410058,250814,159244,1761,2446,2406
2013,South Carolina,45,All,1780251,1230181,550070,5580,7149,4441
2013,South Dakota,46,All,323136,219872,103264,1682,1857,1452
2013,Tennessee,47,All,2475195,1677205,797990,6759,10034,6611
2013,Texas,48,All,8886471,5623552,3262919,18279,26405,13432
2013,Utah,49,All,886770,621854,264916,2762,4138,2942
2013,Vermont,50,All,257004,182537,74467,1218,1320,1128
2013,Virginia,51,All,3022739,2033102,989637,8232,11939,6638
2013,Washington,53,All,2629126,1661427,967699,5804,8639,6172
2013,West Virginia,54,All,741390,544059,197331,3047,3533,3025
2013,Wisconsin,55,All,2288332,1558846,729486,6551,7692,4191
2013,Wyoming,56,All,222846,156202,66644,1618,1817,1899
2013,Puerto Rico,72,All,1230868,862880,367988,3660,3679,3024
2014,Alabama,01,All,1842174,1274196,567978,5671,6461,3897
2014,Alaska,02,All,251678,159415,92263,1303,1498,1413
2014,Arizona,04,All,2387246,1513294,873952,8050,9450,5463
2014,Arkansas,05,All,1132488,753620,378868,4067,4673,3729
2014,California,06,All,12617280,6908925,5708355,20413,34460,17527
2014,Colorado,08,All,1998314,1295048,703266,5078,6834,4658
2014,Connecticut,09,All,1356206,913043,443163,2983,4507,3378
2014,Delaware,10,All,339046,242860,96186,1589,2020,1681
2014,District of Columbia,11,All,267415,111198,156217,1579,1568,1852
2014,Florida,12,All,7217508,4772944,2444564,24923,29238,10391
2014,Georgia,13,All,3540690,2272001,1268689,10836,14319,7198
2014,Hawaii,15,All,450299,257315,192984,1824,2161,1865
2014,Idaho,16,All,585259,404981,180278,2354,3067,2602
2014,Illinois,17,All,4778633,3194707,1583926,11513,15979,7482
2014,Indiana,18,All,2492183,1730954,761229,6801,9333,5434
2014,Iowa,19,All,1232228,884984,347244,3504,4590,3002
2014,Kansas,20,All,1112335,746789,365546,3321,4208,2902
2014,Kentucky,21,All,1702235,1152012,550223,5177,7286,4576
2014,Louisiana,22,All,1718876,1139756,579120,4824,6731,4664
2014,Maine,23,All,553086,395074,158012,2062,2798,2283
2014,Maryland,24,All,2155983,1445880,710103,5424,7677,4525
2014,Massachusetts,25,All,2538485,1580938,957547,4546,7666,5492
2014,Michigan,26,All,3827880,2738012,1089868,9311,12390,5918
2014,Minnesota,27,All,2115337,1525201,590136,5381,6493,3324
2014,Mississippi,28,All,1092627,752825,339802,4203,5060,3636
2014,Missouri,29,All,2361232,1604282,756950,6423,8061,5339
2014,Montana,30,All,407797,276201,131596,1827,2280,1973
2014,Nebraska,31,All,731347,486036,245311,2551,3115,2177
2014,Nevada,32,All,1005958,559911,446047,4387,4863,4127
2014,New Hampshire,33,All,519580,369160,150420,2032,2439,2048
2014,New Jersey,34,All,3188498,2073915,1114583,6117,9960,6766
2014,New Mexico,35,All,764684,521278,243406,2848,3852,2804
2014,New York,36,All,7255528,3906991,3348537,10898,15535,9594
2014,North Carolina,37,All,3742514,2461741,1280773,9967,13326,7026
2014,North Dakota,38,All,292616,190620,101996,1578,1601,1550
2014,Ohio,39,All,4570015,3056206,1513809,10810,14821,7184
2014,Oklahoma,40,All,1450117,964573,485544,3649,4453,3576
2014,Oregon,41,All,1522988,936806,586182,4103,5825,4559
2014,Pennsylvania,42,All,4957736,3446230,1511506,9670,15082,8256
2014,Rhode Island,44,All,409569,246829,162740,1699,2163,2072
2014,South Carolina,45,All,1795715,1232154,563561,5585,7082,4509
2014,South Dakota,46,All,327101,222589,104512,1655,1662,1513
2014,Tennessee,47,All,2487349,1669953,817396,6925,9792,5718
2014,Texas,48,All,9013582,5652542,3361040,16898,27547,15065
2014,Utah,49,All,896194,624605,271589,2411,3803,2614
2014,Vermont,50,All,257252,182417,74835,1155,1088,1193
2014,Virginia,51,All,3041710,2028244,1013466,9225,12264,5608
2014,Washington,53,All,2645396,1658540,986856,5534,8615,6195
2014,West Virginia,54,All,742359,541607,200752,2723,3641,2956
2014,Wisconsin,55,All,2293250,1551769,741481,5079,7017,4349
2014,Wyoming,56,All,225514,156289,69225,1392,1616,1617
2014,Puerto Rico,72,All,1241454,862198,379256,2991,3626,3375
2015,Alabama,01,All,1848325,1269145,579180,5710,7204,4673
2015,Alaska,02,All,250969,159056,91913,1362,1485,1393
2015,Arizona,04,All,2412212,1513861,898351,7194,9091,5792
2015,Arkansas,05,All,1138025,752312,385713,3839,5308,3755
2015,California,06,All,12717801,6909176,5808625,18352,36701,20821
2015,Colorado,08,All,2024468,1302266,722202,4437,7519,5365
2015,Connecticut,09,All,1352583,906227,446356,3661,5290,3646
2015,Delaware,10,All,344022,244849,99173,1500,1997,1683
2015,District of Columbia,11,All,273390,112750,160640,1578,1534,1687
2015,Florida,12,All,7300494,4765260,2535234,24106,29991,11353
2015,Georgia,13,All,3574362,2263697,1310665,9977,13968,8813
2015,Hawaii,15,All,450572,256389,194183,1876,2376,2421
2015,Idaho,16,All,589320,405865,183455,2000,3273,2644
2015,Illinois,17,All,4786388,3177705,1608683,11295,15848,8148
2015,Indiana,18,All,2501937,1726338,775599,7578,9823,4948
2015,Iowa,19,All,1236409,883808,352601,3802,4637,2777
2015,Kansas,20,All,1113472,742564,370908,3874,4710,3261
2015,Kentucky,21,All,1708499,1148752,559747,5144,7067,4197
2015,Louisiana,22,All,1727919,1136709,591210,4615,7040,4668
2015,Maine,23,All,553284,393995,159289,2234,2425,2116
2015,Maryland,24,All,2166389,1447662,718727,5118,7892,5483
2015,Massachusetts,25,All,2549721,1583667,966054,4643,8036,5508
2015,Michigan,26,All,3841148,2728815,1112333,7758,11496,5378
2015,Minnesota,27,All,2124745,1522618,602127,5711,7316,4014
2015,Mississippi,28,All,1096593,749982,346611,4034,5467,3472
2015,Missouri,29,All,2364688,1590020,774668,6201,7835,4517
2015,Montana,30,All,409394,275063,134331,1852,2320,1841
2015,Nebraska,31,All,736613,487948,248665,2628,3372,2530
2015,Nevada,32,All,1016709,559793,456916,4083,4854,3766
2015,New Hampshire,33,All,520251,369175,151076,1779,2515,2110
2015,New Jersey,34,All,3189486,2056107,1133379,6199,9833,6088
2015,New Mexico,35,All,763603,519676,243927,3312,4210,2801
2015,New York,36,All,7262279,3894722,3367557,12603,17001,8640
2015,North Carolina,37,All,3775581,2459072,1316509,9491,13933,7828
2015,North Dakota,38,All,299638,192185,107453,1462,1653,1650
2015,Ohio,39,All,4585084,3040444,1544640,10087,15067,7953
2015,Oklahoma,40,All,1455321,961384,493937,3048,3651,2527
2015,Oregon,41,All,1533430,939637,593793,4037,5874,3601
2015,Pennsylvania,42,All,4958859,3431790,1527069,9151,14359,8387
2015,Rhode Island,44,All,410602,246909,163693,1442,2109,2148
2015,South Carolina,45,All,1815094,1244998,570096,5681,7296,4999
2015,South Dakota,46,All,330858,225219,105639,1744,1944,1512
2015,Tennessee,47,All,2504556,1672329,832227,6998,10220,6150
2015,Texas,48,All,9149196,5693770,3455426,16225,28353,16021
2015,Utah,49,All,906292,629584,276708,2641,4103,3281
2015,Vermont,50,All,257167,182584,74583,1148,1500,1470
2015,Virginia,51,All,3062783,2027005,1035778,7957,12128,6548
2015,Washington,53,All,2668912,1668071,1000841,6381,8989,6122
2015,West Virginia,54,All,740890,537266,203624,2755,3861,3107
2015,Wisconsin,55,All,2299107,1547197,751910,5595,7089,3624
2015,Wyoming,56,All,226865,156675,70190,1265,1588,1396
2015,Puerto Rico,72,All,1244202,857710,386492,3939,4239,3995
2016,Alabama,01,All,1851061,1267824,583237,5444,7066,5099
2016,Alaska,02,All,250235,159313,90922,1399,1295,1238
2016,Arizona,04,All,2448919,1531878,917041,7179,9913,5838
2016,Arkansas,05,All,1141480,749452,392028,3883,4707,3621
2016,California,06,All,12807387,6929007,5878380,18852,37726,22644
2016,Colorado,08,All,2051616,1320617,730999,4112,6915,4895
2016,Connecticut,09,All,1354713,900223,454490,3509,5427,3843
2016,Delaware,10,All,348051,246940,101111,1568,1911,1655
2016,District of Columbia,11,All,276546,112672,163874,1294,1538,1674
2016,Florida,12,All,7393262,4787320,2605942,22885,29348,11008
2016,Georgia,13,All,3611706,2266411,1345295,10039,14745,7580
2016,Hawaii,15,All,452030,259854,192176,1944,2021,2176
2016,Idaho,16,All,596107,410538,185569,2347,3139,2464
2016,Illinois,17,All,4802124,3167081,1635043,9992,15008,8087
2016,Indiana,18,All,2513828,1727511,786317,7023,9670,5259
2016,Iowa,19,All,1242641,883119,359522,3378,4542,3280
2016,Kansas,20,All,1115858,740343,375515,3981,4744,2689
2016,Kentucky,21,All,1718217,1147903,570314,4613,6864,4248
2016,Louisiana,22,All,1731398,1132785,598613,5025,6987,4567
2016,Maine,23,All,551109,393966,157143,1988,2928,2067
2016,Maryland,24,All,2177492,1447783,729709,5012,7870,4990
2016,Massachusetts,25,All,2558889,1588743,970146,5087,8315,5337
2016,Michigan,26,All,3860394,2732051,1128343,7938,11566,6269
2016,Minnesota,27,All,2135310,1525611,609699,5896,7469,4144
2016,Mississippi,28,All,1098803,746399,352404,3985,5193,3633
2016,Missouri,29,All,2372362,1584735,787627,6141,8308,5815
2016,Montana,30,All,412653,277307,135346,1666,2223,1723
2016,Nebraska,31,All,741581,489806,251775,2349,2968,1879
2016,Nevada,32,All,1030701,564787,465914,3828,4889,4091
2016,New Hampshire,33,All,521373,368553,152820,2113,2832,2219
2016,New Jersey,34,All,3195014,2047794,1147220,6205,10396,6190
2016,New Mexico,35,All,762551,516819,245732,2748,3406,2906
2016,New York,36,All,7266187,3894613,3371574,12415,17802,10018
2016,North Carolina,37,All,3815392,2471723,1343669,9701,14278,8739
2016,North Dakota,38,All,305163,193909,111254,1843,1837,1625
2016,Ohio,39,All,4601449,3035485,1565964,10577,16823,9663
2016,Oklahoma,40,All,1461500,960161,501339,3382,3557,2713
2016,Oregon,41,All,1545745,948587,597158,4059,5560,4533
2016,Pennsylvania,42,All,4961929,3425706,1536223,11212,15940,7336
2016,Rhode Island,44,All,410240,244748,165492,1914,2263,2032
2016,South Carolina,45,All,1839041,1258661,580380,4955,7479,5378
2016,South Dakota,46,All,333536,226145,107391,1661,2172,1711
2016,Tennessee,47,All,2522204,1673043,849161,6684,10333,6513
2016,Texas,48,All,9289554,5747458,3542096,15575,28451,15694
2016,Utah,49,All,918367,638767,279600,2610,3814,3238
2016,Vermont,50,All,257107,181461,75646,1081,1377,1241
2016,Virginia,51,All,3090178,2032761,1057417,7622,12333,6827
2016,Washington,53,All,2696606,1683381,1013225,6024,9181,5810
2016,West Virginia,54,All,739397,535940,203457,2753,3693,2648
2016,Wisconsin,55,All,2310246,1547633,762613,4656,6877,4457
2016,Wyoming,56,All,226985,155741,71244,1680,1779,1499
2016,Puerto Rico,72,All,1237180,848735,388445,3604,3587,3163
2017,Alabama,01,All,1856695,1273217,583478,5529,6953,4150
2017,Alaska,02,All,252536,160854,91682,1271,1746,1570
2017,Arizona,04,All,2482311,1567338,914973,6429,8662,5719
2017,Arkansas,05,All,1147291,752633,394658,4059,5242,3133
2017,California,06,All,12888128,7024315,5863813,18518,36191,20710
2017,Colorado,08,All,2082531,1348004,734527,4593,7195,4655
2017,Connecticut,09,All,1361755,906798,454957,3669,5014,3442
2017,Delaware,10,All,352357,251098,101259,1633,1990,1466
2017,District of Columbia,11,All,277985,115795,162190,1316,1423,1573
2017,Florida,12,All,7510882,4868827,2642055,23856,29492,12671
2017,Georgia,13,All,3663104,2306772,1356332,8973,13415,8584
2017,Hawaii,15,All,455502,264622,190880,2028,2718,1989
2017,Idaho,16,All,609124,421439,187685,2433,3119,2477
2017,Illinois,17,All,4818452,3185142,1633310,9284,14651,7940
2017,Indiana,18,All,2537189,1747513,789676,7046,10253,5347
2017,Iowa,19,All,1251587,889285,362302,3914,5411,3323
2017,Kansas,20,All,1121943,745441,376502,3987,4454,3238
2017,Kentucky,21,All,1724514,1155576,568938,4759,7284,4875
2017,Louisiana,22,All,1737645,1137462,600183,5467,7248,4370
2017,Maine,23,All,554061,399142,154919,2330,2732,1695
2017,Maryland,24,All,2181093,1456758,724335,4999,7730,4974
2017,Massachusetts,25,All,2585715,1612329,973386,5003,7758,5833
2017,Michigan,26,All,3888646,2760156,1128490,8344,11272,6408
2017,Minnesota,27,All,2153202,1542041,611161,5375,6698,3527
2017,Mississippi,28,All,1103514,751649,351865,4104,5395,3569
2017,Missouri,29,All,2386203,1597325,788878,6827,8714,5634
2017,Montana,30,All,419975,284168,135807,2155,2256,1775
2017,Nebraska,31,All,748405,494189,254216,2213,3273,2633
2017,Nevada,32,All,1052249,582614,469635,3833,4927,3036
2017,New Hampshire,33,All,526710,372304,154406,2332,2503,2224
2017,New Jersey,34,All,3199111,2052073,1147038,7594,10470,5890
2017,New Mexico,35,All,770435,522930,247505,3318,3802,3232
2017,New York,36,All,7302710,3942483,3360227,13551,17785,9028
2017,North Carolina,37,All,3874346,2517896,1356450,8789,13596,8052
2017,North Dakota,38,All,311525,197083,114442,1685,1656,1763
2017,Ohio,39,All,4633145,3060473,1572672,10307,16016,8617
2017,Oklahoma,40,All,1468971,964466,504505,2956,3968,3351
2017,Oregon,41,All,1571631,969453,602178,4213,5773,4181
2017,Pennsylvania,42,All,5007442,3456360,1551082,10133,15409,8294
2017,Rhode Island,44,All,412028,247291,164737,1756,2140,1817
2017,South Carolina,45,All,1871307,1284532,586775,5896,8058,5631
2017,South Dakota,46,All,339458,230657,108801,1687,1919,1716
2017,Tennessee,47,All,2547194,1688565,858629,6362,10002,6492
2017,Texas,48,All,9430419,5851046,3579373,18380,29465,15650
2017,Utah,49,All,938365,653429,284936,2549,4172,2832
2017,Vermont,50,All,258535,182321,76214,1156,1518,1359
2017,Virginia,51,All,3105636,2055073,1050563,8001,12494,7237
2017,Washington,53,All,2755697,1726899,1028798,6338,9300,6136
2017,West Virginia,54,All,737671,536655,201016,2866,4015,2871
2017,Wisconsin,55,All,2328754,1559308,769446,6459,8215,4108
2017,Wyoming,56,All,230237,159336,70901,1679,1558,1995
2017,Puerto Rico,72,All,1222606,837529,385077,3569,3874,3677
2018,Alabama,01,All,1860269,1275223,585046,6522,8217,4901
2018,Alaska,02,All,253462,162172,91290,1351,1733,1574
2018,Arizona,04,All,2524300,1606065,918235,6840,8371,5470
2018,Arkansas,05,All,1152175,756431,395744,4053,4913,3653
2018,California,06,All,12965435,7085435,5880000,19785,38161,21418
2018,Colorado,08,All,2113387,1371145,742242,4542,7578,4816
2018,Connecticut,09,All,1367374,907134,460240,3671,4800,3488
2018,Delaware,10,All,357765,254308,103457,1676,1711,1721
2018,District of Columbia,11,All,281322,117571,163751,1459,1429,1680
2018,Florida,12,All,7621760,4954601,2667159,23468,29239,10585
2018,Georgia,13,All,3709488,2339981,1369507,9402,12955,7780
2018,Hawaii,15,All,456782,266362,190420,2081,2398,2021
2018,Idaho,16,All,618331,428300,190031,2254,3287,2273
2018,Illinois,17,All,4830038,3189035,1641003,9750,15471,8379
2018,Indiana,18,All,2553818,1760732,793086,7375,10080,5471
2018,Iowa,19,All,1256855,894152,362703,4146,5490,3656
2018,Kansas,20,All,1124549,745845,378704,4096,5377,3641
2018,Kentucky,21,All,1728681,1157631,571050,5065,7335,4904
2018,Louisiana,22,All,1736021,1133084,602937,5617,7564,4930
2018,Maine,23,All,556955,402119,154836,2215,2429,1770
2018,Maryland,24,All,2192518,1463941,728577,5412,8019,5288
2018,Massachusetts,25,All,2601914,1621053,980861,4637,7613,5827
2018,Michigan,26,All,3909509,2777114,1132395,9207,12410,5849
2018,Minnesota,27,All,2167801,1551290,616511,5845,7535,3315
2018,Mississippi,28,All,1105576,754018,351558,4591,5147,4066
2018,Missouri,29,All,2396271,1601845,794426,6753,8786,5404
2018,Montana,30,All,423240,286553,136687,2033,2349,2049
2018,Nebraska,31,All,754063,498567,255496,2749,3369,2353
2018,Nevada,32,All,1075930,600520,475410,3357,4591,3771
2018,New Hampshire,33,All,528078,374758,153320,2194,2713,2254
2018,New Jersey,34,All,3213362,2054413,1158949,6651,10703,6584
2018,New Mexico,35,All,775651,524242,251409,3254,3787,2841
2018,New York,36,All,7316537,3943356,3373181,13711,19567,9961
2018,North Carolina,37,All,3918597,2548705,1369892,8585,14468,8555
2018,North Dakota,38,All,314903,197347,117556,1937,2158,1793
2018,Ohio,39,All,4654075,3071227,1582848,10201,15859,8901
2018,Oklahoma,40,All,1474620,967038,507582,3107,3965,3108
2018,Oregon,41,All,1591835,985523,606312,4000,5720,4504
2018,Pennsylvania,42,All,5025132,3467467,1557665,9263,14310,7200
2018,Rhode Island,44,All,410885,247565,163320,1911,2267,2099
2018,South Carolina,45,All,1894711,1305349,589362,6012,7789,5279
2018,South Dakota,46,All,341565,232636,108929,2003,1851,1522
2018,Tennessee,47,All,2567061,1701159,865902,6524,10459,6917
2018,Texas,48,All,9553046,5917771,3635275,18343,29037,15575
2018,Utah,49,All,957619,668985,288634,2261,3512,2920
2018,Vermont,50,All,259589,183570,76019,1229,1384,1117
2018,Virginia,51,All,3128415,2070879,1057536,7210,11132,6347
2018,Washington,53,All,2800423,1756552,1043871,5474,8776,6288
2018,West Virginia,54,All,734676,535880,198796,2910,3642,2660
2018,Wisconsin,55,All,2343129,1568040,775089,6471,8417,4474
2018,Wyoming,56,All,230630,160121,70509,1390,1571,1465
2018,Puerto Rico,72,All,1205075,820405,384670,4286,4468,3241
2019,Alabama,01,All,1867893,1284748,583145,5799,7548,5328
2019,Alaska,02,All,253346,162996,90350,1463,1930,1815
2019,Arizona,04,All,2571268,1656756,914512,6669,9014,5115
2019,Arkansas,05,All,1158071,759455,398616,4555,5101,3696
2019,California,06,All,13044266,7154580,5889686,20333,37872,21311
2019,Colorado,08,All,2148994,1401735,747259,5236,7774,5909
2019,Connecticut,09,All,1370746,905681,465065,3770,5660,4134
2019,Delaware,10,All,363322,258780,104542,1674,2277,1949
2019,District of Columbia,11,All,284386,118367,166019,1503,1823,1923
2019,Florida,12,All,7736311,5058841,2677470,23882,30826,13189
2019,Georgia,13,All,3758798,2377773,1381025,9973,14949,8549
2019,Hawaii,15,All,459424,270377,189047,2081,2631,2280
2019,Idaho,16,All,630008,440716,189292,2522,3147,2642
2019,Illinois,17,All,4846134,3202715,1643419,10459,16823,10182
2019,Indiana,18,All,2570419,1776182,794237,7538,10208,5512
2019,Iowa,19,All,1265473,899223,366250,4009,5033,3003
2019,Kansas,20,All,1129227,748123,381104,4275,5351,3181
2019,Kentucky,21,All,1734618,1166031,568587,4886,7540,4771
2019,Louisiana,22,All,1739497,1141205,598292,5804,7913,4725
2019,Maine,23,All,559921,404759,155162,2546,2909,2162
2019,Maryland,24,All,2205204,1475149,730055,5389,8312,5419
2019,Massachusetts,25,All,2617497,1632765,984732,4909,8539,5635
2019,Michigan,26,All,3935041,2802699,1132342,8563,11218,5585
2019,Minnesota,27,All,2185603,1564870,620733,5103,6577,3380
2019,Mississippi,28,All,1104394,752841,351553,4685,5673,3816
2019,Missouri,29,All,2414521,1611986,802535,5679,8262,5418
2019,Montana,30,All,427871,291471,136400,1682,2164,2173
2019,Nebraska,31,All,759176,501679,257497,2333,2973,2236
2019,Nevada,32,All,1098602,618605,479997,3380,4381,3468
2019,New Hampshire,33,All,532037,378178,153859,2311,2687,2373
2019,New Jersey,34,All,3231874,2064240,1167634,7167,11449,7419
2019,New Mexico,35,All,780249,527896,252353,3071,3932,3017
2019,New York,36,All,7343234,3957802,3385432,14943,21382,10667
2019,North Carolina,37,All,3965482,2585934,1379548,10327,14825,8561
2019,North Dakota,38,All,318322,198482,119840,1899,1820,1654
2019,Ohio,39,All,4676358,3089046,1587312,10659,16610,8144
2019,Oklahoma,40,All,1480061,971122,508939,2803,3448,3090
2019,Oregon,41,All,1611982,1005896,606086,3890,5843,4619
2019,Pennsylvania,42,All,5053106,3480978,1572128,9552,15971,9279
2019,Rhode Island,44,All,410489,249492,160997,1970,2280,2263
2019,South Carolina,45,All,1921862,1333839,588023,5983,8119,4930
2019,South Dakota,46,All,344397,233607,110790,1938,2021,1389
2019,Tennessee,47,All,2597292,1722247,875045,6331,10007,6452
2019,Texas,48,All,9691647,6004802,3686845,18858,29081,15225
2019,Utah,49,All,977313,685699,291614,2381,4025,3168
2019,Vermont,50,All,260029,183999,76030,1329,1916,1442
2019,Virginia,51,All,3151045,2087711,1063334,7497,12137,7563
2019,Washington,53,All,2848396,1793239,1055157,5857,8958,6286
2019,West Virginia,54,All,732585,536153,196432,2601,3708,2946
2019,Wisconsin,55,All,2358156,1580939,777217,7031,8718,3928
2019,Wyoming,56,All,230101,161972,68129,1458,1715,1663
2019,Puerto Rico,72,All,1192654,812625,380029,3406,4003,4032
2020,Alabama,01,All,1888504,1306505,581999,5749,8890,5958
2020,Alaska,02,All,255173,165376,89797,1326,1894,1820
2020,Arizona,04,All,2643430,1727176,916254,6290,8998,6465
2020,Arkansas,05,All,1170544,770477,400067,4411,6160,4590
2020,California,06,All,13103114,7241318,5861796,18542,35711,20328
2020,Colorado,08,All,2137402,1415324,722078,4703,7389,6558
2020,Connecticut,09,All,1385437,915408,470029,3268,5015,4548
2020,Delaware,10,All,370953,264915,106038,1823,2572,2162
2020,District of Columbia,11,All,288307,122648,165659,1319,2322,2394
2020,Florida,12,All,7931313,5250878,2680435,23200,29168,14277
2020,Georgia,13,All,3830264,2453159,1377105,8096,15000,9408
2020,Hawaii,15,All,467932,282037,185895,1883,2959,2657
2020,Idaho,16,All,649299,459428,189871,2233,3829,3029
2020,Illinois,17,All,4884061,3237778,1646283,8585,15169,9436
2020,Indiana,18,All,2602770,1808293,794477,6793,9974,6016
2020,Iowa,19,All,1273941,906967,366974,4037,5085,2779
2020,Kansas,20,All,1141985,756309,385676,4096,5042,3257
2020,Kentucky,21,All,1748053,1181021,567032,5379,8065,4973
2020,Louisiana,22,All,1751956,1167628,584328,5502,7916,5798
2020,Maine,23,All,569551,414939,154612,2285,2907,2332
2020,Maryland,24,All,2230527,1495828,734699,4131,7636,5861
2020,Massachusetts,25,All,2646980,1654892,992088,4188,8181,6034
2020,Michigan,26,All,3980408,2855485,1124923,8401,11537,6434
2020,Minnesota,27,All,2207988,1588611,619377,5616,7339,4195
2020,Mississippi,28,All,1116649,767972,348677,4463,5809,4195
2020,Missouri,29,All,2440212,1637374,802838,6698,9327,5646
2020,Montana,30,All,436048,298728,137320,1975,2421,2273
2020,Nebraska,31,All,766663,507291,259372,2410,3354,2835
2020,Nevada,32,All,1130011,644864,485147,2777,4854,4270
2020,New Hampshire,33,All,539116,383839,155277,1981,2913,2607
2020,New Jersey,34,All,3272054,2094427,1177627,6029,10839,8379
2020,New Mexico,35,All,792755,539082,253673,2457,4440,3727
2020,New York,36,All,7417224,4014516,3402708,12559,17841,11310
2020,North Carolina,37,All,4031592,2649849,1381743,8480,13076,8669
2020,North Dakota,38,All,320873,200671,120202,1737,1910,1967
2020,Ohio,39,All,4717226,3128172,1589054,9371,14566,8275
2020,Oklahoma,40,All,1493569,986555,507014,3009,4254,3718
2020,Oregon,41,All,1642579,1031006,611573,3451,6702,5491
2020,Pennsylvania,42,All,5106601,3522269,1584332,8064,14124,9484
2020,Rhode Island,44,All,414730,255450,159280,1881,2679,2765
2020,South Carolina,45,All,1961481,1375391,586090,5748,8428,6113
2020,South Dakota,46,All,347878,236495,111383,1737,2333,1901
2020,Tennessee,47,All,2639455,1756534,882921,6788,10835,7497
2020,Texas,48,All,9906070,6168808,3737262,18881,30914,17284
2020,Utah,49,All,1003345,707663,295682,2384,4231,3258
2020,Vermont,50,All,262852,187374,75478,1220,1784,1549
2020,Virginia,51,All,3184121,2123771,1060350,7450,12827,8475
2020,Washington,53,All,2905822,1838059,1067763,5585,9076,6807
2020,West Virginia,54,All,734235,540786,193449,2810,3540,3058
2020,Wisconsin,55,All,2377935,1596500,781435,5709,8011,4409
2020,Wyoming,56,All,233231,165530,67701,1535,1787,1698
2020,Puerto Rico,72,All,1205749,817399,388350,3649,4067,4020
2010,Alabama,01,Black or African American ,450327,247338,202989,2631,3017,2553
2010,Alaska,02,Black or African American ,8095,3132,4963,414,306,491
2010,Arizona,04,Black or African American ,84780,33657,51123,1414,1029,1239
2010,Arkansas,05,Black or African American ,163033,76469,86564,1591,1550,1852
2010,California,06,Black or African American ,821463,317416,504047,3718,3347,4232
2010,Colorado,08,Black or African American ,72179,31370,40809,1207,901,1272
2010,Connecticut,09,Black or African American ,120702,49186,71516,1355,1199,1706
2010,Delaware,10,Black or African American ,64076,33803,30273,910,885,980
2010,District of Columbia,11,Black or African American ,128021,49760,78261,1244,1014,1307
2010,Florida,12,Black or African American ,954842,478803,476039,5257,5288,4655
2010,Georgia,13,Black or African American ,1020794,526525,494269,4773,5388,4522
2010,Hawaii,15,Black or African American ,7976,2398,5578,469,327,488
2010,Idaho,16,Black or African American ,2598,869,1729,283,191,265
2010,Illinois,17,Black or African American ,663622,280624,382998,3009,3022,3059
2010,Indiana,18,Black or African American ,210868,89863,121005,2015,1759,2195
2010,Iowa,19,Black or African American ,28463,9084,19379,747,548,792
2010,Kansas,20,Black or African American ,60751,25069,35682,1138,881,1117
2010,Kentucky,21,Black or African American ,125809,52701,73108,1513,1277,1470
2010,Louisiana,22,Black or African American ,478344,245012,233332,2987,2821,3035
2010,Maine,23,Black or African American ,3741,1057,2684,328,179,347
2010,Maryland,24,Black or African American ,599051,319885,279166,3024,3344,3152
2010,Massachusetts,25,Black or African American ,145652,51254,94398,1987,1188,2216
2010,Michigan,26,Black or African American ,511215,247934,263281,2817,2759,2797
2010,Minnesota,27,Black or African American ,87188,23301,63887,1294,1107,1385
2010,Mississippi,28,Black or African American ,368900,213527,155373,2450,2451,2460
2010,Missouri,29,Black or African American ,256513,113059,143454,1996,1806,2303
2010,Montana,30,Black or African American ,964,219,745,178,88,170
2010,Nebraska,31,Black or African American ,29218,10884,18334,729,541,798
2010,Nevada,32,Black or African American ,77280,27975,49305,1097,1061,1182
2010,New Hampshire,33,Black or African American ,4383,1783,2600,326,234,343
2010,New Jersey,34,Black or African American ,417323,175888,241435,2524,2157,2616
2010,New Mexico,35,Black or African American ,14563,6668,7895,506,526,653
2010,New York,36,Black or African American ,1057523,339894,717629,4073,3162,4427
2010,North Carolina,37,Black or African American ,751798,375138,376660,3809,4171,3389
2010,North Dakota,38,Black or African American ,2661,379,2282,276,119,299
2010,Ohio,39,Black or African American ,541760,218094,323666,2908,2857,2887
2010,Oklahoma,40,Black or African American ,99741,42497,57244,1395,955,1368
2010,Oregon,41,Black or African American ,24206,8246,15960,776,553,805
2010,Pennsylvania,42,Black or African American ,479922,226318,253604,2884,2825,3427
2010,Rhode Island,44,Black or African American ,21007,7417,13590,794,495,752
2010,South Carolina,45,Black or African American ,458459,250024,208435,2951,2791,2645
2010,South Dakota,46,Black or African American ,2666,548,2118,270,149,297
2010,Tennessee,47,Black or African American ,375237,185109,190128,2844,2665,2708
2010,Texas,48,Black or African American ,1029603,472623,556980,4700,4462,4979
2010,Utah,49,Black or African American ,7652,2732,4920,502,321,527
2010,Vermont,50,Black or African American ,1545,502,1043,196,135,211
2010,Virginia,51,Black or African American ,554789,282996,271793,3455,3644,2986
2010,Washington,53,Black or African American ,85261,30379,54882,1449,980,1481
2010,West Virginia,54,Black or African American ,21216,10126,11090,669,560,711
2010,Wisconsin,55,Black or African American ,120739,39592,81147,1299,968,1385
2010,Wyoming,56,Black or African American ,1436,534,902,231,155,171
2010,Puerto Rico,72,Black or African American ,96958,63265,33693,1613,1506,1091
2011,Alabama,01,Black or African American ,455466,247032,208434,3233,2980,2903
2011,Alaska,02,Black or African American ,8233,3327,4906,387,365,456
2011,Arizona,04,Black or African American ,87914,33517,54397,1397,1223,1448
2011,Arkansas,05,Black or African American ,163236,75604,87632,1536,1510,1635
2011,California,06,Black or African American ,820448,309780,510668,4542,3881,4680
2011,Colorado,08,Black or African American ,73201,31347,41854,1085,1107,1395
2011,Connecticut,09,Black or African American ,122310,49491,72819,1615,1100,1791
2011,Delaware,10,Black or African American ,64504,33481,31023,919,927,843
2011,District of Columbia,11,Black or African American ,126681,48907,77774,1286,1097,1351
2011,Florida,12,Black or African American ,959732,474273,485459,5552,5340,4462
2011,Georgia,13,Black or African American ,1029645,525959,503686,4878,5160,3889
2011,Hawaii,15,Black or African American ,7957,2302,5655,485,304,442
2011,Idaho,16,Black or African American ,2496,887,1609,294,210,279
2011,Illinois,17,Black or African American ,663069,276420,386649,2976,3221,3372
2011,Indiana,18,Black or African American ,212567,88431,124136,1955,1562,1937
2011,Iowa,19,Black or African American ,29098,9067,20031,782,568,849
2011,Kansas,20,Black or African American ,60790,24704,36086,1216,928,1126
2011,Kentucky,21,Black or African American ,127015,51869,75146,1485,1227,1678
2011,Louisiana,22,Black or African American ,494251,251917,242334,2499,2832,3211
2011,Maine,23,Black or African American ,3591,1010,2581,314,214,310
2011,Maryland,24,Black or African American ,608898,323422,285476,2767,3407,3413
2011,Massachusetts,25,Black or African American ,148633,51461,97172,1784,1193,1873
2011,Michigan,26,Black or African American ,509398,239300,270098,2888,2764,2793
2011,Minnesota,27,Black or African American ,89491,22865,66626,1143,839,1314
2011,Mississippi,28,Black or African American ,370998,212722,158276,2286,2652,2507
2011,Missouri,29,Black or African American ,258242,111722,146520,2026,1903,1988
2011,Montana,30,Black or African American ,1047,246,801,183,92,183
2011,Nebraska,31,Black or African American ,29614,10819,18795,798,542,800
2011,Nevada,32,Black or African American ,79721,27367,52354,1222,1005,1324
2011,New Hampshire,33,Black or African American ,4325,1837,2488,331,274,382
2011,New Jersey,34,Black or African American ,417384,174262,243122,2267,2335,2593
2011,New Mexico,35,Black or African American ,14728,6703,8025,534,477,614
2011,New York,36,Black or African American ,1058418,334649,723769,4360,3366,4103
2011,North Carolina,37,Black or African American ,762491,378225,384266,3625,3404,3466
2011,North Dakota,38,Black or African American ,2667,467,2200,209,136,243
2011,Ohio,39,Black or African American ,543292,213814,329478,2919,3069,3218
2011,Oklahoma,40,Black or African American ,100707,43139,57568,1426,1023,1516
2011,Oregon,41,Black or African American ,24379,8107,16272,920,486,850
2011,Pennsylvania,42,Black or African American ,483707,224213,259494,2678,2627,2978
2011,Rhode Island,44,Black or African American ,21035,7180,13855,723,625,716
2011,South Carolina,45,Black or African American ,461915,251695,210220,2712,3254,3097
2011,South Dakota,46,Black or African American ,2988,578,2410,308,162,355
2011,Tennessee,47,Black or African American ,377806,182556,195250,2404,2482,2434
2011,Texas,48,Black or African American ,1052276,480551,571725,4656,4798,4532
2011,Utah,49,Black or African American ,8028,2703,5325,546,311,533
2011,Vermont,50,Black or African American ,1396,460,936,196,113,169
2011,Virginia,51,Black or African American ,557414,284846,272568,2952,3230,2889
2011,Washington,53,Black or African American ,87384,30350,57034,1447,1043,1483
2011,West Virginia,54,Black or African American ,20748,9795,10953,731,440,688
2011,Wisconsin,55,Black or African American ,121473,38746,82727,1344,1129,1419
2011,Wyoming,56,Black or African American ,1413,543,870,201,152,184
2011,Puerto Rico,72,Black or African American ,98790,64163,34627,1813,1554,1153
2012,Alabama,01,Black or African American ,459892,247085,212807,2641,2737,2818
2012,Alaska,02,Black or African American ,8302,2970,5332,364,292,456
2012,Arizona,04,Black or African American ,91203,33441,57762,1332,1156,1287
2012,Arkansas,05,Black or African American ,166876,77040,89836,1586,1469,1898
2012,California,06,Black or African American ,817965,300964,517001,4111,3782,4574
2012,Colorado,08,Black or African American ,74303,30833,43470,1241,1071,1482
2012,Connecticut,09,Black or African American ,125522,50044,75478,1392,1184,1650
2012,Delaware,10,Black or African American ,65668,33993,31675,897,890,982
2012,District of Columbia,11,Black or African American ,124869,48205,76664,1151,1220,1249
2012,Florida,12,Black or African American ,966741,465737,501004,5914,5028,3874
2012,Georgia,13,Black or African American ,1040222,523307,516915,4648,5035,4844
2012,Hawaii,15,Black or African American ,8579,2326,6253,504,322,532
2012,Idaho,16,Black or African American ,2508,883,1625,323,195,288
2012,Illinois,17,Black or African American ,661372,270904,390468,3218,3498,3827
2012,Indiana,18,Black or African American ,213543,86125,127418,1904,1715,2004
2012,Iowa,19,Black or African American ,29568,9197,20371,788,525,849
2012,Kansas,20,Black or African American ,61977,24303,37674,1006,880,1012
2012,Kentucky,21,Black or African American ,129665,51674,77991,1665,1204,1773
2012,Louisiana,22,Black or African American ,503895,255141,248754,2528,2531,2560
2012,Maine,23,Black or African American ,3731,990,2741,301,215,277
2012,Maryland,24,Black or African American ,614457,323459,290998,2560,2955,3169
2012,Massachusetts,25,Black or African American ,151717,51118,100599,1750,1250,1959
2012,Michigan,26,Black or African American ,509710,233350,276360,2744,2482,2571
2012,Minnesota,27,Black or African American ,91211,22227,68984,1113,767,1376
2012,Mississippi,28,Black or African American ,373690,210360,163330,2711,2829,2564
2012,Missouri,29,Black or African American ,259674,109507,150167,2094,1698,1990
2012,Montana,30,Black or African American ,1129,217,912,225,78,233
2012,Nebraska,31,Black or African American ,30107,10411,19696,707,555,839
2012,Nevada,32,Black or African American ,79726,26789,52937,1380,1058,1399
2012,New Hampshire,33,Black or African American ,4862,1909,2953,377,240,401
2012,New Jersey,34,Black or African American ,417633,171897,245736,2895,2319,2825
2012,New Mexico,35,Black or African American ,15111,6714,8397,526,556,527
2012,New York,36,Black or African American ,1061768,332330,729438,4088,3328,4361
2012,North Carolina,37,Black or African American ,770021,375333,394688,4323,4323,3382
2012,North Dakota,38,Black or African American ,2783,421,2362,256,124,252
2012,Ohio,39,Black or African American ,546794,210744,336050,2724,2814,2934
2012,Oklahoma,40,Black or African American ,101305,43554,57751,1330,1043,1197
2012,Oregon,41,Black or African American ,24016,7740,16276,633,528,692
2012,Pennsylvania,42,Black or African American ,488725,222771,265954,2604,2543,3005
2012,Rhode Island,44,Black or African American ,21826,7292,14534,722,577,701
2012,South Carolina,45,Black or African American ,463101,250739,212362,3085,3070,2757
2012,South Dakota,46,Black or African American ,3328,721,2607,264,186,318
2012,Tennessee,47,Black or African American ,381422,181415,200007,2419,2810,2246
2012,Texas,48,Black or African American ,1067613,476582,591031,4548,4739,4831
2012,Utah,49,Black or African American ,8173,2746,5427,452,317,417
2012,Vermont,50,Black or African American ,1609,471,1138,200,118,214
2012,Virginia,51,Black or African American ,560872,281860,279012,3119,3035,2685
2012,Washington,53,Black or African American ,88888,29686,59202,1568,1093,1607
2012,West Virginia,54,Black or African American ,20948,9867,11081,584,487,663
2012,Wisconsin,55,Black or African American ,121939,37421,84518,1384,1137,1383
2012,Wyoming,56,Black or African American ,1557,567,990,225,164,197
2012,Puerto Rico,72,Black or African American ,101120,65291,35829,1875,1393,1171
2013,Alabama,01,Black or African American ,463301,246748,216553,2744,2778,2640
2013,Alaska,02,Black or African American ,8815,2939,5876,481,334,491
2013,Arizona,04,Black or African American ,93757,32441,61316,1636,1114,1657
2013,Arkansas,05,Black or African American ,166480,75418,91062,1656,1617,1839
2013,California,06,Black or African American ,817081,293378,523703,3885,3124,4651
2013,Colorado,08,Black or African American ,73608,29320,44288,1112,1004,1297
2013,Connecticut,09,Black or African American ,127078,49035,78043,1642,1275,1968
2013,Delaware,10,Black or African American ,65685,34682,31003,1008,1001,1213
2013,District of Columbia,11,Black or African American ,123543,46672,76871,1442,1171,1615
2013,Florida,12,Black or African American ,973353,461632,511721,5365,5556,3940
2013,Georgia,13,Black or African American ,1046672,515603,531069,5017,5259,4338
2013,Hawaii,15,Black or African American ,9099,2428,6671,522,371,485
2013,Idaho,16,Black or African American ,2726,770,1956,322,158,308
2013,Illinois,17,Black or African American ,657915,266203,391712,2998,2877,3228
2013,Indiana,18,Black or African American ,217007,84878,132129,1815,1446,1853
2013,Iowa,19,Black or African American ,30416,9302,21114,672,568,783
2013,Kansas,20,Black or African American ,61979,23622,38357,1199,941,1247
2013,Kentucky,21,Black or African American ,128772,50287,78485,1372,1347,1403
2013,Louisiana,22,Black or African American ,508523,255538,252985,2610,2930,2571
2013,Maine,23,Black or African American ,3840,1031,2809,317,201,268
2013,Maryland,24,Black or African American ,619221,322457,296764,2448,3008,2717
2013,Massachusetts,25,Black or African American ,153146,50004,103142,1652,1390,1862
2013,Michigan,26,Black or African American ,511255,230277,280978,2670,2386,3099
2013,Minnesota,27,Black or African American ,92597,22381,70216,1108,741,1310
2013,Mississippi,28,Black or African American ,375547,209427,166120,2891,2519,2698
2013,Missouri,29,Black or African American ,260003,106759,153244,1954,1879,2203
2013,Montana,30,Black or African American ,1254,246,1008,229,80,231
2013,Nebraska,31,Black or African American ,31002,10282,20720,629,471,791
2013,Nevada,32,Black or African American ,82133,26621,55512,1275,1083,1179
2013,New Hampshire,33,Black or African American ,5040,2071,2969,407,243,391
2013,New Jersey,34,Black or African American ,421177,171058,250119,2650,2524,2830
2013,New Mexico,35,Black or African American ,15456,7211,8245,588,510,607
2013,New York,36,Black or African American ,1058108,330934,727174,4939,3521,5083
2013,North Carolina,37,Black or African American ,775237,370339,404898,3901,4027,4062
2013,North Dakota,38,Black or African American ,3187,531,2656,274,168,305
2013,Ohio,39,Black or African American ,547875,208026,339849,3209,2799,3143
2013,Oklahoma,40,Black or African American ,101731,42980,58751,1279,1056,1261
2013,Oregon,41,Black or African American ,24584,8063,16521,850,506,912
2013,Pennsylvania,42,Black or African American ,489772,219836,269936,2725,2481,3077
2013,Rhode Island,44,Black or African American ,22125,6988,15137,835,503,785
2013,South Carolina,45,Black or African American ,466261,250854,215407,3069,2994,2875
2013,South Dakota,46,Black or African American ,3451,843,2608,335,211,338
2013,Tennessee,47,Black or African American ,385869,180275,205594,2284,2549,2830
2013,Texas,48,Black or African American ,1086515,475669,610846,4467,4564,4563
2013,Utah,49,Black or African American ,8287,2823,5464,580,340,542
2013,Vermont,50,Black or African American ,1760,461,1299,187,130,180
2013,Virginia,51,Black or African American ,561327,278630,282697,3019,2913,2757
2013,Washington,53,Black or African American ,90823,29044,61779,1211,1124,1564
2013,West Virginia,54,Black or African American ,21184,9167,12017,789,551,650
2013,Wisconsin,55,Black or African American ,122964,36324,86640,1177,992,1433
2013,Wyoming,56,Black or African American ,1781,558,1223,247,138,213
2013,Puerto Rico,72,Black or African American ,104029,67525,36504,1724,1588,1135
2014,Alabama,01,Black or African American ,466483,244345,222138,3052,2758,2838
2014,Alaska,02,Black or African American ,8729,2815,5914,443,314,421
2014,Arizona,04,Black or African American ,95321,32115,63206,1324,1075,1566
2014,Arkansas,05,Black or African American ,168285,76164,92121,1668,1401,1768
2014,California,06,Black or African American ,817579,289396,528183,4517,3241,4744
2014,Colorado,08,Black or African American ,73470,29054,44416,1336,1011,1191
2014,Connecticut,09,Black or African American ,126896,49005,77891,1458,1139,1568
2014,Delaware,10,Black or African American ,67529,35393,32136,956,885,985
2014,District of Columbia,11,Black or African American ,123617,46551,77066,1301,1064,1387
2014,Florida,12,Black or African American ,985477,456437,529040,5832,5138,4565
2014,Georgia,13,Black or African American ,1058176,509053,549123,4779,5354,4088
2014,Hawaii,15,Black or African American ,9822,2107,7715,511,325,539
2014,Idaho,16,Black or African American ,2853,695,2158,336,199,302
2014,Illinois,17,Black or African American ,657898,261392,396506,3127,3077,3555
2014,Indiana,18,Black or African American ,219537,83995,135542,2013,1635,2241
2014,Iowa,19,Black or African American ,31265,9362,21903,688,524,735
2014,Kansas,20,Black or African American ,62591,23884,38707,1155,778,1209
2014,Kentucky,21,Black or African American ,131036,50100,80936,1271,1221,1458
2014,Louisiana,22,Black or African American ,515609,254800,260809,2634,2502,2771
2014,Maine,23,Black or African American ,3772,874,2898,265,185,238
2014,Maryland,24,Black or African American ,625470,321818,303652,2678,3158,2648
2014,Massachusetts,25,Black or African American ,155895,50292,105603,1980,1403,2136
2014,Michigan,26,Black or African American ,511736,222757,288979,2522,2472,2818
2014,Minnesota,27,Black or African American ,95512,23082,72430,1070,868,1412
2014,Mississippi,28,Black or African American ,380403,209699,170704,2618,2714,2444
2014,Missouri,29,Black or African American ,260633,105489,155144,1714,1619,2044
2014,Montana,30,Black or African American ,1408,259,1149,244,102,235
2014,Nebraska,31,Black or African American ,31282,9913,21369,754,435,742
2014,Nevada,32,Black or African American ,83901,25964,57937,1563,902,1407
2014,New Hampshire,33,Black or African American ,5053,1876,3177,455,249,420
2014,New Jersey,34,Black or African American ,420508,168796,251712,2609,2316,2644
2014,New Mexico,35,Black or African American ,15618,7245,8373,571,504,521
2014,New York,36,Black or African American ,1064378,328913,735465,4358,3456,4471
2014,North Carolina,37,Black or African American ,784136,369550,414586,4260,4023,3956
2014,North Dakota,38,Black or African American ,3873,471,3402,302,179,305
2014,Ohio,39,Black or African American ,552056,205745,346311,2980,2416,3199
2014,Oklahoma,40,Black or African American ,103558,42260,61298,1301,1055,1388
2014,Oregon,41,Black or African American ,24286,7840,16446,712,545,781
2014,Pennsylvania,42,Black or African American ,492165,217775,274390,2808,2838,2848
2014,Rhode Island,44,Black or African American ,22255,6856,15399,781,464,835
2014,South Carolina,45,Black or African American ,467894,248050,219844,3038,3100,2682
2014,South Dakota,46,Black or African American ,3913,875,3038,341,189,347
2014,Tennessee,47,Black or African American ,390773,179027,211746,2479,2317,2804
2014,Texas,48,Black or African American ,1105130,476090,629040,4869,4940,5281
2014,Utah,49,Black or African American ,8311,2773,5538,562,264,511
2014,Vermont,50,Black or African American ,1702,442,1260,222,121,181
2014,Virginia,51,Black or African American ,565192,275144,290048,3269,3304,2866
2014,Washington,53,Black or African American ,92082,29713,62369,1546,991,1612
2014,West Virginia,54,Black or African American ,21579,9304,12275,759,476,709
2014,Wisconsin,55,Black or African American ,124294,35784,88510,1110,1088,1527
2014,Wyoming,56,Black or African American ,1996,788,1208,298,209,236
2014,Puerto Rico,72,Black or African American ,108444,71312,37132,1881,1581,1097
2015,Alabama,01,Black or African American ,472929,243790,229139,2859,2641,2983
2015,Alaska,02,Black or African American ,8491,2686,5805,591,285,558
2015,Arizona,04,Black or African American ,97319,32555,64764,1786,1290,1677
2015,Arkansas,05,Black or African American ,170167,76044,94123,1646,1376,1850
2015,California,06,Black or African American ,818591,283731,534860,4043,3425,4142
2015,Colorado,08,Black or African American ,75390,29577,45813,1401,1063,1272
2015,Connecticut,09,Black or African American ,128836,50119,78717,1503,1402,1688
2015,Delaware,10,Black or African American ,68355,35720,32635,899,873,957
2015,District of Columbia,11,Black or African American ,124683,46339,78344,1380,1146,1412
2015,Florida,12,Black or African American ,1000764,451715,549049,5448,6152,4599
2015,Georgia,13,Black or African American ,1072378,507108,565270,4891,5037,4682
2015,Hawaii,15,Black or African American ,10468,2018,8450,517,366,546
2015,Idaho,16,Black or African American ,2998,852,2146,308,239,330
2015,Illinois,17,Black or African American ,658014,258783,399231,3085,2891,3872
2015,Indiana,18,Black or African American ,223166,83439,139727,1778,1614,1678
2015,Iowa,19,Black or African American ,32285,9337,22948,791,653,837
2015,Kansas,20,Black or African American ,63431,23347,40084,1101,867,1045
2015,Kentucky,21,Black or African American ,132753,50114,82639,1369,1207,1552
2015,Louisiana,22,Black or African American ,519112,252229,266883,2711,3254,2953
2015,Maine,23,Black or African American ,3933,838,3095,335,161,348
2015,Maryland,24,Black or African American ,630181,324041,306140,2882,3131,3364
2015,Massachusetts,25,Black or African American ,160258,52033,108225,1942,1377,2091
2015,Michigan,26,Black or African American ,514107,218360,295747,2637,2672,2777
2015,Minnesota,27,Black or African American ,98362,23547,74815,1138,869,1274
2015,Mississippi,28,Black or African American ,384703,209712,174991,2441,2536,2124
2015,Missouri,29,Black or African American ,262627,104438,158189,2065,1781,2247
2015,Montana,30,Black or African American ,1367,377,990,239,126,233
2015,Nebraska,31,Black or African American ,32252,10091,22161,723,444,811
2015,Nevada,32,Black or African American ,85546,26382,59164,1325,967,1480
2015,New Hampshire,33,Black or African American ,5420,2096,3324,423,329,420
2015,New Jersey,34,Black or African American ,419632,165704,253928,2114,2277,2344
2015,New Mexico,35,Black or African American ,15751,7111,8640,666,529,740
2015,New York,36,Black or African American ,1065864,328868,736996,4454,3137,4315
2015,North Carolina,37,Black or African American ,791632,366871,424761,4105,4391,3593
2015,North Dakota,38,Black or African American ,4091,396,3695,325,190,367
2015,Ohio,39,Black or African American ,558151,202913,355238,2732,2674,2997
2015,Oklahoma,40,Black or African American ,104457,41393,63064,1225,1069,1373
2015,Oregon,41,Black or African American ,25003,7950,17053,757,531,824
2015,Pennsylvania,42,Black or African American ,494149,214962,279187,2729,2489,3180
2015,Rhode Island,44,Black or African American ,22871,7154,15717,808,503,748
2015,South Carolina,45,Black or African American ,473335,251099,222236,2762,3016,2269
2015,South Dakota,46,Black or African American ,4139,1011,3128,331,222,346
2015,Tennessee,47,Black or African American ,397221,179313,217908,2492,2598,2595
2015,Texas,48,Black or African American ,1131364,477759,653605,4844,4849,4949
2015,Utah,49,Black or African American ,9039,3107,5932,473,345,448
2015,Vermont,50,Black or African American ,1765,351,1414,209,129,197
2015,Virginia,51,Black or African American ,567663,272830,294833,3452,3456,3167
2015,Washington,53,Black or African American ,93108,29864,63244,1675,1084,1663
2015,West Virginia,54,Black or African American ,22023,9102,12921,736,517,865
2015,Wisconsin,55,Black or African American ,124783,34356,90427,1189,924,1227
2015,Wyoming,56,Black or African American ,2056,802,1254,320,233,308
2015,Puerto Rico,72,Black or African American ,113853,75639,38214,2057,1790,1290
2016,Alabama,01,Black or African American ,476883,244098,232785,2839,2928,3129
2016,Alaska,02,Black or African American ,8175,2506,5669,476,254,475
2016,Arizona,04,Black or African American ,99691,32454,67237,1615,1130,1631
2016,Arkansas,05,Black or African American ,171376,74839,96537,1685,1467,1809
2016,California,06,Black or African American ,817922,278929,538993,3747,3416,4282
2016,Colorado,08,Black or African American ,75129,28581,46548,1190,975,1239
2016,Connecticut,09,Black or African American ,130051,49881,80170,1745,1491,1797
2016,Delaware,10,Black or African American ,69420,36243,33177,1064,891,1104
2016,District of Columbia,11,Black or African American ,124542,44762,79780,1266,1013,1268
2016,Florida,12,Black or African American ,1015245,453034,562211,5609,5174,5033
2016,Georgia,13,Black or African American ,1094380,508998,585382,4302,4960,4581
2016,Hawaii,15,Black or African American ,9341,1857,7484,514,218,512
2016,Idaho,16,Black or African American ,3025,893,2132,332,251,339
2016,Illinois,17,Black or African American ,663467,257998,405469,3073,2887,3347
2016,Indiana,18,Black or African American ,226300,83954,142346,2093,1717,2368
2016,Iowa,19,Black or African American ,34240,9316,24924,862,589,919
2016,Kansas,20,Black or African American ,63401,22659,40742,1079,774,1170
2016,Kentucky,21,Black or African American ,134831,49224,85607,1466,1363,1619
2016,Louisiana,22,Black or African American ,522215,250154,272061,2616,2922,2699
2016,Maine,23,Black or African American ,4356,838,3518,365,191,373
2016,Maryland,24,Black or African American ,635560,323015,312545,3114,3049,3207
2016,Massachusetts,25,Black or African American ,162248,53354,108894,1847,1306,2045
2016,Michigan,26,Black or African American ,517675,216521,301154,2464,2661,3030
2016,Minnesota,27,Black or African American ,100916,23800,77116,1402,831,1417
2016,Mississippi,28,Black or African American ,389013,210408,178605,2318,2290,2378
2016,Missouri,29,Black or African American ,265497,103401,162096,2054,1753,2373
2016,Montana,30,Black or African American ,1329,328,1001,214,94,199
2016,Nebraska,31,Black or African American ,32582,10109,22473,891,467,879
2016,Nevada,32,Black or African American ,87641,26136,61505,1275,1012,1504
2016,New Hampshire,33,Black or African American ,5277,1899,3378,455,265,448
2016,New Jersey,34,Black or African American ,421380,164070,257310,2564,2350,3168
2016,New Mexico,35,Black or African American ,14803,6709,8094,619,472,590
2016,New York,36,Black or African American ,1069100,332060,737040,4760,3749,4960
2016,North Carolina,37,Black or African American ,799014,365774,433240,3716,3932,3590
2016,North Dakota,38,Black or African American ,5228,518,4710,413,250,380
2016,Ohio,39,Black or African American ,565105,203733,361372,2932,2739,3327
2016,Oklahoma,40,Black or African American ,106570,41341,65229,1349,938,1295
2016,Oregon,41,Black or African American ,25366,7940,17426,800,562,747
2016,Pennsylvania,42,Black or African American ,495705,214667,281038,2659,3028,3567
2016,Rhode Island,44,Black or African American ,23271,7148,16123,622,457,613
2016,South Carolina,45,Black or African American ,477479,252203,225276,2817,3318,3310
2016,South Dakota,46,Black or African American ,4351,1065,3286,301,209,315
2016,Tennessee,47,Black or African American ,403433,178223,225210,2514,2394,2567
2016,Texas,48,Black or African American ,1158251,481779,676472,4932,4975,5429
2016,Utah,49,Black or African American ,8915,2970,5945,533,353,455
2016,Vermont,50,Black or African American ,1784,333,1451,215,111,183
2016,Virginia,51,Black or African American ,577452,273778,303674,2997,3020,2787
2016,Washington,53,Black or African American ,93019,29456,63563,1558,1152,1738
2016,West Virginia,54,Black or African American ,22873,9502,13371,693,579,684
2016,Wisconsin,55,Black or African American ,126841,34033,92808,1515,929,1577
2016,Wyoming,56,Black or African American ,2096,707,1389,315,191,317
2016,Puerto Rico,72,Black or African American ,121333,81071,40262,1872,1644,1394
2017,Alabama,01,Black or African American ,481514,245147,236367,2693,3089,2554
2017,Alaska,02,Black or African American ,7857,2598,5259,527,328,494
2017,Arizona,04,Black or African American ,101091,33441,67650,1469,1186,1801
2017,Arkansas,05,Black or African American ,172490,74500,97990,1507,1461,1849
2017,California,06,Black or African American ,815002,278805,536197,3715,3397,4592
2017,Colorado,08,Black or African American ,76220,28925,47295,1299,1025,1327
2017,Connecticut,09,Black or African American ,130942,51237,79705,1475,1177,1589
2017,Delaware,10,Black or African American ,70657,37415,33242,1061,895,1012
2017,District of Columbia,11,Black or African American ,123505,44557,78948,1279,951,1266
2017,Florida,12,Black or African American ,1029505,457035,572470,6295,5574,5905
2017,Georgia,13,Black or African American ,1114736,522287,592449,4672,5031,5035
2017,Hawaii,15,Black or African American ,9331,1866,7465,494,243,486
2017,Idaho,16,Black or African American ,3109,1039,2070,310,224,345
2017,Illinois,17,Black or African American ,664742,257985,406757,3314,2849,3219
2017,Indiana,18,Black or African American ,229205,85645,143560,2058,1926,2531
2017,Iowa,19,Black or African American ,35431,9571,25860,838,588,930
2017,Kansas,20,Black or African American ,63694,22696,40998,1035,834,1155
2017,Kentucky,21,Black or African American ,136072,49899,86173,1343,1331,1680
2017,Louisiana,22,Black or African American ,525543,250056,275487,3115,3198,3029
2017,Maine,23,Black or African American ,4530,845,3685,384,182,360
2017,Maryland,24,Black or African American ,636944,325549,311395,2681,3312,3416
2017,Massachusetts,25,Black or African American ,166746,55658,111088,2161,1263,1905
2017,Michigan,26,Black or African American ,519723,217927,301796,2582,2549,3065
2017,Minnesota,27,Black or African American ,105053,25486,79567,1584,928,1580
2017,Mississippi,28,Black or African American ,394708,213820,180888,2280,2706,2191
2017,Missouri,29,Black or African American ,265848,102355,163493,1961,1839,2204
2017,Montana,30,Black or African American ,1529,423,1106,251,140,252
2017,Nebraska,31,Black or African American ,33535,10078,23457,704,419,643
2017,Nevada,32,Black or African American ,91461,26713,64748,1248,990,1268
2017,New Hampshire,33,Black or African American ,5726,1950,3776,506,287,464
2017,New Jersey,34,Black or African American ,420796,163617,257179,2809,2647,3119
2017,New Mexico,35,Black or African American ,15247,6714,8533,620,533,606
2017,New York,36,Black or African American ,1075113,337231,737882,4153,3188,4193
2017,North Carolina,37,Black or African American ,813338,372374,440964,3118,3776,3568
2017,North Dakota,38,Black or African American ,6680,508,6172,433,201,461
2017,Ohio,39,Black or African American ,572410,206920,365490,2915,2653,3232
2017,Oklahoma,40,Black or African American ,107756,40987,66769,1388,974,1339
2017,Oregon,41,Black or African American ,25782,8298,17484,924,589,908
2017,Pennsylvania,42,Black or African American ,500718,218146,282572,2395,2738,3187
2017,Rhode Island,44,Black or African American ,23187,7270,15917,729,518,783
2017,South Carolina,45,Black or African American ,486286,257528,228758,2779,3181,3134
2017,South Dakota,46,Black or African American ,4587,947,3640,338,180,372
2017,Tennessee,47,Black or African American ,407114,179293,227821,2415,2746,3122
2017,Texas,48,Black or African American ,1184353,490739,693614,4520,4934,5433
2017,Utah,49,Black or African American ,9014,2926,6088,458,360,483
2017,Vermont,50,Black or African American ,1970,432,1538,202,106,215
2017,Virginia,51,Black or African American ,580167,277417,302750,3010,3510,3156
2017,Washington,53,Black or African American ,95709,30142,65567,1363,1138,1572
2017,West Virginia,54,Black or African American ,24015,9796,14219,796,542,741
2017,Wisconsin,55,Black or African American ,128168,34232,93936,1263,870,1461
2017,Wyoming,56,Black or African American ,2193,744,1449,311,153,315
2017,Puerto Rico,72,Black or African American ,127598,85887,41711,2347,1949,1360
2018,Alabama,01,Black or African American ,485130,244992,240138,2914,3235,2612
2018,Alaska,02,Black or African American ,8232,2750,5482,500,306,468
2018,Arizona,04,Black or African American ,104159,35440,68719,1634,1200,1583
2018,Arkansas,05,Black or African American ,172994,75130,97864,1820,1606,1815
2018,California,06,Black or African American ,817879,281623,536256,4415,3282,4533
2018,Colorado,08,Black or African American ,78951,30388,48563,1305,898,1334
2018,Connecticut,09,Black or African American ,131802,52020,79782,1614,1243,1687
2018,Delaware,10,Black or African American ,73717,37598,36119,1061,1071,1305
2018,District of Columbia,11,Black or African American ,123692,44892,78800,1254,994,1374
2018,Florida,12,Black or African American ,1045762,465799,579963,6300,5790,4081
2018,Georgia,13,Black or African American ,1135655,529662,605993,4262,4852,4305
2018,Hawaii,15,Black or African American ,9715,1905,7810,540,314,526
2018,Idaho,16,Black or African American ,3285,1105,2180,355,249,387
2018,Illinois,17,Black or African American ,669101,259514,409587,3022,3239,2946
2018,Indiana,18,Black or African American ,231956,85426,146530,2089,1665,2532
2018,Iowa,19,Black or African American ,36239,9430,26809,901,649,943
2018,Kansas,20,Black or African American ,63731,22438,41293,946,928,1147
2018,Kentucky,21,Black or African American ,138021,50049,87972,1564,1284,1650
2018,Louisiana,22,Black or African American ,526949,247026,279923,2973,3228,2967
2018,Maine,23,Black or African American ,4672,877,3795,380,213,393
2018,Maryland,24,Black or African American ,641526,328165,313361,3007,3245,3309
2018,Massachusetts,25,Black or African American ,169378,56994,112384,2106,1710,2075
2018,Michigan,26,Black or African American ,523584,217643,305941,2754,2403,2896
2018,Minnesota,27,Black or African American ,109959,26470,83489,1446,916,1528
2018,Mississippi,28,Black or African American ,398126,214188,183938,2384,2491,2744
2018,Missouri,29,Black or African American ,269993,102509,167484,2184,2118,2654
2018,Montana,30,Black or African American ,1388,389,999,225,145,195
2018,Nebraska,31,Black or African American ,33769,10179,23590,711,487,746
2018,Nevada,32,Black or African American ,95945,28128,67817,1497,1114,1443
2018,New Hampshire,33,Black or African American ,6002,1865,4137,517,285,501
2018,New Jersey,34,Black or African American ,425064,165178,259886,2509,2482,3057
2018,New Mexico,35,Black or African American ,15694,6559,9135,693,560,804
2018,New York,36,Black or African American ,1084784,339170,745614,4897,3622,4631
2018,North Carolina,37,Black or African American ,824465,376460,448005,3602,4295,4164
2018,North Dakota,38,Black or African American ,7780,623,7157,437,159,450
2018,Ohio,39,Black or African American ,578967,206999,371968,3046,2676,3297
2018,Oklahoma,40,Black or African American ,108428,41161,67267,1207,883,1257
2018,Oregon,41,Black or African American ,26298,8274,18024,989,607,856
2018,Pennsylvania,42,Black or African American ,507442,219793,287649,3052,2946,3421
2018,Rhode Island,44,Black or African American ,23222,7437,15785,752,428,774
2018,South Carolina,45,Black or African American ,490042,258310,231732,2991,3071,3237
2018,South Dakota,46,Black or African American ,5084,922,4162,345,227,390
2018,Tennessee,47,Black or African American ,413270,179898,233372,2879,2840,3163
2018,Texas,48,Black or African American ,1209097,496329,712768,4809,5098,5242
2018,Utah,49,Black or African American ,9388,2964,6424,500,292,501
2018,Vermont,50,Black or African American ,1981,420,1561,230,110,228
2018,Virginia,51,Black or African American ,587095,279810,307285,3375,3506,3353
2018,Washington,53,Black or African American ,97357,31423,65934,1676,1047,1680
2018,West Virginia,54,Black or African American ,25163,10750,14413,838,542,813
2018,Wisconsin,55,Black or African American ,129765,33514,96251,1463,1049,1512
2018,Wyoming,56,Black or African American ,2007,771,1236,271,173,293
2018,Puerto Rico,72,Black or African American ,136435,91639,44796,2395,1853,1492
2019,Alabama,01,Black or African American ,489933,248861,241072,3172,2996,3237
2019,Alaska,02,Black or African American ,8218,3092,5126,440,402,503
2019,Arizona,04,Black or African American ,108736,37621,71115,1501,1105,1538
2019,Arkansas,05,Black or African American ,174264,75824,98440,1642,1461,1853
2019,California,06,Black or African American ,818832,284566,534266,4219,3486,4774
2019,Colorado,08,Black or African American ,80945,32103,48842,1261,1062,1328
2019,Connecticut,09,Black or African American ,135220,53306,81914,1655,1400,1927
2019,Delaware,10,Black or African American ,74927,38221,36706,1032,953,1116
2019,District of Columbia,11,Black or African American ,123184,43334,79850,1290,1043,1496
2019,Florida,12,Black or African American ,1064084,481979,582105,6032,5705,4760
2019,Georgia,13,Black or African American ,1160923,542472,618451,5208,6162,5139
2019,Hawaii,15,Black or African American ,9977,2320,7657,586,348,563
2019,Idaho,16,Black or African American ,3057,1150,1907,405,230,404
2019,Illinois,17,Black or African American ,674203,261615,412588,3483,3216,4449
2019,Indiana,18,Black or African American ,235992,87723,148269,2178,1811,2301
2019,Iowa,19,Black or African American ,38844,9470,29374,915,684,1004
2019,Kansas,20,Black or African American ,64559,22489,42070,1139,816,1016
2019,Kentucky,21,Black or African American ,140519,51367,89152,1569,1324,1497
2019,Louisiana,22,Black or African American ,527045,248607,278438,3013,3078,3160
2019,Maine,23,Black or African American ,4978,1099,3879,426,214,367
2019,Maryland,24,Black or African American ,648484,333905,314579,2718,3733,3478
2019,Massachusetts,25,Black or African American ,173234,59119,114115,2124,1481,2213
2019,Michigan,26,Black or African American ,527956,220614,307342,2678,2536,3314
2019,Minnesota,27,Black or African American ,113728,27580,86148,1467,952,1371
2019,Mississippi,28,Black or African American ,400619,214413,186206,2768,2657,2923
2019,Missouri,29,Black or African American ,272262,102476,169786,1861,2156,2547
2019,Montana,30,Black or African American ,1444,401,1043,257,113,237
2019,Nebraska,31,Black or African American ,34227,10290,23937,714,566,870
2019,Nevada,32,Black or African American ,100269,29330,70939,1472,993,1584
2019,New Hampshire,33,Black or African American ,6381,2065,4316,442,370,402
2019,New Jersey,34,Black or African American ,428807,166721,262086,3010,2493,3445
2019,New Mexico,35,Black or African American ,15916,6398,9518,706,483,703
2019,New York,36,Black or African American ,1091282,341480,749802,4623,4199,4133
2019,North Carolina,37,Black or African American ,836021,380625,455396,3955,4186,3878
2019,North Dakota,38,Black or African American ,8557,667,7890,561,197,560
2019,Ohio,39,Black or African American ,584521,208044,376477,3275,3067,3560
2019,Oklahoma,40,Black or African American ,108079,41689,66390,1386,1034,1523
2019,Oregon,41,Black or African American ,27230,9161,18069,850,621,875
2019,Pennsylvania,42,Black or African American ,513862,221816,292046,2697,2921,3565
2019,Rhode Island,44,Black or African American ,24315,8186,16129,772,606,915
2019,South Carolina,45,Black or African American ,496273,263566,232707,3140,3281,2750
2019,South Dakota,46,Black or African American ,5481,1050,4431,438,264,477
2019,Tennessee,47,Black or African American ,422149,181642,240507,2874,2528,3591
2019,Texas,48,Black or African American ,1240150,504350,735800,5076,4967,6053
2019,Utah,49,Black or African American ,9616,2782,6834,494,298,496
2019,Vermont,50,Black or African American ,2450,597,1853,268,159,251
2019,Virginia,51,Black or African American ,590176,282251,307925,3129,3401,3591
2019,Washington,53,Black or African American ,101897,32114,69783,1659,1085,1757
2019,West Virginia,54,Black or African American ,25114,10637,14477,669,598,714
2019,Wisconsin,55,Black or African American ,132136,33660,98476,1487,1123,1669
2019,Wyoming,56,Black or African American ,2121,610,1511,316,201,363
2019,Puerto Rico,72,Black or African American ,144087,97441,46646,2419,2059,1631
2020,Alabama,01,Black or African American ,495426,252234,243192,3227,3505,3864
2020,Alaska,02,Black or African American ,8362,3143,5219,527,313,558
2020,Arizona,04,Black or African American ,110292,39345,70947,1884,1614,1814
2020,Arkansas,05,Black or African American ,176064,77010,99054,2011,1876,2297
2020,California,06,Black or African American ,806733,286043,520690,4977,3467,4699
2020,Colorado,08,Black or African American ,78350,32403,45947,1481,1214,1494
2020,Connecticut,09,Black or African American ,138334,55625,82709,1605,1356,1871
2020,Delaware,10,Black or African American ,77144,39448,37696,1153,1235,1457
2020,District of Columbia,11,Black or African American ,120985,44718,76267,1515,1438,1670
2020,Florida,12,Black or African American ,1080641,501902,578739,6743,6164,6098
2020,Georgia,13,Black or African American ,1186727,566876,619851,4585,6853,5809
2020,Hawaii,15,Black or African American ,10266,2434,7832,704,434,600
2020,Idaho,16,Black or African American ,3058,1187,1871,361,260,327
2020,Illinois,17,Black or African American ,676524,266028,410496,3557,3657,4451
2020,Indiana,18,Black or African American ,239617,89346,150271,2457,2049,2448
2020,Iowa,19,Black or African American ,39558,9613,29945,1139,755,1249
2020,Kansas,20,Black or African American ,64175,22729,41446,1347,1001,1406
2020,Kentucky,21,Black or African American ,141542,51783,89759,1664,1534,1909
2020,Louisiana,22,Black or African American ,527328,255950,271378,3878,4054,4072
2020,Maine,23,Black or African American ,5267,1330,3937,314,224,337
2020,Maryland,24,Black or African American ,658613,340012,318601,2722,3884,3793
2020,Massachusetts,25,Black or African American ,171958,60809,111149,2290,1531,2309
2020,Michigan,26,Black or African American ,529046,223708,305338,3399,3442,3991
2020,Minnesota,27,Black or African American ,114302,29040,85262,1507,1130,1805
2020,Mississippi,28,Black or African American ,406602,219042,187560,2683,3290,2957
2020,Missouri,29,Black or African American ,274714,104868,169846,2428,1952,2622
2020,Montana,30,Black or African American ,1628,560,1068,333,237,221
2020,Nebraska,31,Black or African American ,33921,10235,23686,872,514,921
2020,Nevada,32,Black or African American ,104297,31818,72479,1791,1587,1703
2020,New Hampshire,33,Black or African American ,6229,1982,4247,450,370,488
2020,New Jersey,34,Black or African American ,430451,168629,261822,3123,2753,3579
2020,New Mexico,35,Black or African American ,15902,5924,9978,643,418,681
2020,New York,36,Black or African American ,1088200,347456,740744,5059,4357,5466
2020,North Carolina,37,Black or African American ,848234,391993,456241,4670,5216,5167
2020,North Dakota,38,Black or African American ,9468,787,8681,466,224,466
2020,Ohio,39,Black or African American ,590255,212231,378024,3897,3584,4613
2020,Oklahoma,40,Black or African American ,108542,43772,64770,1760,1302,1581
2020,Oregon,41,Black or African American ,28020,9346,18674,1082,694,1077
2020,Pennsylvania,42,Black or African American ,514680,223455,291225,3973,3157,3944
2020,Rhode Island,44,Black or African American ,24084,8177,15907,1023,646,979
2020,South Carolina,45,Black or African American ,503410,270473,232937,3396,3541,3733
2020,South Dakota,46,Black or African American ,6001,1089,4912,387,279,456
2020,Tennessee,47,Black or African American ,430652,185484,245168,2652,3186,3407
2020,Texas,48,Black or African American ,1267229,518713,748516,5419,5568,6169
2020,Utah,49,Black or African American ,9985,2878,7107,606,358,609
2020,Vermont,50,Black or African American ,2131,450,1681,378,140,373
2020,Virginia,51,Black or African American ,595688,288557,307131,3469,3713,3805
2020,Washington,53,Black or African American ,103711,33772,69939,2135,1506,1912
2020,West Virginia,54,Black or African American ,23920,10317,13603,909,602,878
2020,Wisconsin,55,Black or African American ,131874,31471,100403,1861,1087,1800
2020,Wyoming,56,Black or African American ,1939,584,1355,302,167,344
2020,Puerto Rico,72,Black or African American ,140199,94348,45851,2684,2133,1568
2010,Alabama,01,American Indian and Alaska Native ,9795,6926,2869,481,464,340
2010,Alaska,02,American Indian and Alaska Native ,28540,16450,12090,917,696,740
2010,Arizona,04,American Indian and Alaska Native ,75031,41948,33083,1406,1253,1062
2010,Arkansas,05,American Indian and Alaska Native ,6588,4110,2478,455,377,334
2010,California,06,American Indian and Alaska Native ,95144,45623,49521,2110,1380,1555
2010,Colorado,08,American Indian and Alaska Native ,17308,7789,9519,871,504,752
2010,Connecticut,09,American Indian and Alaska Native ,3001,1416,1585,331,195,310
2010,Delaware,10,American Indian and Alaska Native ,993,620,373,210,138,157
2010,District of Columbia,11,American Indian and Alaska Native ,700,250,450,149,102,154
2010,Florida,12,American Indian and Alaska Native ,20418,12323,8095,952,688,667
2010,Georgia,13,American Indian and Alaska Native ,8789,5635,3154,612,469,453
2010,Hawaii,15,American Indian and Alaska Native ,1431,532,899,198,120,171
2010,Idaho,16,American Indian and Alaska Native ,5902,3596,2306,413,336,287
2010,Illinois,17,American Indian and Alaska Native ,8722,4970,3752,633,423,409
2010,Indiana,18,American Indian and Alaska Native ,5709,3256,2453,424,357,279
2010,Iowa,19,American Indian and Alaska Native ,3243,1531,1712,311,243,237
2010,Kansas,20,American Indian and Alaska Native ,8274,4660,3614,481,330,374
2010,Kentucky,21,American Indian and Alaska Native ,3562,1933,1629,331,291,236
2010,Louisiana,22,American Indian and Alaska Native ,9059,6137,2922,555,493,380
2010,Maine,23,American Indian and Alaska Native ,2910,1379,1531,251,186,203
2010,Maryland,24,American Indian and Alaska Native ,5458,3335,2123,383,281,336
2010,Massachusetts,25,American Indian and Alaska Native ,4990,1736,3254,460,274,364
2010,Michigan,26,American Indian and Alaska Native ,19923,12262,7661,776,545,531
2010,Minnesota,27,American Indian and Alaska Native ,19075,8848,10227,614,495,548
2010,Mississippi,28,American Indian and Alaska Native ,4034,2564,1470,348,297,220
2010,Missouri,29,American Indian and Alaska Native ,9519,5324,4195,562,428,336
2010,Montana,30,American Indian and Alaska Native ,17644,8175,9469,422,375,474
2010,Nebraska,31,American Indian and Alaska Native ,4581,1756,2825,360,234,329
2010,Nevada,32,American Indian and Alaska Native ,10789,5965,4824,563,398,430
2010,New Hampshire,33,American Indian and Alaska Native ,1178,587,591,228,137,190
2010,New Jersey,34,American Indian and Alaska Native ,6206,2983,3223,458,318,369
2010,New Mexico,35,American Indian and Alaska Native ,49866,31722,18144,1109,857,929
2010,New York,36,American Indian and Alaska Native ,24120,10120,14000,994,585,771
2010,North Carolina,37,American Indian and Alaska Native ,35854,24194,11660,1033,1046,776
2010,North Dakota,38,American Indian and Alaska Native ,10482,4808,5674,443,293,420
2010,Ohio,39,American Indian and Alaska Native ,9325,4637,4688,598,449,396
2010,Oklahoma,40,American Indian and Alaska Native ,84812,53879,30933,1457,1080,1048
2010,Oregon,41,American Indian and Alaska Native ,18891,8526,10365,880,546,692
2010,Pennsylvania,42,American Indian and Alaska Native ,6985,3679,3306,368,337,372
2010,Rhode Island,44,American Indian and Alaska Native ,1490,509,981,259,148,231
2010,South Carolina,45,American Indian and Alaska Native ,5345,3180,2165,394,329,330
2010,South Dakota,46,American Indian and Alaska Native ,17277,6661,10616,540,443,565
2010,Tennessee,47,American Indian and Alaska Native ,6646,3764,2882,519,322,376
2010,Texas,48,American Indian and Alaska Native ,42138,25819,16319,1321,1039,878
2010,Utah,49,American Indian and Alaska Native ,8931,4548,4383,453,354,415
2010,Vermont,50,American Indian and Alaska Native ,821,473,348,147,112,105
2010,Virginia,51,American Indian and Alaska Native ,8419,4782,3637,560,455,461
2010,Washington,53,American Indian and Alaska Native ,30792,14991,15801,953,733,840
2010,West Virginia,54,American Indian and Alaska Native ,1581,1007,574,231,188,150
2010,Wisconsin,55,American Indian and Alaska Native ,17991,8613,9378,656,447,517
2010,Wyoming,56,American Indian and Alaska Native ,3672,1913,1759,281,226,227
2010,Puerto Rico,72,American Indian and Alaska Native ,2621,1737,884,276,202,170
2011,Alabama,01,American Indian and Alaska Native ,9925,7050,2875,599,442,395
2011,Alaska,02,American Indian and Alaska Native ,28628,16514,12114,743,586,584
2011,Arizona,04,American Indian and Alaska Native ,74513,41196,33317,1377,1029,1139
2011,Arkansas,05,American Indian and Alaska Native ,6211,3997,2214,555,427,351
2011,California,06,American Indian and Alaska Native ,95061,45454,49607,1984,1368,1364
2011,Colorado,08,American Indian and Alaska Native ,17256,7366,9890,837,522,716
2011,Connecticut,09,American Indian and Alaska Native ,2968,1273,1695,340,229,293
2011,Delaware,10,American Indian and Alaska Native ,1004,640,364,168,121,168
2011,District of Columbia,11,American Indian and Alaska Native ,725,287,438,132,78,121
2011,Florida,12,American Indian and Alaska Native ,20430,12116,8314,1158,799,738
2011,Georgia,13,American Indian and Alaska Native ,8587,5306,3281,636,486,414
2011,Hawaii,15,American Indian and Alaska Native ,1286,485,801,219,153,190
2011,Idaho,16,American Indian and Alaska Native ,6159,3672,2487,392,331,268
2011,Illinois,17,American Indian and Alaska Native ,9173,5224,3949,520,390,415
2011,Indiana,18,American Indian and Alaska Native ,5779,3525,2254,395,365,316
2011,Iowa,19,American Indian and Alaska Native ,3381,1514,1867,328,216,293
2011,Kansas,20,American Indian and Alaska Native ,8309,4607,3702,489,402,366
2011,Kentucky,21,American Indian and Alaska Native ,3362,1951,1411,333,226,273
2011,Louisiana,22,American Indian and Alaska Native ,9456,6305,3151,507,416,377
2011,Maine,23,American Indian and Alaska Native ,2898,1278,1620,246,179,239
2011,Maryland,24,American Indian and Alaska Native ,5693,3234,2459,499,363,412
2011,Massachusetts,25,American Indian and Alaska Native ,4687,1545,3142,473,221,398
2011,Michigan,26,American Indian and Alaska Native ,19730,12093,7637,733,556,446
2011,Minnesota,27,American Indian and Alaska Native ,19124,8502,10622,684,484,618
2011,Mississippi,28,American Indian and Alaska Native ,4225,2582,1643,308,277,266
2011,Missouri,29,American Indian and Alaska Native ,8937,4847,4090,527,385,410
2011,Montana,30,American Indian and Alaska Native ,18102,8580,9522,618,489,531
2011,Nebraska,31,American Indian and Alaska Native ,4874,1923,2951,341,210,291
2011,Nevada,32,American Indian and Alaska Native ,10845,5768,5077,586,417,516
2011,New Hampshire,33,American Indian and Alaska Native ,1076,599,477,199,124,150
2011,New Jersey,34,American Indian and Alaska Native ,6597,3172,3425,544,283,413
2011,New Mexico,35,American Indian and Alaska Native ,49966,31757,18209,1031,748,850
2011,New York,36,American Indian and Alaska Native ,24024,10130,13894,915,619,758
2011,North Carolina,37,American Indian and Alaska Native ,36447,24659,11788,1091,954,868
2011,North Dakota,38,American Indian and Alaska Native ,10845,4896,5949,356,340,379
2011,Ohio,39,American Indian and Alaska Native ,8748,4404,4344,571,381,362
2011,Oklahoma,40,American Indian and Alaska Native ,84409,53380,31029,1327,1107,1056
2011,Oregon,41,American Indian and Alaska Native ,18725,8434,10291,853,641,691
2011,Pennsylvania,42,American Indian and Alaska Native ,6774,3492,3282,476,398,375
2011,Rhode Island,44,American Indian and Alaska Native ,1665,442,1223,285,124,270
2011,South Carolina,45,American Indian and Alaska Native ,5805,3527,2278,490,390,395
2011,South Dakota,46,American Indian and Alaska Native ,17823,6718,11105,599,452,662
2011,Tennessee,47,American Indian and Alaska Native ,6262,3786,2476,553,326,430
2011,Texas,48,American Indian and Alaska Native ,43581,26186,17395,1207,1029,964
2011,Utah,49,American Indian and Alaska Native ,9326,4646,4680,480,381,474
2011,Vermont,50,American Indian and Alaska Native ,877,454,423,171,109,134
2011,Virginia,51,American Indian and Alaska Native ,9141,5092,4049,642,455,510
2011,Washington,53,American Indian and Alaska Native ,31377,14978,16399,1037,792,890
2011,West Virginia,54,American Indian and Alaska Native ,1460,882,578,236,172,157
2011,Wisconsin,55,American Indian and Alaska Native ,17853,8659,9194,613,444,483
2011,Wyoming,56,American Indian and Alaska Native ,3561,1893,1668,260,186,262
2011,Puerto Rico,72,American Indian and Alaska Native ,2586,1786,800,335,262,167
2012,Alabama,01,American Indian and Alaska Native ,9758,6990,2768,592,475,331
2012,Alaska,02,American Indian and Alaska Native ,28303,16739,11564,769,541,603
2012,Arizona,04,American Indian and Alaska Native ,74711,41578,33133,1348,970,1246
2012,Arkansas,05,American Indian and Alaska Native ,6358,3978,2380,520,383,344
2012,California,06,American Indian and Alaska Native ,94605,44316,50289,1994,1284,1592
2012,Colorado,08,American Indian and Alaska Native ,16908,7486,9422,841,565,639
2012,Connecticut,09,American Indian and Alaska Native ,2940,1244,1696,329,209,268
2012,Delaware,10,American Indian and Alaska Native ,976,688,288,154,114,117
2012,District of Columbia,11,American Indian and Alaska Native ,917,293,624,151,74,159
2012,Florida,12,American Indian and Alaska Native ,20309,11639,8670,1062,689,822
2012,Georgia,13,American Indian and Alaska Native ,9092,5537,3555,643,517,373
2012,Hawaii,15,American Indian and Alaska Native ,1360,491,869,195,136,176
2012,Idaho,16,American Indian and Alaska Native ,6124,3654,2470,460,372,348
2012,Illinois,17,American Indian and Alaska Native ,9654,5599,4055,607,502,402
2012,Indiana,18,American Indian and Alaska Native ,5859,3387,2472,385,340,306
2012,Iowa,19,American Indian and Alaska Native ,3271,1348,1923,318,220,271
2012,Kansas,20,American Indian and Alaska Native ,7967,4413,3554,487,330,400
2012,Kentucky,21,American Indian and Alaska Native ,3374,1998,1376,385,277,258
2012,Louisiana,22,American Indian and Alaska Native ,10034,6600,3434,588,433,402
2012,Maine,23,American Indian and Alaska Native ,3021,1294,1727,288,174,256
2012,Maryland,24,American Indian and Alaska Native ,5950,3480,2470,465,365,380
2012,Massachusetts,25,American Indian and Alaska Native ,5193,1751,3442,471,254,402
2012,Michigan,26,American Indian and Alaska Native ,20087,12229,7858,745,548,517
2012,Minnesota,27,American Indian and Alaska Native ,19001,8494,10507,666,457,570
2012,Mississippi,28,American Indian and Alaska Native ,4034,2528,1506,417,264,290
2012,Missouri,29,American Indian and Alaska Native ,8854,5035,3819,582,464,350
2012,Montana,30,American Indian and Alaska Native ,18285,8683,9602,639,443,547
2012,Nebraska,31,American Indian and Alaska Native ,4982,1836,3146,324,214,306
2012,Nevada,32,American Indian and Alaska Native ,11021,5707,5314,507,415,516
2012,New Hampshire,33,American Indian and Alaska Native ,923,621,302,191,141,117
2012,New Jersey,34,American Indian and Alaska Native ,7058,3288,3770,473,351,432
2012,New Mexico,35,American Indian and Alaska Native ,49226,31669,17557,881,780,819
2012,New York,36,American Indian and Alaska Native ,24415,10343,14072,872,556,679
2012,North Carolina,37,American Indian and Alaska Native ,37052,24489,12563,984,860,724
2012,North Dakota,38,American Indian and Alaska Native ,11044,5131,5913,381,304,347
2012,Ohio,39,American Indian and Alaska Native ,8941,4443,4498,437,330,393
2012,Oklahoma,40,American Indian and Alaska Native ,85391,54017,31374,1314,1094,964
2012,Oregon,41,American Indian and Alaska Native ,17637,8076,9561,813,567,629
2012,Pennsylvania,42,American Indian and Alaska Native ,6912,3446,3466,461,318,389
2012,Rhode Island,44,American Indian and Alaska Native ,1833,450,1383,273,130,280
2012,South Carolina,45,American Indian and Alaska Native ,6179,3643,2536,539,378,397
2012,South Dakota,46,American Indian and Alaska Native ,17978,7040,10938,455,450,504
2012,Tennessee,47,American Indian and Alaska Native ,6235,3458,2777,521,380,400
2012,Texas,48,American Indian and Alaska Native ,44655,26751,17904,1415,1091,963
2012,Utah,49,American Indian and Alaska Native ,9093,4424,4669,540,305,476
2012,Vermont,50,American Indian and Alaska Native ,807,376,431,149,101,133
2012,Virginia,51,American Indian and Alaska Native ,9023,4825,4198,561,447,445
2012,Washington,53,American Indian and Alaska Native ,31294,14465,16829,813,698,690
2012,West Virginia,54,American Indian and Alaska Native ,1338,771,567,201,160,166
2012,Wisconsin,55,American Indian and Alaska Native ,18021,8662,9359,739,470,554
2012,Wyoming,56,American Indian and Alaska Native ,3507,1884,1623,288,206,205
2012,Puerto Rico,72,American Indian and Alaska Native ,2951,1843,1108,321,273,210
2013,Alabama,01,American Indian and Alaska Native ,9503,6780,2723,572,453,359
2013,Alaska,02,American Indian and Alaska Native ,28594,16633,11961,662,471,622
2013,Arizona,04,American Indian and Alaska Native ,75452,42260,33192,1502,1119,1187
2013,Arkansas,05,American Indian and Alaska Native ,6910,4307,2603,519,364,368
2013,California,06,American Indian and Alaska Native ,93331,42834,50497,1917,1344,1561
2013,Colorado,08,American Indian and Alaska Native ,16805,7664,9141,752,564,633
2013,Connecticut,09,American Indian and Alaska Native ,2846,1390,1456,288,213,234
2013,Delaware,10,American Indian and Alaska Native ,1043,782,261,157,129,89
2013,District of Columbia,11,American Indian and Alaska Native ,880,275,605,158,95,175
2013,Florida,12,American Indian and Alaska Native ,20157,11460,8697,1146,799,827
2013,Georgia,13,American Indian and Alaska Native ,9107,5562,3545,640,506,456
2013,Hawaii,15,American Indian and Alaska Native ,1220,421,799,182,126,168
2013,Idaho,16,American Indian and Alaska Native ,6573,3765,2808,430,343,318
2013,Illinois,17,American Indian and Alaska Native ,10037,5568,4469,658,519,456
2013,Indiana,18,American Indian and Alaska Native ,5716,3356,2360,468,301,357
2013,Iowa,19,American Indian and Alaska Native ,3259,1383,1876,312,232,243
2013,Kansas,20,American Indian and Alaska Native ,7983,4446,3537,457,407,361
2013,Kentucky,21,American Indian and Alaska Native ,3194,1850,1344,345,245,266
2013,Louisiana,22,American Indian and Alaska Native ,10238,6440,3798,563,439,445
2013,Maine,23,American Indian and Alaska Native ,3042,1418,1624,338,227,237
2013,Maryland,24,American Indian and Alaska Native ,5778,3218,2560,540,342,420
2013,Massachusetts,25,American Indian and Alaska Native ,5033,1892,3141,447,261,336
2013,Michigan,26,American Indian and Alaska Native ,20198,12214,7984,655,558,516
2013,Minnesota,27,American Indian and Alaska Native ,19125,8596,10529,632,399,538
2013,Mississippi,28,American Indian and Alaska Native ,3763,2321,1442,377,256,284
2013,Missouri,29,American Indian and Alaska Native ,9165,4963,4202,487,410,414
2013,Montana,30,American Indian and Alaska Native ,18226,8906,9320,540,484,433
2013,Nebraska,31,American Indian and Alaska Native ,4850,1836,3014,386,178,341
2013,Nevada,32,American Indian and Alaska Native ,10283,5212,5071,449,416,411
2013,New Hampshire,33,American Indian and Alaska Native ,908,548,360,184,151,125
2013,New Jersey,34,American Indian and Alaska Native ,6690,3240,3450,491,304,448
2013,New Mexico,35,American Indian and Alaska Native ,49312,31734,17578,977,733,657
2013,New York,36,American Indian and Alaska Native ,25194,10449,14745,892,520,859
2013,North Carolina,37,American Indian and Alaska Native ,37686,24721,12965,978,859,814
2013,North Dakota,38,American Indian and Alaska Native ,11113,5206,5907,289,283,311
2013,Ohio,39,American Indian and Alaska Native ,8855,4552,4303,586,382,394
2013,Oklahoma,40,American Indian and Alaska Native ,87248,55025,32223,1538,1113,907
2013,Oregon,41,American Indian and Alaska Native ,16074,7448,8626,699,552,587
2013,Pennsylvania,42,American Indian and Alaska Native ,7280,3518,3762,508,366,369
2013,Rhode Island,44,American Indian and Alaska Native ,1761,500,1261,281,179,245
2013,South Carolina,45,American Indian and Alaska Native ,5775,3413,2362,536,381,391
2013,South Dakota,46,American Indian and Alaska Native ,18049,6659,11390,548,372,509
2013,Tennessee,47,American Indian and Alaska Native ,6259,3677,2582,552,357,397
2013,Texas,48,American Indian and Alaska Native ,45042,26373,18669,1202,1083,909
2013,Utah,49,American Indian and Alaska Native ,9213,4639,4574,506,341,383
2013,Vermont,50,American Indian and Alaska Native ,814,421,393,151,93,124
2013,Virginia,51,American Indian and Alaska Native ,8737,4879,3858,509,394,439
2013,Washington,53,American Indian and Alaska Native ,31844,14913,16931,1035,680,846
2013,West Virginia,54,American Indian and Alaska Native ,1280,740,540,212,138,159
2013,Wisconsin,55,American Indian and Alaska Native ,17728,8907,8821,629,486,503
2013,Wyoming,56,American Indian and Alaska Native ,3542,1845,1697,302,195,245
2013,Puerto Rico,72,American Indian and Alaska Native ,3430,1986,1444,413,292,264
2014,Alabama,01,American Indian and Alaska Native ,9720,6907,2813,582,475,352
2014,Alaska,02,American Indian and Alaska Native ,28717,16845,11872,609,410,526
2014,Arizona,04,American Indian and Alaska Native ,77455,42147,35308,1416,912,992
2014,Arkansas,05,American Indian and Alaska Native ,7122,4413,2709,461,397,375
2014,California,06,American Indian and Alaska Native ,93161,42159,51002,2298,1448,1758
2014,Colorado,08,American Indian and Alaska Native ,16502,7720,8782,733,498,663
2014,Connecticut,09,American Indian and Alaska Native ,2660,1303,1357,319,200,250
2014,Delaware,10,American Indian and Alaska Native ,1198,894,304,199,164,103
2014,District of Columbia,11,American Indian and Alaska Native ,949,279,670,165,94,164
2014,Florida,12,American Indian and Alaska Native ,20074,11720,8354,948,727,656
2014,Georgia,13,American Indian and Alaska Native ,9098,5313,3785,636,605,385
2014,Hawaii,15,American Indian and Alaska Native ,1103,308,795,196,116,183
2014,Idaho,16,American Indian and Alaska Native ,6793,3738,3055,486,301,354
2014,Illinois,17,American Indian and Alaska Native ,10507,5847,4660,666,510,503
2014,Indiana,18,American Indian and Alaska Native ,6073,3700,2373,476,405,283
2014,Iowa,19,American Indian and Alaska Native ,3443,1521,1922,321,208,220
2014,Kansas,20,American Indian and Alaska Native ,8299,4729,3570,462,383,280
2014,Kentucky,21,American Indian and Alaska Native ,3715,1989,1726,378,291,286
2014,Louisiana,22,American Indian and Alaska Native ,10401,6580,3821,604,522,433
2014,Maine,23,American Indian and Alaska Native ,2997,1262,1735,262,168,220
2014,Maryland,24,American Indian and Alaska Native ,5645,2871,2774,436,321,361
2014,Massachusetts,25,American Indian and Alaska Native ,5280,2031,3249,467,296,350
2014,Michigan,26,American Indian and Alaska Native ,20170,12182,7988,678,515,526
2014,Minnesota,27,American Indian and Alaska Native ,18644,8610,10034,624,416,480
2014,Mississippi,28,American Indian and Alaska Native ,3922,2420,1502,299,263,240
2014,Missouri,29,American Indian and Alaska Native ,9845,5488,4357,532,423,446
2014,Montana,30,American Indian and Alaska Native ,18384,8860,9524,626,398,580
2014,Nebraska,31,American Indian and Alaska Native ,4740,1834,2906,354,194,323
2014,Nevada,32,American Indian and Alaska Native ,10013,4930,5083,567,409,462
2014,New Hampshire,33,American Indian and Alaska Native ,1029,538,491,210,139,142
2014,New Jersey,34,American Indian and Alaska Native ,6639,3061,3578,548,392,360
2014,New Mexico,35,American Indian and Alaska Native ,49990,31586,18404,938,808,806
2014,New York,36,American Indian and Alaska Native ,25787,10666,15121,914,461,856
2014,North Carolina,37,American Indian and Alaska Native ,38662,25056,13606,946,701,725
2014,North Dakota,38,American Indian and Alaska Native ,11163,5153,6010,416,316,460
2014,Ohio,39,American Indian and Alaska Native ,9361,4421,4940,620,382,402
2014,Oklahoma,40,American Indian and Alaska Native ,89786,56008,33778,1228,1006,847
2014,Oregon,41,American Indian and Alaska Native ,16118,7530,8588,732,505,569
2014,Pennsylvania,42,American Indian and Alaska Native ,8133,3973,4160,513,429,382
2014,Rhode Island,44,American Indian and Alaska Native ,1799,396,1403,199,127,222
2014,South Carolina,45,American Indian and Alaska Native ,5902,3675,2227,475,342,293
2014,South Dakota,46,American Indian and Alaska Native ,17860,6733,11127,527,314,483
2014,Tennessee,47,American Indian and Alaska Native ,6618,3873,2745,510,382,434
2014,Texas,48,American Indian and Alaska Native ,44949,26503,18446,1742,1190,1093
2014,Utah,49,American Indian and Alaska Native ,9320,4771,4549,454,375,445
2014,Vermont,50,American Indian and Alaska Native ,921,570,351,176,124,110
2014,Virginia,51,American Indian and Alaska Native ,8502,4958,3544,528,411,429
2014,Washington,53,American Indian and Alaska Native ,31597,15136,16461,882,666,712
2014,West Virginia,54,American Indian and Alaska Native ,1255,942,313,269,209,159
2014,Wisconsin,55,American Indian and Alaska Native ,17643,8694,8949,504,342,517
2014,Wyoming,56,American Indian and Alaska Native ,3469,1760,1709,325,201,266
2014,Puerto Rico,72,American Indian and Alaska Native ,3792,2119,1673,378,297,242
2015,Alabama,01,American Indian and Alaska Native ,9399,6848,2551,533,416,339
2015,Alaska,02,American Indian and Alaska Native ,27505,16409,11096,645,448,532
2015,Arizona,04,American Indian and Alaska Native ,78357,42847,35510,1315,993,1023
2015,Arkansas,05,American Indian and Alaska Native ,6774,4101,2673,594,420,358
2015,California,06,American Indian and Alaska Native ,91680,41729,49951,2037,1253,1594
2015,Colorado,08,American Indian and Alaska Native ,16685,8029,8656,815,498,599
2015,Connecticut,09,American Indian and Alaska Native ,3103,1519,1584,296,246,274
2015,Delaware,10,American Indian and Alaska Native ,1311,985,326,192,177,94
2015,District of Columbia,11,American Indian and Alaska Native ,945,298,647,150,102,139
2015,Florida,12,American Indian and Alaska Native ,18712,10875,7837,890,708,609
2015,Georgia,13,American Indian and Alaska Native ,9536,4955,4581,718,482,462
2015,Hawaii,15,American Indian and Alaska Native ,1140,365,775,207,105,209
2015,Idaho,16,American Indian and Alaska Native ,6572,3729,2843,454,368,290
2015,Illinois,17,American Indian and Alaska Native ,10608,5730,4878,694,475,521
2015,Indiana,18,American Indian and Alaska Native ,5859,3665,2194,433,381,277
2015,Iowa,19,American Indian and Alaska Native ,3792,1606,2186,385,274,267
2015,Kansas,20,American Indian and Alaska Native ,8499,4648,3851,444,338,389
2015,Kentucky,21,American Indian and Alaska Native ,3610,1937,1673,398,307,283
2015,Louisiana,22,American Indian and Alaska Native ,9868,6482,3386,571,469,475
2015,Maine,23,American Indian and Alaska Native ,3012,1368,1644,222,153,194
2015,Maryland,24,American Indian and Alaska Native ,5699,2898,2801,395,257,371
2015,Massachusetts,25,American Indian and Alaska Native ,4670,1828,2842,369,248,337
2015,Michigan,26,American Indian and Alaska Native ,19587,11987,7600,716,554,441
2015,Minnesota,27,American Indian and Alaska Native ,18423,8583,9840,543,415,453
2015,Mississippi,28,American Indian and Alaska Native ,4129,2549,1580,369,260,272
2015,Missouri,29,American Indian and Alaska Native ,10032,5620,4412,576,440,387
2015,Montana,30,American Indian and Alaska Native ,18485,8639,9846,535,371,409
2015,Nebraska,31,American Indian and Alaska Native ,4943,1904,3039,335,200,311
2015,Nevada,32,American Indian and Alaska Native ,10552,5086,5466,594,359,455
2015,New Hampshire,33,American Indian and Alaska Native ,933,510,423,169,128,115
2015,New Jersey,34,American Indian and Alaska Native ,6431,3124,3307,531,361,429
2015,New Mexico,35,American Indian and Alaska Native ,51236,31955,19281,1045,844,806
2015,New York,36,American Indian and Alaska Native ,26323,10627,15696,1095,597,928
2015,North Carolina,37,American Indian and Alaska Native ,40152,25669,14483,908,730,784
2015,North Dakota,38,American Indian and Alaska Native ,11340,5172,6168,345,311,367
2015,Ohio,39,American Indian and Alaska Native ,9533,4571,4962,606,418,444
2015,Oklahoma,40,American Indian and Alaska Native ,90616,55982,34634,1106,943,948
2015,Oregon,41,American Indian and Alaska Native ,15965,7206,8759,835,475,645
2015,Pennsylvania,42,American Indian and Alaska Native ,8243,3997,4246,500,384,460
2015,Rhode Island,44,American Indian and Alaska Native ,1892,440,1452,225,141,229
2015,South Carolina,45,American Indian and Alaska Native ,5852,3589,2263,470,382,315
2015,South Dakota,46,American Indian and Alaska Native ,17872,6775,11097,485,334,480
2015,Tennessee,47,American Indian and Alaska Native ,6635,3784,2851,516,400,430
2015,Texas,48,American Indian and Alaska Native ,44607,25796,18811,1583,1226,970
2015,Utah,49,American Indian and Alaska Native ,8889,4592,4297,496,342,383
2015,Vermont,50,American Indian and Alaska Native ,898,574,324,147,116,100
2015,Virginia,51,American Indian and Alaska Native ,8218,4918,3300,576,458,382
2015,Washington,53,American Indian and Alaska Native ,31344,14936,16408,1026,724,792
2015,West Virginia,54,American Indian and Alaska Native ,1267,871,396,213,175,126
2015,Wisconsin,55,American Indian and Alaska Native ,17669,8498,9171,590,380,489
2015,Wyoming,56,American Indian and Alaska Native ,3430,1841,1589,293,177,236
2015,Puerto Rico,72,American Indian and Alaska Native ,4110,2183,1927,440,332,281
2016,Alabama,01,American Indian and Alaska Native ,9210,6661,2549,532,486,309
2016,Alaska,02,American Indian and Alaska Native ,28175,16631,11544,697,518,480
2016,Arizona,04,American Indian and Alaska Native ,80207,43423,36784,1543,900,1063
2016,Arkansas,05,American Indian and Alaska Native ,7232,4508,2724,530,407,356
2016,California,06,American Indian and Alaska Native ,91047,40430,50617,2018,1385,1526
2016,Colorado,08,American Indian and Alaska Native ,17268,8398,8870,734,547,603
2016,Connecticut,09,American Indian and Alaska Native ,3100,1471,1629,360,236,294
2016,Delaware,10,American Indian and Alaska Native ,1417,1054,363,161,155,92
2016,District of Columbia,11,American Indian and Alaska Native ,889,292,597,196,121,152
2016,Florida,12,American Indian and Alaska Native ,18878,11319,7559,947,825,626
2016,Georgia,13,American Indian and Alaska Native ,10331,5000,5331,681,447,528
2016,Hawaii,15,American Indian and Alaska Native ,1038,319,719,221,101,194
2016,Idaho,16,American Indian and Alaska Native ,6837,3813,3024,459,321,336
2016,Illinois,17,American Indian and Alaska Native ,10847,5605,5242,769,495,576
2016,Indiana,18,American Indian and Alaska Native ,6181,3607,2574,526,431,380
2016,Iowa,19,American Indian and Alaska Native ,3566,1537,2029,346,280,263
2016,Kansas,20,American Indian and Alaska Native ,8605,4564,4041,481,319,416
2016,Kentucky,21,American Indian and Alaska Native ,3581,1851,1730,462,273,327
2016,Louisiana,22,American Indian and Alaska Native ,9455,6395,3060,563,474,431
2016,Maine,23,American Indian and Alaska Native ,3124,1422,1702,272,130,230
2016,Maryland,24,American Indian and Alaska Native ,5997,3211,2786,525,385,397
2016,Massachusetts,25,American Indian and Alaska Native ,5023,1882,3141,432,239,376
2016,Michigan,26,American Indian and Alaska Native ,19325,11689,7636,647,461,516
2016,Minnesota,27,American Indian and Alaska Native ,18411,8747,9664,679,337,575
2016,Mississippi,28,American Indian and Alaska Native ,4111,2581,1530,369,293,237
2016,Missouri,29,American Indian and Alaska Native ,10166,5644,4522,556,440,448
2016,Montana,30,American Indian and Alaska Native ,18552,8649,9903,515,397,446
2016,Nebraska,31,American Indian and Alaska Native ,4875,1841,3034,384,236,335
2016,Nevada,32,American Indian and Alaska Native ,10829,5333,5496,559,397,438
2016,New Hampshire,33,American Indian and Alaska Native ,893,467,426,156,120,117
2016,New Jersey,34,American Indian and Alaska Native ,6253,3071,3182,447,345,332
2016,New Mexico,35,American Indian and Alaska Native ,52690,32357,20333,1045,820,823
2016,New York,36,American Indian and Alaska Native ,26246,10658,15588,971,554,929
2016,North Carolina,37,American Indian and Alaska Native ,40585,25932,14653,880,748,744
2016,North Dakota,38,American Indian and Alaska Native ,11326,5002,6324,433,303,437
2016,Ohio,39,American Indian and Alaska Native ,9408,4438,4970,619,433,448
2016,Oklahoma,40,American Indian and Alaska Native ,92889,57749,35140,1178,994,881
2016,Oregon,41,American Indian and Alaska Native ,15075,6872,8203,732,472,629
2016,Pennsylvania,42,American Indian and Alaska Native ,8370,4191,4179,521,363,423
2016,Rhode Island,44,American Indian and Alaska Native ,1989,429,1560,269,161,230
2016,South Carolina,45,American Indian and Alaska Native ,5795,3814,1981,475,340,307
2016,South Dakota,46,American Indian and Alaska Native ,18357,6917,11440,481,399,473
2016,Tennessee,47,American Indian and Alaska Native ,6909,3697,3212,481,343,332
2016,Texas,48,American Indian and Alaska Native ,44010,25464,18546,1398,1088,914
2016,Utah,49,American Indian and Alaska Native ,8473,4610,3863,432,368,410
2016,Vermont,50,American Indian and Alaska Native ,899,587,312,160,141,99
2016,Virginia,51,American Indian and Alaska Native ,8114,4789,3325,494,378,395
2016,Washington,53,American Indian and Alaska Native ,30986,15423,15563,917,581,841
2016,West Virginia,54,American Indian and Alaska Native ,1353,876,477,228,220,159
2016,Wisconsin,55,American Indian and Alaska Native ,18239,8525,9714,586,430,460
2016,Wyoming,56,American Indian and Alaska Native ,3412,1850,1562,291,167,270
2016,Puerto Rico,72,American Indian and Alaska Native ,4165,2114,2051,425,315,268
2017,Alabama,01,American Indian and Alaska Native ,9620,6797,2823,605,576,344
2017,Alaska,02,American Indian and Alaska Native ,28821,17109,11712,740,510,524
2017,Arizona,04,American Indian and Alaska Native ,81902,43695,38207,1451,870,1185
2017,Arkansas,05,American Indian and Alaska Native ,7421,4486,2935,563,432,366
2017,California,06,American Indian and Alaska Native ,92887,42732,50155,2190,1417,1672
2017,Colorado,08,American Indian and Alaska Native ,18380,8727,9653,820,569,644
2017,Connecticut,09,American Indian and Alaska Native ,3127,1410,1717,363,217,323
2017,Delaware,10,American Indian and Alaska Native ,1440,1009,431,224,196,130
2017,District of Columbia,11,American Indian and Alaska Native ,775,267,508,182,118,147
2017,Florida,12,American Indian and Alaska Native ,19994,12086,7908,884,696,609
2017,Georgia,13,American Indian and Alaska Native ,10831,5249,5582,617,438,473
2017,Hawaii,15,American Indian and Alaska Native ,1061,354,707,184,100,146
2017,Idaho,16,American Indian and Alaska Native ,7171,4011,3160,461,332,310
2017,Illinois,17,American Indian and Alaska Native ,11117,5761,5356,698,510,569
2017,Indiana,18,American Indian and Alaska Native ,6218,3697,2521,454,381,289
2017,Iowa,19,American Indian and Alaska Native ,3893,1700,2193,400,259,253
2017,Kansas,20,American Indian and Alaska Native ,8905,4736,4169,472,396,321
2017,Kentucky,21,American Indian and Alaska Native ,3786,1883,1903,504,282,398
2017,Louisiana,22,American Indian and Alaska Native ,9736,6595,3141,516,457,414
2017,Maine,23,American Indian and Alaska Native ,3255,1573,1682,262,171,205
2017,Maryland,24,American Indian and Alaska Native ,5982,3174,2808,424,282,358
2017,Massachusetts,25,American Indian and Alaska Native ,4857,1784,3073,418,284,370
2017,Michigan,26,American Indian and Alaska Native ,19229,11828,7401,667,490,492
2017,Minnesota,27,American Indian and Alaska Native ,18961,8715,10246,654,421,504
2017,Mississippi,28,American Indian and Alaska Native ,4239,2805,1434,334,284,247
2017,Missouri,29,American Indian and Alaska Native ,10525,5981,4544,593,465,474
2017,Montana,30,American Indian and Alaska Native ,18573,8973,9600,549,394,463
2017,Nebraska,31,American Indian and Alaska Native ,5042,1996,3046,377,252,306
2017,Nevada,32,American Indian and Alaska Native ,11213,5717,5496,521,464,440
2017,New Hampshire,33,American Indian and Alaska Native ,908,454,454,169,129,124
2017,New Jersey,34,American Indian and Alaska Native ,6142,2874,3268,402,293,382
2017,New Mexico,35,American Indian and Alaska Native ,55047,34042,21005,943,813,833
2017,New York,36,American Indian and Alaska Native ,26710,10577,16133,995,695,832
2017,North Carolina,37,American Indian and Alaska Native ,40653,26585,14068,875,692,813
2017,North Dakota,38,American Indian and Alaska Native ,11702,5235,6467,444,296,427
2017,Ohio,39,American Indian and Alaska Native ,9395,4548,4847,707,453,536
2017,Oklahoma,40,American Indian and Alaska Native ,94184,58718,35466,1352,991,915
2017,Oregon,41,American Indian and Alaska Native ,15449,6918,8531,837,491,602
2017,Pennsylvania,42,American Indian and Alaska Native ,8774,4419,4355,565,344,429
2017,Rhode Island,44,American Indian and Alaska Native ,1964,369,1595,309,123,298
2017,South Carolina,45,American Indian and Alaska Native ,5830,3831,1999,361,335,273
2017,South Dakota,46,American Indian and Alaska Native ,18363,6917,11446,532,321,532
2017,Tennessee,47,American Indian and Alaska Native ,7044,4064,2980,524,360,393
2017,Texas,48,American Indian and Alaska Native ,44850,26243,18607,1319,1081,936
2017,Utah,49,American Indian and Alaska Native ,8591,4676,3915,543,362,422
2017,Vermont,50,American Indian and Alaska Native ,958,659,299,163,148,90
2017,Virginia,51,American Indian and Alaska Native ,8513,5319,3194,511,440,373
2017,Washington,53,American Indian and Alaska Native ,31485,16176,15309,980,693,887
2017,West Virginia,54,American Indian and Alaska Native ,1465,1081,384,298,270,121
2017,Wisconsin,55,American Indian and Alaska Native ,18199,8683,9516,587,361,470
2017,Wyoming,56,American Indian and Alaska Native ,3592,1920,1672,268,207,197
2017,Puerto Rico,72,American Indian and Alaska Native ,3934,2209,1725,432,323,275
2018,Alabama,01,American Indian and Alaska Native ,9915,7052,2863,703,521,418
2018,Alaska,02,American Indian and Alaska Native ,29073,17356,11717,708,584,585
2018,Arizona,04,American Indian and Alaska Native ,84607,45185,39422,1469,943,1162
2018,Arkansas,05,American Indian and Alaska Native ,7065,4257,2808,533,422,323
2018,California,06,American Indian and Alaska Native ,93898,45134,48764,1874,1153,1370
2018,Colorado,08,American Indian and Alaska Native ,19579,9374,10205,783,575,732
2018,Connecticut,09,American Indian and Alaska Native ,3531,1410,2121,440,267,369
2018,Delaware,10,American Indian and Alaska Native ,1478,1038,440,197,177,131
2018,District of Columbia,11,American Indian and Alaska Native ,929,345,584,186,114,149
2018,Florida,12,American Indian and Alaska Native ,21203,12652,8551,847,713,712
2018,Georgia,13,American Indian and Alaska Native ,11854,5399,6455,812,478,746
2018,Hawaii,15,American Indian and Alaska Native ,1203,429,774,203,123,182
2018,Idaho,16,American Indian and Alaska Native ,7322,4090,3232,488,365,398
2018,Illinois,17,American Indian and Alaska Native ,11256,5771,5485,653,554,512
2018,Indiana,18,American Indian and Alaska Native ,6352,3574,2778,440,333,388
2018,Iowa,19,American Indian and Alaska Native ,3864,1686,2178,314,265,251
2018,Kansas,20,American Indian and Alaska Native ,8898,4334,4564,474,306,387
2018,Kentucky,21,American Indian and Alaska Native ,3768,1982,1786,431,304,314
2018,Louisiana,22,American Indian and Alaska Native ,9414,6548,2866,579,492,420
2018,Maine,23,American Indian and Alaska Native ,3378,1537,1841,261,188,238
2018,Maryland,24,American Indian and Alaska Native ,6145,3443,2702,516,319,396
2018,Massachusetts,25,American Indian and Alaska Native ,4895,1682,3213,473,294,372
2018,Michigan,26,American Indian and Alaska Native ,19391,12055,7336,698,572,457
2018,Minnesota,27,American Indian and Alaska Native ,19200,8836,10364,579,419,551
2018,Mississippi,28,American Indian and Alaska Native ,4703,3155,1548,387,280,296
2018,Missouri,29,American Indian and Alaska Native ,10871,6243,4628,524,450,434
2018,Montana,30,American Indian and Alaska Native ,18461,8681,9780,595,384,503
2018,Nebraska,31,American Indian and Alaska Native ,5233,2270,2963,312,234,267
2018,Nevada,32,American Indian and Alaska Native ,12640,6176,6464,539,399,466
2018,New Hampshire,33,American Indian and Alaska Native ,931,442,489,167,120,131
2018,New Jersey,34,American Indian and Alaska Native ,6218,2872,3346,453,313,375
2018,New Mexico,35,American Indian and Alaska Native ,55869,34311,21558,1022,728,846
2018,New York,36,American Indian and Alaska Native ,28096,10944,17152,1104,572,1097
2018,North Carolina,37,American Indian and Alaska Native ,41840,26846,14994,945,786,712
2018,North Dakota,38,American Indian and Alaska Native ,11480,5149,6331,423,295,443
2018,Ohio,39,American Indian and Alaska Native ,9980,4382,5598,625,442,502
2018,Oklahoma,40,American Indian and Alaska Native ,96215,60282,35933,1309,1080,864
2018,Oregon,41,American Indian and Alaska Native ,16331,7310,9021,926,594,781
2018,Pennsylvania,42,American Indian and Alaska Native ,8912,4389,4523,649,527,423
2018,Rhode Island,44,American Indian and Alaska Native ,1919,383,1536,320,127,320
2018,South Carolina,45,American Indian and Alaska Native ,6539,4041,2498,400,427,301
2018,South Dakota,46,American Indian and Alaska Native ,18000,6900,11100,553,303,544
2018,Tennessee,47,American Indian and Alaska Native ,7180,4123,3057,536,428,369
2018,Texas,48,American Indian and Alaska Native ,45911,26987,18924,1586,1167,1149
2018,Utah,49,American Indian and Alaska Native ,9011,4693,4318,520,368,467
2018,Vermont,50,American Indian and Alaska Native ,1011,693,318,171,143,124
2018,Virginia,51,American Indian and Alaska Native ,8486,5128,3358,606,481,406
2018,Washington,53,American Indian and Alaska Native ,31955,16526,15429,966,762,766
2018,West Virginia,54,American Indian and Alaska Native ,1621,1029,592,275,175,195
2018,Wisconsin,55,American Indian and Alaska Native ,18702,8813,9889,586,378,454
2018,Wyoming,56,American Indian and Alaska Native ,3618,1903,1715,267,211,242
2018,Puerto Rico,72,American Indian and Alaska Native ,3304,1873,1431,381,334,248
2019,Alabama,01,American Indian and Alaska Native ,9848,7115,2733,663,530,403
2019,Alaska,02,American Indian and Alaska Native ,29726,17630,12096,768,605,570
2019,Arizona,04,American Indian and Alaska Native ,86934,47678,39256,1284,1095,1181
2019,Arkansas,05,American Indian and Alaska Native ,7270,4319,2951,589,486,380
2019,California,06,American Indian and Alaska Native ,96536,47048,49488,2178,1420,1586
2019,Colorado,08,American Indian and Alaska Native ,20395,10101,10294,1001,732,831
2019,Connecticut,09,American Indian and Alaska Native ,3668,1486,2182,409,257,338
2019,Delaware,10,American Indian and Alaska Native ,1615,1097,518,238,217,173
2019,District of Columbia,11,American Indian and Alaska Native ,881,294,587,177,123,154
2019,Florida,12,American Indian and Alaska Native ,20884,12244,8640,1091,849,708
2019,Georgia,13,American Indian and Alaska Native ,13120,5900,7220,827,533,744
2019,Hawaii,15,American Indian and Alaska Native ,1427,536,891,221,150,172
2019,Idaho,16,American Indian and Alaska Native ,7814,4392,3422,588,448,458
2019,Illinois,17,American Indian and Alaska Native ,11527,6084,5443,710,514,583
2019,Indiana,18,American Indian and Alaska Native ,6320,3783,2537,565,459,385
2019,Iowa,19,American Indian and Alaska Native ,3935,1783,2152,345,272,272
2019,Kansas,20,American Indian and Alaska Native ,8625,3908,4717,486,320,416
2019,Kentucky,21,American Indian and Alaska Native ,3676,1804,1872,457,252,342
2019,Louisiana,22,American Indian and Alaska Native ,9739,6717,3022,593,523,474
2019,Maine,23,American Indian and Alaska Native ,3568,1830,1738,307,235,234
2019,Maryland,24,American Indian and Alaska Native ,6711,3752,2959,662,435,474
2019,Massachusetts,25,American Indian and Alaska Native ,5193,1835,3358,467,291,441
2019,Michigan,26,American Indian and Alaska Native ,19528,11966,7562,747,583,507
2019,Minnesota,27,American Indian and Alaska Native ,18773,8740,10033,524,424,454
2019,Mississippi,28,American Indian and Alaska Native ,4706,3129,1577,402,346,252
2019,Missouri,29,American Indian and Alaska Native ,10659,5788,4871,680,444,581
2019,Montana,30,American Indian and Alaska Native ,18241,8609,9632,581,365,525
2019,Nebraska,31,American Indian and Alaska Native ,5197,2242,2955,386,300,278
2019,Nevada,32,American Indian and Alaska Native ,13422,6760,6662,783,505,580
2019,New Hampshire,33,American Indian and Alaska Native ,887,447,440,182,128,143
2019,New Jersey,34,American Indian and Alaska Native ,6524,3271,3253,482,332,388
2019,New Mexico,35,American Indian and Alaska Native ,56422,34707,21715,1049,816,816
2019,New York,36,American Indian and Alaska Native ,28195,10972,17223,1150,726,1053
2019,North Carolina,37,American Indian and Alaska Native ,42343,27287,15056,977,844,784
2019,North Dakota,38,American Indian and Alaska Native ,11832,5374,6458,500,283,505
2019,Ohio,39,American Indian and Alaska Native ,9651,4236,5415,748,498,570
2019,Oklahoma,40,American Indian and Alaska Native ,98151,61400,36751,1264,1084,904
2019,Oregon,41,American Indian and Alaska Native ,16365,7467,8898,918,602,654
2019,Pennsylvania,42,American Indian and Alaska Native ,8718,4558,4160,614,465,439
2019,Rhode Island,44,American Indian and Alaska Native ,1944,391,1553,313,163,269
2019,South Carolina,45,American Indian and Alaska Native ,6857,4132,2725,521,441,364
2019,South Dakota,46,American Indian and Alaska Native ,18190,6977,11213,546,392,519
2019,Tennessee,47,American Indian and Alaska Native ,7813,4102,3711,673,495,469
2019,Texas,48,American Indian and Alaska Native ,48391,28729,19662,1486,1302,1102
2019,Utah,49,American Indian and Alaska Native ,9116,4772,4344,622,379,489
2019,Vermont,50,American Indian and Alaska Native ,954,581,373,176,121,126
2019,Virginia,51,American Indian and Alaska Native ,8621,5157,3464,580,453,425
2019,Washington,53,American Indian and Alaska Native ,32351,16939,15412,1012,681,778
2019,West Virginia,54,American Indian and Alaska Native ,1502,889,613,307,233,203
2019,Wisconsin,55,American Indian and Alaska Native ,19139,8880,10259,596,423,475
2019,Wyoming,56,American Indian and Alaska Native ,3624,2116,1508,273,239,189
2019,Puerto Rico,72,American Indian and Alaska Native ,2664,1610,1054,415,343,231
2020,Alabama,01,American Indian and Alaska Native ,9798,7136,2662,684,598,410
2020,Alaska,02,American Indian and Alaska Native ,29173,17207,11966,828,581,726
2020,Arizona,04,American Indian and Alaska Native ,87128,48373,38755,1457,1174,1142
2020,Arkansas,05,American Indian and Alaska Native ,7165,4593,2572,491,468,321
2020,California,06,American Indian and Alaska Native ,97757,48100,49657,2048,1467,1548
2020,Colorado,08,American Indian and Alaska Native ,18928,9277,9651,885,667,787
2020,Connecticut,09,American Indian and Alaska Native ,3244,1252,1992,395,252,326
2020,Delaware,10,American Indian and Alaska Native ,1507,1120,387,175,149,140
2020,District of Columbia,11,American Indian and Alaska Native ,1357,289,1068,303,108,312
2020,Florida,12,American Indian and Alaska Native ,19572,11691,7881,1086,963,704
2020,Georgia,13,American Indian and Alaska Native ,12359,5849,6510,801,559,589
2020,Hawaii,15,American Indian and Alaska Native ,1446,464,982,238,123,214
2020,Idaho,16,American Indian and Alaska Native ,8303,4613,3690,596,486,481
2020,Illinois,17,American Indian and Alaska Native ,11069,6493,4576,785,598,450
2020,Indiana,18,American Indian and Alaska Native ,5695,3344,2351,481,383,345
2020,Iowa,19,American Indian and Alaska Native ,3442,1647,1795,332,291,260
2020,Kansas,20,American Indian and Alaska Native ,8367,4243,4124,505,350,400
2020,Kentucky,21,American Indian and Alaska Native ,3307,1663,1644,356,241,312
2020,Louisiana,22,American Indian and Alaska Native ,9757,6492,3265,684,598,451
2020,Maine,23,American Indian and Alaska Native ,3539,1806,1733,322,269,232
2020,Maryland,24,American Indian and Alaska Native ,6080,3603,2477,447,359,392
2020,Massachusetts,25,American Indian and Alaska Native ,4903,1629,3274,512,292,414
2020,Michigan,26,American Indian and Alaska Native ,18908,12107,6801,771,611,497
2020,Minnesota,27,American Indian and Alaska Native ,17529,8412,9117,567,341,490
2020,Mississippi,28,American Indian and Alaska Native ,4901,3140,1761,419,382,304
2020,Missouri,29,American Indian and Alaska Native ,9342,5292,4050,666,480,476
2020,Montana,30,American Indian and Alaska Native ,18433,8965,9468,693,495,550
2020,Nebraska,31,American Indian and Alaska Native ,5002,2221,2781,368,222,292
2020,Nevada,32,American Indian and Alaska Native ,13855,7352,6503,658,527,525
2020,New Hampshire,33,American Indian and Alaska Native ,1012,620,392,242,185,151
2020,New Jersey,34,American Indian and Alaska Native ,7105,3432,3673,575,372,504
2020,New Mexico,35,American Indian and Alaska Native ,56334,34937,21397,1153,892,875
2020,New York,36,American Indian and Alaska Native ,26115,10350,15765,1295,725,956
2020,North Carolina,37,American Indian and Alaska Native ,42673,27813,14860,963,736,772
2020,North Dakota,38,American Indian and Alaska Native ,11517,5498,6019,460,314,414
2020,Ohio,39,American Indian and Alaska Native ,8569,4085,4484,589,431,427
2020,Oklahoma,40,American Indian and Alaska Native ,99828,62985,36843,1299,1270,953
2020,Oregon,41,American Indian and Alaska Native ,16319,7785,8534,848,656,660
2020,Pennsylvania,42,American Indian and Alaska Native ,7821,4086,3735,548,431,420
2020,Rhode Island,44,American Indian and Alaska Native ,1658,332,1326,282,115,265
2020,South Carolina,45,American Indian and Alaska Native ,6554,4109,2445,500,396,344
2020,South Dakota,46,American Indian and Alaska Native ,18562,7038,11524,589,390,616
2020,Tennessee,47,American Indian and Alaska Native ,7397,3952,3445,532,419,447
2020,Texas,48,American Indian and Alaska Native ,47791,28870,18921,1579,1092,1132
2020,Utah,49,American Indian and Alaska Native ,9200,4929,4271,585,390,490
2020,Vermont,50,American Indian and Alaska Native ,960,522,438,195,131,152
2020,Virginia,51,American Indian and Alaska Native ,8289,4991,3298,566,429,425
2020,Washington,53,American Indian and Alaska Native ,31520,16952,14568,988,764,874
2020,West Virginia,54,American Indian and Alaska Native ,1251,746,505,319,246,185
2020,Wisconsin,55,American Indian and Alaska Native ,18667,8780,9887,549,426,466
2020,Wyoming,56,American Indian and Alaska Native ,3607,1888,1719,384,293,282
2020,Puerto Rico,72,American Indian and Alaska Native ,2329,1520,809,353,317,202
2010,Alabama,01,Asian ,16451,9194,7257,636,504,459
2010,Alaska,02,Asian ,8942,5328,3614,417,378,309
2010,Arizona,04,Asian ,56379,35697,20682,1115,1096,955
2010,Arkansas,05,Asian ,10269,5839,4430,525,340,479
2010,California,06,Asian ,1491808,862166,629642,6019,6952,5146
2010,Colorado,08,Asian ,45990,28984,17006,903,809,776
2010,Connecticut,09,Asian ,41848,23362,18486,681,696,805
2010,Delaware,10,Asian ,8869,5821,3048,353,358,321
2010,District of Columbia,11,Asian ,9486,3665,5821,424,319,445
2010,Florida,12,Asian ,138315,96143,42172,2049,1854,1362
2010,Georgia,13,Asian ,91827,60662,31165,1327,1372,1196
2010,Hawaii,15,Asian ,179974,126991,52983,1790,1682,1465
2010,Idaho,16,Asian ,5968,3462,2506,409,282,352
2010,Illinois,17,Asian ,188384,119231,69153,1702,1773,1548
2010,Indiana,18,Asian ,30692,15953,14739,894,578,828
2010,Iowa,19,Asian ,16207,8850,7357,672,479,559
2010,Kansas,20,Asian ,20964,12297,8667,539,478,554
2010,Kentucky,21,Asian ,14670,7637,7033,636,514,493
2010,Louisiana,22,Asian ,20737,13020,7717,633,625,530
2010,Maine,23,Asian ,4003,1810,2193,296,226,285
2010,Maryland,24,Asian ,96492,65248,31244,1243,1133,1077
2010,Massachusetts,25,Asian ,108681,54159,54522,1206,1144,1238
2010,Michigan,26,Asian ,75223,44399,30824,1014,884,1009
2010,Minnesota,27,Asian ,56294,33317,22977,993,816,884
2010,Mississippi,28,Asian ,7977,4732,3245,479,417,372
2010,Missouri,29,Asian ,30570,16826,13744,760,626,610
2010,Montana,30,Asian ,1887,1003,884,231,197,191
2010,Nebraska,31,Asian ,9140,4531,4609,400,341,399
2010,Nevada,32,Asian ,60450,39173,21277,1178,1091,985
2010,New Hampshire,33,Asian ,8446,4977,3469,409,366,377
2010,New Jersey,34,Asian ,214845,133820,81025,1623,1590,1556
2010,New Mexico,35,Asian ,9764,5877,3887,483,439,423
2010,New York,36,Asian ,438082,202672,235410,2643,2811,2412
2010,North Carolina,37,Asian ,59300,35902,23398,1186,993,1030
2010,North Dakota,38,Asian ,2143,685,1458,236,130,221
2010,Ohio,39,Asian ,62854,34310,28544,1085,908,1082
2010,Oklahoma,40,Asian ,19423,11596,7827,664,488,523
2010,Oregon,41,Asian ,45266,28320,16946,1008,683,888
2010,Pennsylvania,42,Asian ,104865,60313,44552,1387,1166,1393
2010,Rhode Island,44,Asian ,8919,4076,4843,412,312,426
2010,South Carolina,45,Asian ,18402,10894,7508,629,550,592
2010,South Dakota,46,Asian ,1963,1064,899,291,215,201
2010,Tennessee,47,Asian ,27133,15906,11227,679,573,652
2010,Texas,48,Asian ,289666,181423,108243,2460,2248,2267
2010,Utah,49,Asian ,15998,10015,5983,624,496,518
2010,Vermont,50,Asian ,1916,1059,857,201,148,176
2010,Virginia,51,Asian ,131381,89495,41886,1571,1658,1325
2010,Washington,53,Asian ,153991,96552,57439,1693,1592,1477
2010,West Virginia,54,Asian ,3769,1983,1786,255,227,262
2010,Wisconsin,55,Asian ,33793,17067,16726,727,580,770
2010,Wyoming,56,Asian ,977,695,282,172,153,131
2010,Puerto Rico,72,Asian ,4458,2260,2198,491,317,321
2011,Alabama,01,Asian ,16955,9817,7138,520,489,441
2011,Alaska,02,Asian ,8970,5078,3892,576,424,426
2011,Arizona,04,Asian ,57151,35196,21955,1164,1094,1052
2011,Arkansas,05,Asian ,10624,5762,4862,527,441,506
2011,California,06,Asian ,1512577,870264,642313,5524,6394,5075
2011,Colorado,08,Asian ,45140,27978,17162,990,851,791
2011,Connecticut,09,Asian ,41825,23278,18547,857,678,833
2011,Delaware,10,Asian ,9202,5845,3357,374,340,287
2011,District of Columbia,11,Asian ,9189,3500,5689,473,400,514
2011,Florida,12,Asian ,140121,98250,41871,2066,1900,1340
2011,Georgia,13,Asian ,94428,61817,32611,1485,1549,1129
2011,Hawaii,15,Asian ,179356,125763,53593,2151,2023,1637
2011,Idaho,16,Asian ,6062,3465,2597,456,370,349
2011,Illinois,17,Asian ,189785,118712,71073,1904,1724,1498
2011,Indiana,18,Asian ,31368,15964,15404,755,640,775
2011,Iowa,19,Asian ,16608,8896,7712,605,465,548
2011,Kansas,20,Asian ,20895,12004,8891,610,543,658
2011,Kentucky,21,Asian ,14737,8074,6663,507,470,532
2011,Louisiana,22,Asian ,21683,13385,8298,603,532,599
2011,Maine,23,Asian ,3821,1965,1856,287,228,254
2011,Maryland,24,Asian ,98570,65995,32575,1462,1218,1013
2011,Massachusetts,25,Asian ,109796,54225,55571,1240,1046,1287
2011,Michigan,26,Asian ,75159,44645,30514,1136,883,997
2011,Minnesota,27,Asian ,57579,33601,23978,1050,848,938
2011,Mississippi,28,Asian ,8281,5044,3237,458,438,377
2011,Missouri,29,Asian ,30829,16577,14252,876,681,775
2011,Montana,30,Asian ,1672,948,724,225,183,220
2011,Nebraska,31,Asian ,9501,4609,4892,405,321,420
2011,Nevada,32,Asian ,61784,40014,21770,1012,983,1102
2011,New Hampshire,33,Asian ,8373,4963,3410,339,308,353
2011,New Jersey,34,Asian ,220282,137124,83158,1649,1738,1626
2011,New Mexico,35,Asian ,9186,5862,3324,479,342,383
2011,New York,36,Asian ,442961,202753,240208,2966,2924,3068
2011,North Carolina,37,Asian ,61944,38156,23788,1093,1095,1037
2011,North Dakota,38,Asian ,2215,725,1490,189,140,180
2011,Ohio,39,Asian ,63310,34781,28529,1023,847,809
2011,Oklahoma,40,Asian ,19917,11642,8275,588,484,541
2011,Oregon,41,Asian ,45805,28200,17605,980,902,892
2011,Pennsylvania,42,Asian ,107944,61833,46111,1217,1085,1227
2011,Rhode Island,44,Asian ,8949,4285,4664,479,355,403
2011,South Carolina,45,Asian ,19415,11747,7668,612,621,557
2011,South Dakota,46,Asian ,2102,1061,1041,273,199,197
2011,Tennessee,47,Asian ,27647,16712,10935,731,598,686
2011,Texas,48,Asian ,299467,187077,112390,2448,2067,2240
2011,Utah,49,Asian ,16639,10467,6172,485,468,453
2011,Vermont,50,Asian ,2024,1056,968,224,150,199
2011,Virginia,51,Asian ,134718,90808,43910,1812,1562,1167
2011,Washington,53,Asian ,158106,97675,60431,1733,1535,1736
2011,West Virginia,54,Asian ,3791,2042,1749,315,251,240
2011,Wisconsin,55,Asian ,34845,17394,17451,805,582,752
2011,Wyoming,56,Asian ,971,599,372,170,142,124
2011,Puerto Rico,72,Asian ,4226,2043,2183,441,296,325
2012,Alabama,01,Asian ,17239,9744,7495,565,474,567
2012,Alaska,02,Asian ,9372,5177,4195,434,394,339
2012,Arizona,04,Asian ,58503,35042,23461,1134,964,1089
2012,Arkansas,05,Asian ,11352,6281,5071,468,386,468
2012,California,06,Asian ,1536709,878187,658522,6147,6623,4588
2012,Colorado,08,Asian ,45526,28861,16665,947,828,789
2012,Connecticut,09,Asian ,42569,24009,18560,698,677,659
2012,Delaware,10,Asian ,9085,5615,3470,335,263,309
2012,District of Columbia,11,Asian ,9260,3617,5643,531,373,448
2012,Florida,12,Asian ,141996,98993,43003,1806,1303,1427
2012,Georgia,13,Asian ,96196,61385,34811,1457,1532,1131
2012,Hawaii,15,Asian ,177966,124605,53361,1814,1719,1575
2012,Idaho,16,Asian ,6029,3518,2511,349,321,325
2012,Illinois,17,Asian ,193934,118201,75733,1810,1704,1632
2012,Indiana,18,Asian ,32505,16463,16042,902,679,801
2012,Iowa,19,Asian ,16302,8648,7654,523,395,463
2012,Kansas,20,Asian ,21433,12050,9383,695,433,570
2012,Kentucky,21,Asian ,15010,8057,6953,516,407,416
2012,Louisiana,22,Asian ,22604,13755,8849,747,613,636
2012,Maine,23,Asian ,4041,2057,1984,257,227,302
2012,Maryland,24,Asian ,101414,67787,33627,1167,1112,1157
2012,Massachusetts,25,Asian ,112663,55547,57116,1229,1221,1228
2012,Michigan,26,Asian ,76292,44726,31566,952,960,1052
2012,Minnesota,27,Asian ,59187,33930,25257,941,948,965
2012,Mississippi,28,Asian ,8138,4945,3193,453,345,379
2012,Missouri,29,Asian ,31439,17235,14204,816,675,751
2012,Montana,30,Asian ,1795,1042,753,213,189,162
2012,Nebraska,31,Asian ,9735,4666,5069,443,361,408
2012,Nevada,32,Asian ,63248,39548,23700,1260,1098,1069
2012,New Hampshire,33,Asian ,8632,4781,3851,396,360,344
2012,New Jersey,34,Asian ,226519,141270,85249,1639,1618,1377
2012,New Mexico,35,Asian ,8579,5373,3206,407,345,364
2012,New York,36,Asian ,452049,207097,244952,2914,2824,3051
2012,North Carolina,37,Asian ,64586,39570,25016,1300,1151,1000
2012,North Dakota,38,Asian ,2285,728,1557,220,172,222
2012,Ohio,39,Asian ,64794,35450,29344,961,872,872
2012,Oklahoma,40,Asian ,20188,11703,8485,565,450,510
2012,Oregon,41,Asian ,46621,28152,18469,1074,874,892
2012,Pennsylvania,42,Asian ,109863,62813,47050,1396,1307,1401
2012,Rhode Island,44,Asian ,9256,4480,4776,439,401,411
2012,South Carolina,45,Asian ,19296,11806,7490,703,649,610
2012,South Dakota,46,Asian ,2331,996,1335,252,186,209
2012,Tennessee,47,Asian ,28483,17207,11276,702,678,765
2012,Texas,48,Asian ,310720,191360,119360,2538,2331,2244
2012,Utah,49,Asian ,16955,10526,6429,520,483,486
2012,Vermont,50,Asian ,2149,1120,1029,211,147,170
2012,Virginia,51,Asian ,136740,90918,45822,1509,1279,1326
2012,Washington,53,Asian ,162349,99513,62836,1544,1563,1574
2012,West Virginia,54,Asian ,4282,2373,1909,285,274,227
2012,Wisconsin,55,Asian ,36120,17800,18320,829,597,843
2012,Wyoming,56,Asian ,1077,603,474,186,155,134
2012,Puerto Rico,72,Asian ,4275,1943,2332,416,293,291
2013,Alabama,01,Asian ,18112,10052,8060,595,652,555
2013,Alaska,02,Asian ,9113,4906,4207,412,350,336
2013,Arizona,04,Asian ,60450,35978,24472,1069,1081,999
2013,Arkansas,05,Asian ,11638,6200,5438,499,360,409
2013,California,06,Asian ,1564916,897861,667055,6188,6849,4881
2013,Colorado,08,Asian ,45603,29101,16502,1094,889,794
2013,Connecticut,09,Asian ,43434,24628,18806,831,736,860
2013,Delaware,10,Asian ,9574,5954,3620,341,318,251
2013,District of Columbia,11,Asian ,9385,3603,5782,435,333,451
2013,Florida,12,Asian ,143629,100718,42911,2124,1794,1410
2013,Georgia,13,Asian ,98819,62422,36397,1470,1390,1320
2013,Hawaii,15,Asian ,177405,123215,54190,1532,1587,1311
2013,Idaho,16,Asian ,6294,3851,2443,411,332,316
2013,Illinois,17,Asian ,195480,118858,76622,1894,1771,1423
2013,Indiana,18,Asian ,34741,16977,17764,845,720,677
2013,Iowa,19,Asian ,17113,9269,7844,474,522,541
2013,Kansas,20,Asian ,21491,11893,9598,561,485,555
2013,Kentucky,21,Asian ,15879,8484,7395,479,477,532
2013,Louisiana,22,Asian ,22698,13338,9360,809,598,666
2013,Maine,23,Asian ,4069,2035,2034,317,308,299
2013,Maryland,24,Asian ,104386,69825,34561,1172,991,1077
2013,Massachusetts,25,Asian ,115876,57610,58266,1349,1188,1170
2013,Michigan,26,Asian ,77091,45946,31145,1093,925,886
2013,Minnesota,27,Asian ,61572,34361,27211,965,948,861
2013,Mississippi,28,Asian ,8373,5031,3342,422,443,385
2013,Missouri,29,Asian ,31775,17279,14496,815,671,664
2013,Montana,30,Asian ,2011,1135,876,288,208,216
2013,Nebraska,31,Asian ,10365,4929,5436,421,346,428
2013,Nevada,32,Asian ,64627,40014,24613,1139,1065,1117
2013,New Hampshire,33,Asian ,8954,4744,4210,426,328,393
2013,New Jersey,34,Asian ,232745,144400,88345,1629,1732,1691
2013,New Mexico,35,Asian ,9029,5708,3321,484,422,331
2013,New York,36,Asian ,461126,212003,249123,2551,2834,2755
2013,North Carolina,37,Asian ,67902,41063,26839,1175,1034,914
2013,North Dakota,38,Asian ,2368,791,1577,225,155,237
2013,Ohio,39,Asian ,66066,36043,30023,1068,856,968
2013,Oklahoma,40,Asian ,20449,11790,8659,534,505,504
2013,Oregon,41,Asian ,47427,28295,19132,1090,930,889
2013,Pennsylvania,42,Asian ,112799,64740,48059,1691,1233,1420
2013,Rhode Island,44,Asian ,9356,4431,4925,473,419,461
2013,South Carolina,45,Asian ,19675,12197,7478,613,549,561
2013,South Dakota,46,Asian ,2430,989,1441,215,215,188
2013,Tennessee,47,Asian ,29416,17536,11880,719,626,610
2013,Texas,48,Asian ,321032,196374,124658,2554,2358,2429
2013,Utah,49,Asian ,17391,10817,6574,556,421,541
2013,Vermont,50,Asian ,2193,1095,1098,181,131,193
2013,Virginia,51,Asian ,139267,91584,47683,1579,1544,1319
2013,Washington,53,Asian ,165698,100092,65606,1864,1742,1586
2013,West Virginia,54,Asian ,4262,2215,2047,334,271,276
2013,Wisconsin,55,Asian ,37152,18221,18931,732,622,884
2013,Wyoming,56,Asian ,1256,578,678,212,145,172
2013,Puerto Rico,72,Asian ,4269,1980,2289,467,293,357
2014,Alabama,01,Asian ,18693,10175,8518,599,563,598
2014,Alaska,02,Asian ,9902,5431,4471,478,412,373
2014,Arizona,04,Asian ,62269,36888,25381,1220,1032,1023
2014,Arkansas,05,Asian ,12178,6444,5734,465,454,483
2014,California,06,Asian ,1600409,917795,682614,4837,6257,5431
2014,Colorado,08,Asian ,46965,29152,17813,930,768,813
2014,Connecticut,09,Asian ,45399,25495,19904,919,716,803
2014,Delaware,10,Asian ,9989,6014,3975,371,322,300
2014,District of Columbia,11,Asian ,9871,3775,6096,558,328,522
2014,Florida,12,Asian ,148449,102729,45720,1873,1828,1448
2014,Georgia,13,Asian ,101888,64261,37627,1395,1499,1228
2014,Hawaii,15,Asian ,176969,122517,54452,1569,1484,1244
2014,Idaho,16,Asian ,6434,4148,2286,442,332,330
2014,Illinois,17,Asian ,201254,121345,79909,1945,1717,1923
2014,Indiana,18,Asian ,36671,18214,18457,962,715,860
2014,Iowa,19,Asian ,18478,9098,9380,633,393,594
2014,Kansas,20,Asian ,22422,12225,10197,600,496,608
2014,Kentucky,21,Asian ,16533,8541,7992,574,470,608
2014,Louisiana,22,Asian ,22890,13746,9144,580,573,516
2014,Maine,23,Asian ,3978,2250,1728,321,307,215
2014,Maryland,24,Asian ,108072,72110,35962,1381,1228,1097
2014,Massachusetts,25,Asian ,120916,60366,60550,1316,1318,1406
2014,Michigan,26,Asian ,79402,47095,32307,1057,1068,1137
2014,Minnesota,27,Asian ,64423,35501,28922,994,853,967
2014,Mississippi,28,Asian ,8357,4867,3490,495,390,435
2014,Missouri,29,Asian ,32481,17196,15285,908,636,848
2014,Montana,30,Asian ,2255,1177,1078,261,178,207
2014,Nebraska,31,Asian ,11072,5358,5714,488,385,424
2014,Nevada,32,Asian ,65953,39761,26192,1357,1158,1097
2014,New Hampshire,33,Asian ,9384,5069,4315,351,356,359
2014,New Jersey,34,Asian ,240209,148678,91531,1568,1897,1690
2014,New Mexico,35,Asian ,9135,5529,3606,497,382,382
2014,New York,36,Asian ,473302,217321,255981,2946,2499,3115
2014,North Carolina,37,Asian ,71296,43148,28148,1153,1049,845
2014,North Dakota,38,Asian ,2630,789,1841,233,159,242
2014,Ohio,39,Asian ,69225,37613,31612,1058,1000,996
2014,Oklahoma,40,Asian ,21208,12059,9149,622,458,544
2014,Oregon,41,Asian ,48967,28940,20027,933,811,891
2014,Pennsylvania,42,Asian ,116368,67255,49113,1411,1001,1083
2014,Rhode Island,44,Asian ,9551,4690,4861,444,379,380
2014,South Carolina,45,Asian ,20378,12633,7745,578,551,553
2014,South Dakota,46,Asian ,2522,953,1569,216,185,197
2014,Tennessee,47,Asian ,30533,18390,12143,774,643,642
2014,Texas,48,Asian ,335810,205341,130469,2680,2396,2394
2014,Utah,49,Asian ,17975,11188,6787,557,512,549
2014,Vermont,50,Asian ,2293,1158,1135,198,147,173
2014,Virginia,51,Asian ,142424,92651,49773,1656,1573,1411
2014,Washington,53,Asian ,170233,102140,68093,2072,1808,1707
2014,West Virginia,54,Asian ,4335,2016,2319,346,274,316
2014,Wisconsin,55,Asian ,38886,17961,20925,789,701,826
2014,Wyoming,56,Asian ,1560,787,773,225,168,192
2014,Puerto Rico,72,Asian ,3959,1812,2147,475,301,385
2015,Alabama,01,Asian ,19111,10291,8820,648,543,615
2015,Alaska,02,Asian ,10292,5687,4605,409,370,402
2015,Arizona,04,Asian ,64799,37800,26999,982,967,1021
2015,Arkansas,05,Asian ,12839,6695,6144,547,444,524
2015,California,06,Asian ,1645396,946331,699065,5684,6963,4367
2015,Colorado,08,Asian ,48663,29712,18951,1024,886,911
2015,Connecticut,09,Asian ,46862,26555,20307,910,762,729
2015,Delaware,10,Asian ,10588,6243,4345,397,359,315
2015,District of Columbia,11,Asian ,10259,3904,6355,496,355,465
2015,Florida,12,Asian ,154822,106331,48491,2162,2052,1604
2015,Georgia,13,Asian ,106772,67464,39308,1570,1567,1372
2015,Hawaii,15,Asian ,176375,121618,54757,1712,1726,1246
2015,Idaho,16,Asian ,6502,4193,2309,441,382,350
2015,Illinois,17,Asian ,208201,124489,83712,2102,2026,1625
2015,Indiana,18,Asian ,37913,19003,18910,999,854,983
2015,Iowa,19,Asian ,19440,9303,10137,628,537,540
2015,Kansas,20,Asian ,23024,12486,10538,603,523,542
2015,Kentucky,21,Asian ,17249,8910,8339,523,506,552
2015,Louisiana,22,Asian ,23542,14160,9382,664,610,578
2015,Maine,23,Asian ,3905,2254,1651,337,277,257
2015,Maryland,24,Asian ,111108,75284,35824,1151,1125,1020
2015,Massachusetts,25,Asian ,126184,64092,62092,1440,978,1432
2015,Michigan,26,Asian ,83529,49041,34488,913,942,939
2015,Minnesota,27,Asian ,66658,36585,30073,1052,944,882
2015,Mississippi,28,Asian ,8364,4991,3373,474,435,370
2015,Missouri,29,Asian ,34263,17773,16490,816,678,728
2015,Montana,30,Asian ,2306,1111,1195,277,189,241
2015,Nebraska,31,Asian ,11890,5713,6177,407,357,454
2015,Nevada,32,Asian ,68349,40906,27443,1066,1124,1180
2015,New Hampshire,33,Asian ,10137,5355,4782,421,347,453
2015,New Jersey,34,Asian ,246904,152245,94659,1915,1865,1886
2015,New Mexico,35,Asian ,9090,5660,3430,429,336,333
2015,New York,36,Asian ,487325,223491,263834,3078,2659,2751
2015,North Carolina,37,Asian ,75275,45480,29795,1350,1094,1094
2015,North Dakota,38,Asian ,3004,886,2118,274,168,257
2015,Ohio,39,Asian ,72486,38809,33677,1212,827,993
2015,Oklahoma,40,Asian ,21816,12312,9504,655,470,487
2015,Oregon,41,Asian ,50489,29627,20862,1015,827,938
2015,Pennsylvania,42,Asian ,120762,69733,51029,1384,1451,1202
2015,Rhode Island,44,Asian ,10099,5042,5057,512,376,419
2015,South Carolina,45,Asian ,20786,13258,7528,716,560,548
2015,South Dakota,46,Asian ,2738,1032,1706,278,204,244
2015,Tennessee,47,Asian ,31545,19189,12356,747,850,736
2015,Texas,48,Asian ,353904,215076,138828,2489,2632,2035
2015,Utah,49,Asian ,18658,11303,7355,679,506,509
2015,Vermont,50,Asian ,2453,1170,1283,214,175,217
2015,Virginia,51,Asian ,147789,96029,51760,1487,1649,1334
2015,Washington,53,Asian ,177106,106154,70952,2062,1568,1698
2015,West Virginia,54,Asian ,4494,2371,2123,287,241,275
2015,Wisconsin,55,Asian ,40049,18803,21246,767,623,821
2015,Wyoming,56,Asian ,1597,846,751,282,196,187
2015,Puerto Rico,72,Asian ,3637,1710,1927,425,311,330
2016,Alabama,01,Asian ,19274,10294,8980,680,584,560
2016,Alaska,02,Asian ,10563,5836,4727,481,416,373
2016,Arizona,04,Asian ,66957,39124,27833,1092,1037,940
2016,Arkansas,05,Asian ,12783,6652,6131,517,433,515
2016,California,06,Asian ,1681626,971290,710336,6182,7244,5495
2016,Colorado,08,Asian ,50274,30664,19610,941,818,856
2016,Connecticut,09,Asian ,48371,27306,21065,880,783,835
2016,Delaware,10,Asian ,11188,6612,4576,334,321,286
2016,District of Columbia,11,Asian ,10428,4110,6318,480,336,440
2016,Florida,12,Asian ,159421,107626,51795,1936,1989,1573
2016,Georgia,13,Asian ,111656,70550,41106,1355,1540,1261
2016,Hawaii,15,Asian ,178791,123488,55303,1596,1504,1442
2016,Idaho,16,Asian ,6684,4260,2424,494,404,351
2016,Illinois,17,Asian ,213504,126982,86522,1917,1912,1546
2016,Indiana,18,Asian ,40221,19948,20273,1084,833,870
2016,Iowa,19,Asian ,20607,10076,10531,709,497,606
2016,Kansas,20,Asian ,24108,12916,11192,584,516,582
2016,Kentucky,21,Asian ,17649,8823,8826,567,487,524
2016,Louisiana,22,Asian ,23886,14601,9285,769,568,633
2016,Maine,23,Asian ,4305,2417,1888,329,232,333
2016,Maryland,24,Asian ,113654,77249,36405,1234,1178,1008
2016,Massachusetts,25,Asian ,129805,67426,62379,1373,1134,1484
2016,Michigan,26,Asian ,87014,50160,36854,1089,957,1143
2016,Minnesota,27,Asian ,67594,37656,29938,992,949,850
2016,Mississippi,28,Asian ,8670,4917,3753,515,438,449
2016,Missouri,29,Asian ,34520,17940,16580,866,653,782
2016,Montana,30,Asian ,2389,1141,1248,271,194,198
2016,Nebraska,31,Asian ,12187,5696,6491,411,349,380
2016,Nevada,32,Asian ,70941,42368,28573,1165,1119,1032
2016,New Hampshire,33,Asian ,10264,5166,5098,482,416,449
2016,New Jersey,34,Asian ,252222,155545,96677,1833,1934,1688
2016,New Mexico,35,Asian ,9236,5648,3588,514,435,349
2016,New York,36,Asian ,497188,229666,267522,3031,2618,2553
2016,North Carolina,37,Asian ,78098,46708,31390,1096,974,1026
2016,North Dakota,38,Asian ,3151,996,2155,342,219,298
2016,Ohio,39,Asian ,74391,38835,35556,1013,1042,891
2016,Oklahoma,40,Asian ,22781,12972,9809,583,480,554
2016,Oregon,41,Asian ,51888,30093,21795,1006,803,795
2016,Pennsylvania,42,Asian ,122905,70625,52280,1556,1268,1206
2016,Rhode Island,44,Asian ,10185,5027,5158,504,380,451
2016,South Carolina,45,Asian ,21233,13462,7771,670,560,570
2016,South Dakota,46,Asian ,2970,1024,1946,280,167,256
2016,Tennessee,47,Asian ,32557,19236,13321,822,730,555
2016,Texas,48,Asian ,370969,226146,144823,2577,2354,2139
2016,Utah,49,Asian ,19080,11369,7711,670,586,500
2016,Vermont,50,Asian ,2597,1342,1255,161,183,186
2016,Virginia,51,Asian ,151261,98852,52409,1747,1713,1364
2016,Washington,53,Asian ,184020,110817,73203,1805,1795,1587
2016,West Virginia,54,Asian ,4952,2555,2397,371,331,316
2016,Wisconsin,55,Asian ,41403,19498,21905,783,714,862
2016,Wyoming,56,Asian ,1576,926,650,262,203,163
2016,Puerto Rico,72,Asian ,3435,1675,1760,416,276,310
2017,Alabama,01,Asian ,20372,10966,9406,615,547,601
2017,Alaska,02,Asian ,11143,6248,4895,428,409,371
2017,Arizona,04,Asian ,70175,42332,27843,947,1108,1056
2017,Arkansas,05,Asian ,12970,6556,6414,506,452,560
2017,California,06,Asian ,1731758,1012492,719266,6467,7634,5071
2017,Colorado,08,Asian ,52285,31751,20534,1058,898,814
2017,Connecticut,09,Asian ,50550,28962,21588,999,828,876
2017,Delaware,10,Asian ,12178,7372,4806,384,374,341
2017,District of Columbia,11,Asian ,10817,4078,6739,429,375,411
2017,Florida,12,Asian ,166423,113370,53053,2134,1839,1582
2017,Georgia,13,Asian ,117460,75661,41799,1466,1554,1328
2017,Hawaii,15,Asian ,179920,125459,54461,1824,1754,1439
2017,Idaho,16,Asian ,7201,4753,2448,523,419,336
2017,Illinois,17,Asian ,219802,132855,86947,1769,1735,1654
2017,Indiana,18,Asian ,42079,21355,20724,1013,825,870
2017,Iowa,19,Asian ,22359,11126,11233,655,527,561
2017,Kansas,20,Asian ,25113,13628,11485,613,552,624
2017,Kentucky,21,Asian ,18371,9263,9108,699,612,576
2017,Louisiana,22,Asian ,23916,15196,8720,672,615,595
2017,Maine,23,Asian ,4227,2409,1818,270,268,252
2017,Maryland,24,Asian ,117551,81285,36266,1179,1150,1061
2017,Massachusetts,25,Asian ,136062,72444,63618,1545,1236,1505
2017,Michigan,26,Asian ,92282,53123,39159,1213,962,1031
2017,Minnesota,27,Asian ,70827,40353,30474,1059,780,954
2017,Mississippi,28,Asian ,9061,5003,4058,644,521,463
2017,Missouri,29,Asian ,36738,19109,17629,936,690,810
2017,Montana,30,Asian ,2404,1129,1275,280,192,215
2017,Nebraska,31,Asian ,13201,6310,6891,467,333,455
2017,Nevada,32,Asian ,74643,45730,28913,1109,965,950
2017,New Hampshire,33,Asian ,10605,5643,4962,391,361,446
2017,New Jersey,34,Asian ,261018,161941,99077,1881,1898,2053
2017,New Mexico,35,Asian ,9473,5734,3739,451,386,393
2017,New York,36,Asian ,511599,241305,270294,3116,2768,2774
2017,North Carolina,37,Asian ,82635,49688,32947,1220,1046,1083
2017,North Dakota,38,Asian ,3424,1166,2258,313,224,319
2017,Ohio,39,Asian ,77822,40140,37682,1088,1060,1027
2017,Oklahoma,40,Asian ,23863,13872,9991,654,569,599
2017,Oregon,41,Asian ,55062,32703,22359,1074,1004,968
2017,Pennsylvania,42,Asian ,129583,75312,54271,1479,1357,1464
2017,Rhode Island,44,Asian ,10823,5280,5543,407,424,352
2017,South Carolina,45,Asian ,22271,14218,8053,784,579,551
2017,South Dakota,46,Asian ,3449,1315,2134,279,202,305
2017,Tennessee,47,Asian ,33683,19927,13756,918,667,892
2017,Texas,48,Asian ,391880,243364,148516,2832,2470,2613
2017,Utah,49,Asian ,20080,12228,7852,622,554,566
2017,Vermont,50,Asian ,2749,1476,1273,206,204,230
2017,Virginia,51,Asian ,157778,104280,53498,1480,1642,1507
2017,Washington,53,Asian ,195708,119267,76441,1937,1802,1844
2017,West Virginia,54,Asian ,4923,2363,2560,375,253,351
2017,Wisconsin,55,Asian ,43563,20339,23224,794,701,843
2017,Wyoming,56,Asian ,1440,815,625,248,158,199
2017,Puerto Rico,72,Asian ,2912,1469,1443,362,244,251
2018,Alabama,01,Asian ,21170,12062,9108,728,564,630
2018,Alaska,02,Asian ,11651,6417,5234,507,504,430
2018,Arizona,04,Asian ,75354,45338,30016,1302,1108,1074
2018,Arkansas,05,Asian ,13755,7385,6370,659,415,586
2018,California,06,Asian ,1770644,1041602,729042,6244,7954,6014
2018,Colorado,08,Asian ,55153,33280,21873,1132,790,1094
2018,Connecticut,09,Asian ,52011,29687,22324,834,834,889
2018,Delaware,10,Asian ,12177,7268,4909,343,283,307
2018,District of Columbia,11,Asian ,11242,4541,6701,488,402,396
2018,Florida,12,Asian ,171201,116420,54781,2261,2002,1552
2018,Georgia,13,Asian ,122769,79713,43056,1831,1691,1537
2018,Hawaii,15,Asian ,178407,124942,53465,1810,1675,1393
2018,Idaho,16,Asian ,7364,4838,2526,557,467,352
2018,Illinois,17,Asian ,227650,137142,90508,2037,1955,2055
2018,Indiana,18,Asian ,44576,23096,21480,1049,850,1001
2018,Iowa,19,Asian ,23599,12030,11569,739,610,640
2018,Kansas,20,Asian ,26174,14404,11770,647,527,587
2018,Kentucky,21,Asian ,19358,9466,9892,602,586,638
2018,Louisiana,22,Asian ,23875,15553,8322,747,659,589
2018,Maine,23,Asian ,4292,2445,1847,329,281,279
2018,Maryland,24,Asian ,119294,82593,36701,1410,1393,1188
2018,Massachusetts,25,Asian ,141787,75993,65794,1396,1344,1361
2018,Michigan,26,Asian ,97966,56157,41809,1279,1001,1148
2018,Minnesota,27,Asian ,72394,41628,30766,1103,891,872
2018,Mississippi,28,Asian ,8873,5045,3828,523,387,488
2018,Missouri,29,Asian ,38779,20493,18286,994,794,839
2018,Montana,30,Asian ,2632,1310,1322,250,265,229
2018,Nebraska,31,Asian ,13410,6304,7106,567,414,461
2018,Nevada,32,Asian ,77263,47834,29429,1115,1072,954
2018,New Hampshire,33,Asian ,11412,6181,5231,489,441,402
2018,New Jersey,34,Asian ,261642,163124,98518,1916,1979,1760
2018,New Mexico,35,Asian ,10103,5903,4200,505,366,477
2018,New York,36,Asian ,516439,246680,269759,2627,2851,2402
2018,North Carolina,37,Asian ,87507,53168,34339,1262,1132,1080
2018,North Dakota,38,Asian ,3635,1104,2531,278,217,253
2018,Ohio,39,Asian ,83058,42147,40911,1147,1127,1126
2018,Oklahoma,40,Asian ,24949,14393,10556,652,569,661
2018,Oregon,41,Asian ,57830,34285,23545,875,1019,893
2018,Pennsylvania,42,Asian ,133629,77483,56146,1701,1493,1399
2018,Rhode Island,44,Asian ,10794,5312,5482,467,380,472
2018,South Carolina,45,Asian ,23240,14920,8320,836,740,639
2018,South Dakota,46,Asian ,3801,1378,2423,242,188,283
2018,Tennessee,47,Asian ,34625,20160,14465,853,779,851
2018,Texas,48,Asian ,411745,256464,155281,3273,3002,2665
2018,Utah,49,Asian ,20928,12618,8310,548,509,565
2018,Vermont,50,Asian ,2950,1529,1421,242,234,240
2018,Virginia,51,Asian ,162608,108224,54384,1746,1561,1591
2018,Washington,53,Asian ,208088,127419,80669,2154,2041,2043
2018,West Virginia,54,Asian ,5139,2624,2515,337,287,301
2018,Wisconsin,55,Asian ,46300,21047,25253,826,743,824
2018,Wyoming,56,Asian ,1425,914,511,229,180,150
2018,Puerto Rico,72,Asian ,2441,1443,998,333,283,234
2019,Alabama,01,Asian ,21325,12363,8962,758,687,648
2019,Alaska,02,Asian ,11608,6564,5044,513,473,470
2019,Arizona,04,Asian ,77081,46754,30327,1353,1176,1174
2019,Arkansas,05,Asian ,14065,7664,6401,555,439,612
2019,California,06,Asian ,1811767,1074491,737276,7238,7951,5260
2019,Colorado,08,Asian ,57754,35398,22356,1140,943,933
2019,Connecticut,09,Asian ,52729,30386,22343,1058,851,928
2019,Delaware,10,Asian ,12482,7558,4924,405,415,396
2019,District of Columbia,11,Asian ,11628,4661,6967,580,430,593
2019,Florida,12,Asian ,176202,121548,54654,2126,1950,1852
2019,Georgia,13,Asian ,128000,83530,44470,1649,1384,1502
2019,Hawaii,15,Asian ,179474,126032,53442,1536,1839,1473
2019,Idaho,16,Asian ,7468,4671,2797,518,485,328
2019,Illinois,17,Asian ,231623,140390,91233,2150,2226,1750
2019,Indiana,18,Asian ,46681,24467,22214,1030,742,993
2019,Iowa,19,Asian ,24211,12581,11630,674,647,593
2019,Kansas,20,Asian ,26705,14752,11953,723,531,643
2019,Kentucky,21,Asian ,20327,10177,10150,650,501,596
2019,Louisiana,22,Asian ,24448,16086,8362,703,682,570
2019,Maine,23,Asian ,4284,2374,1910,308,237,274
2019,Maryland,24,Asian ,121789,85243,36546,1128,1187,1077
2019,Massachusetts,25,Asian ,145828,79392,66436,1559,1461,1449
2019,Michigan,26,Asian ,101311,58582,42729,1140,1058,1121
2019,Minnesota,27,Asian ,73848,42689,31159,979,995,858
2019,Mississippi,28,Asian ,8945,5228,3717,589,413,479
2019,Missouri,29,Asian ,41281,22017,19264,906,743,747
2019,Montana,30,Asian ,2922,1653,1269,312,262,304
2019,Nebraska,31,Asian ,13934,6419,7515,483,328,481
2019,Nevada,32,Asian ,79792,50564,29228,1242,1096,1098
2019,New Hampshire,33,Asian ,11344,6385,4959,569,418,501
2019,New Jersey,34,Asian ,268946,168763,100183,1928,2040,2005
2019,New Mexico,35,Asian ,10292,5633,4659,556,438,452
2019,New York,36,Asian ,526705,255492,271213,3358,3232,2686
2019,North Carolina,37,Asian ,90650,56464,34186,1329,1430,1142
2019,North Dakota,38,Asian ,4008,1281,2727,376,229,366
2019,Ohio,39,Asian ,85813,44651,41162,1411,1004,1288
2019,Oklahoma,40,Asian ,25839,14865,10974,702,543,528
2019,Oregon,41,Asian ,60011,36409,23602,1149,964,904
2019,Pennsylvania,42,Asian ,138698,81010,57688,1460,1448,1226
2019,Rhode Island,44,Asian ,10940,5284,5656,545,379,541
2019,South Carolina,45,Asian ,24443,15885,8558,828,702,664
2019,South Dakota,46,Asian ,3834,1324,2510,321,189,343
2019,Tennessee,47,Asian ,35975,21258,14717,904,815,877
2019,Texas,48,Asian ,428601,269489,159112,3313,3192,3043
2019,Utah,49,Asian ,22262,13331,8931,741,712,572
2019,Vermont,50,Asian ,3010,1603,1407,310,208,247
2019,Virginia,51,Asian ,168700,113367,55333,1851,1565,1513
2019,Washington,53,Asian ,218988,135686,83302,2066,1860,1842
2019,West Virginia,54,Asian ,4944,2761,2183,350,269,288
2019,Wisconsin,55,Asian ,47532,22225,25307,886,712,994
2019,Wyoming,56,Asian ,1456,905,551,230,208,135
2019,Puerto Rico,72,Asian ,2261,1424,837,305,279,199
2020,Alabama,01,Asian ,23204,13512,9692,854,736,650
2020,Alaska,02,Asian ,13132,7613,5519,801,795,589
2020,Arizona,04,Asian ,80691,48216,32475,1537,1247,1406
2020,Arkansas,05,Asian ,15211,8189,7022,690,629,632
2020,California,06,Asian ,1860890,1111582,749308,6843,7391,6053
2020,Colorado,08,Asian ,56608,35782,20826,1276,1273,1062
2020,Connecticut,09,Asian ,53895,31761,22134,985,899,942
2020,Delaware,10,Asian ,14014,8746,5268,518,511,520
2020,District of Columbia,11,Asian ,12249,5106,7143,570,513,542
2020,Florida,12,Asian ,185103,126736,58367,2463,2336,1929
2020,Georgia,13,Asian ,137651,90763,46888,1924,1905,1700
2020,Hawaii,15,Asian ,183995,132543,51452,1884,2058,1687
2020,Idaho,16,Asian ,8157,4932,3225,515,424,453
2020,Illinois,17,Asian ,242604,147894,94710,2481,2543,2251
2020,Indiana,18,Asian ,49688,26394,23294,1063,1041,1069
2020,Iowa,19,Asian ,25825,13092,12733,810,692,936
2020,Kansas,20,Asian ,28490,15736,12754,845,587,781
2020,Kentucky,21,Asian ,21911,10905,11006,774,672,719
2020,Louisiana,22,Asian ,25327,16521,8806,887,815,724
2020,Maine,23,Asian ,4520,2369,2151,370,320,350
2020,Maryland,24,Asian ,124437,86026,38411,1679,1574,1308
2020,Massachusetts,25,Asian ,152655,83153,69502,1751,1958,1807
2020,Michigan,26,Asian ,104236,61211,43025,1540,1281,1384
2020,Minnesota,27,Asian ,77939,46530,31409,1267,1309,1173
2020,Mississippi,28,Asian ,9172,5466,3706,631,503,491
2020,Missouri,29,Asian ,42878,23675,19203,965,935,884
2020,Montana,30,Asian ,2850,1595,1255,327,288,258
2020,Nebraska,31,Asian ,15321,7458,7863,668,411,681
2020,Nevada,32,Asian ,84403,54336,30067,1503,1267,1301
2020,New Hampshire,33,Asian ,11975,6356,5619,650,522,672
2020,New Jersey,34,Asian ,280258,177000,103258,1860,2434,1891
2020,New Mexico,35,Asian ,11144,5844,5300,676,568,554
2020,New York,36,Asian ,539547,265583,273964,3193,3614,3320
2020,North Carolina,37,Asian ,98642,60612,38030,1643,1505,1178
2020,North Dakota,38,Asian ,4798,1301,3497,416,265,411
2020,Ohio,39,Asian ,88904,47256,41648,1654,1516,1534
2020,Oklahoma,40,Asian ,26665,16135,10530,882,612,734
2020,Oregon,41,Asian ,64195,39996,24199,1443,1292,1119
2020,Pennsylvania,42,Asian ,144936,84565,60371,1781,1511,1751
2020,Rhode Island,44,Asian ,11425,5379,6046,598,431,570
2020,South Carolina,45,Asian ,26142,17546,8596,948,893,700
2020,South Dakota,46,Asian ,3836,1493,2343,387,346,335
2020,Tennessee,47,Asian ,38731,21773,16958,1042,862,1035
2020,Texas,48,Asian ,449192,286043,163149,3801,3697,2981
2020,Utah,49,Asian ,22430,13747,8683,764,606,665
2020,Vermont,50,Asian ,2785,1314,1471,301,198,248
2020,Virginia,51,Asian ,178857,121469,57388,1902,1740,1288
2020,Washington,53,Asian ,233476,144068,89408,2687,2360,2245
2020,West Virginia,54,Asian ,5189,2601,2588,420,353,324
2020,Wisconsin,55,Asian ,49627,23768,25859,1018,917,1025
2020,Wyoming,56,Asian ,1711,1119,592,271,264,161
2020,Puerto Rico,72,Asian ,2139,1432,707,346,300,193
2010,Alabama,01,Native Hawaiian and Other Pacific Islander ,576,220,356,144,89,142
2010,Alaska,02,Native Hawaiian and Other Pacific Islander ,1291,375,916,199,118,181
2010,Arizona,04,Native Hawaiian and Other Pacific Islander ,3222,1361,1861,334,243,357
2010,Arkansas,05,Native Hawaiian and Other Pacific Islander ,789,198,591,149,86,140
2010,California,06,Native Hawaiian and Other Pacific Islander ,38176,18277,19899,975,799,845
2010,Colorado,08,Native Hawaiian and Other Pacific Islander ,1939,1075,864,300,230,190
2010,Connecticut,09,Native Hawaiian and Other Pacific Islander ,346,230,116,131,109,77
2010,Delaware,10,Native Hawaiian and Other Pacific Islander ,187,69,118,90,43,93
2010,District of Columbia,11,Native Hawaiian and Other Pacific Islander ,158,51,107,80,42,90
2010,Florida,12,Native Hawaiian and Other Pacific Islander ,3454,1789,1665,438,304,313
2010,Georgia,13,Native Hawaiian and Other Pacific Islander ,1573,613,960,238,163,231
2010,Hawaii,15,Native Hawaiian and Other Pacific Islander ,32929,14988,17941,1015,782,826
2010,Idaho,16,Native Hawaiian and Other Pacific Islander ,647,275,372,195,109,155
2010,Illinois,17,Native Hawaiian and Other Pacific Islander ,1288,629,659,265,147,207
2010,Indiana,18,Native Hawaiian and Other Pacific Islander ,519,313,206,185,147,94
2010,Iowa,19,Native Hawaiian and Other Pacific Islander ,262,90,172,129,59,117
2010,Kansas,20,Native Hawaiian and Other Pacific Islander ,570,213,357,111,104,107
2010,Kentucky,21,Native Hawaiian and Other Pacific Islander ,758,219,539,187,123,163
2010,Louisiana,22,Native Hawaiian and Other Pacific Islander ,504,175,329,188,67,187
2010,Maine,23,Native Hawaiian and Other Pacific Islander ,157,80,77,65,46,62
2010,Maryland,24,Native Hawaiian and Other Pacific Islander ,903,324,579,241,122,222
2010,Massachusetts,25,Native Hawaiian and Other Pacific Islander ,527,283,244,175,122,113
2010,Michigan,26,Native Hawaiian and Other Pacific Islander ,942,552,390,190,145,143
2010,Minnesota,27,Native Hawaiian and Other Pacific Islander ,807,329,478,137,96,139
2010,Mississippi,28,Native Hawaiian and Other Pacific Islander ,174,71,103,91,68,76
2010,Missouri,29,Native Hawaiian and Other Pacific Islander ,1307,501,806,170,132,144
2010,Montana,30,Native Hawaiian and Other Pacific Islander ,146,62,84,42,42,26
2010,Nebraska,31,Native Hawaiian and Other Pacific Islander ,328,107,221,84,50,68
2010,Nevada,32,Native Hawaiian and Other Pacific Islander ,4856,2111,2745,368,314,392
2010,New Hampshire,33,Native Hawaiian and Other Pacific Islander ,84,37,47,38,23,35
2010,New Jersey,34,Native Hawaiian and Other Pacific Islander ,838,445,393,227,163,158
2010,New Mexico,35,Native Hawaiian and Other Pacific Islander ,396,164,232,121,82,97
2010,New York,36,Native Hawaiian and Other Pacific Islander ,1649,473,1176,293,119,303
2010,North Carolina,37,Native Hawaiian and Other Pacific Islander ,1420,645,775,287,170,260
2010,North Dakota,38,Native Hawaiian and Other Pacific Islander ,229,9,220,167,11,170
2010,Ohio,39,Native Hawaiian and Other Pacific Islander ,713,294,419,188,121,141
2010,Oklahoma,40,Native Hawaiian and Other Pacific Islander ,1020,383,637,230,111,243
2010,Oregon,41,Native Hawaiian and Other Pacific Islander ,3468,1070,2398,369,212,327
2010,Pennsylvania,42,Native Hawaiian and Other Pacific Islander ,985,495,490,208,182,149
2010,Rhode Island,44,Native Hawaiian and Other Pacific Islander ,113,0,113,100,127,100
2010,South Carolina,45,Native Hawaiian and Other Pacific Islander ,614,269,345,177,111,163
2010,South Dakota,46,Native Hawaiian and Other Pacific Islander ,91,19,72,80,26,78
2010,Tennessee,47,Native Hawaiian and Other Pacific Islander ,779,324,455,202,146,169
2010,Texas,48,Native Hawaiian and Other Pacific Islander ,5450,2956,2494,478,426,406
2010,Utah,49,Native Hawaiian and Other Pacific Islander ,4957,2309,2648,338,269,361
2010,Vermont,50,Native Hawaiian and Other Pacific Islander ,33,9,24,31,11,28
2010,Virginia,51,Native Hawaiian and Other Pacific Islander ,1688,893,795,283,186,234
2010,Washington,53,Native Hawaiian and Other Pacific Islander ,10043,3969,6074,438,337,416
2010,West Virginia,54,Native Hawaiian and Other Pacific Islander ,91,41,50,56,32,46
2010,Wisconsin,55,Native Hawaiian and Other Pacific Islander ,514,196,318,155,78,139
2010,Wyoming,56,Native Hawaiian and Other Pacific Islander ,55,23,32,34,25,23
2010,Puerto Rico,72,Native Hawaiian and Other Pacific Islander ,30,23,7,19,16,12
2011,Alabama,01,Native Hawaiian and Other Pacific Islander ,470,250,220,153,88,114
2011,Alaska,02,Native Hawaiian and Other Pacific Islander ,1450,437,1013,166,105,178
2011,Arizona,04,Native Hawaiian and Other Pacific Islander ,2975,1233,1742,399,328,330
2011,Arkansas,05,Native Hawaiian and Other Pacific Islander ,907,193,714,166,82,163
2011,California,06,Native Hawaiian and Other Pacific Islander ,37695,17942,19753,1103,895,975
2011,Colorado,08,Native Hawaiian and Other Pacific Islander ,1869,834,1035,325,191,233
2011,Connecticut,09,Native Hawaiian and Other Pacific Islander ,382,189,193,146,91,123
2011,Delaware,10,Native Hawaiian and Other Pacific Islander ,216,85,131,123,70,102
2011,District of Columbia,11,Native Hawaiian and Other Pacific Islander ,128,53,75,63,44,75
2011,Florida,12,Native Hawaiian and Other Pacific Islander ,3195,1558,1637,440,287,301
2011,Georgia,13,Native Hawaiian and Other Pacific Islander ,1548,684,864,270,195,211
2011,Hawaii,15,Native Hawaiian and Other Pacific Islander ,32965,14798,18167,825,631,896
2011,Idaho,16,Native Hawaiian and Other Pacific Islander ,746,479,267,204,204,118
2011,Illinois,17,Native Hawaiian and Other Pacific Islander ,1323,606,717,272,196,239
2011,Indiana,18,Native Hawaiian and Other Pacific Islander ,436,267,169,165,125,107
2011,Iowa,19,Native Hawaiian and Other Pacific Islander ,292,82,210,120,58,101
2011,Kansas,20,Native Hawaiian and Other Pacific Islander ,565,229,336,151,97,140
2011,Kentucky,21,Native Hawaiian and Other Pacific Islander ,674,228,446,230,135,196
2011,Louisiana,22,Native Hawaiian and Other Pacific Islander ,576,191,385,202,99,176
2011,Maine,23,Native Hawaiian and Other Pacific Islander ,141,64,77,67,33,65
2011,Maryland,24,Native Hawaiian and Other Pacific Islander ,838,313,525,179,116,182
2011,Massachusetts,25,Native Hawaiian and Other Pacific Islander ,398,166,232,120,95,111
2011,Michigan,26,Native Hawaiian and Other Pacific Islander ,842,433,409,193,146,159
2011,Minnesota,27,Native Hawaiian and Other Pacific Islander ,747,336,411,177,135,157
2011,Mississippi,28,Native Hawaiian and Other Pacific Islander ,150,63,87,98,63,64
2011,Missouri,29,Native Hawaiian and Other Pacific Islander ,1362,445,917,184,131,158
2011,Montana,30,Native Hawaiian and Other Pacific Islander ,164,82,82,70,41,51
2011,Nebraska,31,Native Hawaiian and Other Pacific Islander ,325,122,203,91,58,76
2011,Nevada,32,Native Hawaiian and Other Pacific Islander ,5094,2054,3040,389,363,326
2011,New Hampshire,33,Native Hawaiian and Other Pacific Islander ,65,34,31,39,20,33
2011,New Jersey,34,Native Hawaiian and Other Pacific Islander ,756,488,268,196,183,121
2011,New Mexico,35,Native Hawaiian and Other Pacific Islander ,469,199,270,142,75,135
2011,New York,36,Native Hawaiian and Other Pacific Islander ,2014,658,1356,306,178,291
2011,North Carolina,37,Native Hawaiian and Other Pacific Islander ,1233,564,669,299,190,242
2011,North Dakota,38,Native Hawaiian and Other Pacific Islander ,134,7,127,93,10,93
2011,Ohio,39,Native Hawaiian and Other Pacific Islander ,746,319,427,217,114,170
2011,Oklahoma,40,Native Hawaiian and Other Pacific Islander ,1053,356,697,169,111,163
2011,Oregon,41,Native Hawaiian and Other Pacific Islander ,3864,1063,2801,364,268,383
2011,Pennsylvania,42,Native Hawaiian and Other Pacific Islander ,964,539,425,217,164,158
2011,Rhode Island,44,Native Hawaiian and Other Pacific Islander ,212,0,212,139,95,139
2011,South Carolina,45,Native Hawaiian and Other Pacific Islander ,615,309,306,189,118,147
2011,South Dakota,46,Native Hawaiian and Other Pacific Islander ,75,16,59,72,22,69
2011,Tennessee,47,Native Hawaiian and Other Pacific Islander ,780,296,484,193,121,168
2011,Texas,48,Native Hawaiian and Other Pacific Islander ,5852,2857,2995,545,370,393
2011,Utah,49,Native Hawaiian and Other Pacific Islander ,5097,2189,2908,279,292,262
2011,Vermont,50,Native Hawaiian and Other Pacific Islander ,12,8,4,14,8,10
2011,Virginia,51,Native Hawaiian and Other Pacific Islander ,1561,887,674,260,191,208
2011,Washington,53,Native Hawaiian and Other Pacific Islander ,9827,3790,6037,490,410,475
2011,West Virginia,54,Native Hawaiian and Other Pacific Islander ,129,100,29,83,74,46
2011,Wisconsin,55,Native Hawaiian and Other Pacific Islander ,541,248,293,148,95,116
2011,Wyoming,56,Native Hawaiian and Other Pacific Islander ,63,36,27,47,32,32
2011,Puerto Rico,72,Native Hawaiian and Other Pacific Islander ,22,15,7,21,16,13
2012,Alabama,01,Native Hawaiian and Other Pacific Islander ,490,271,219,115,94,102
2012,Alaska,02,Native Hawaiian and Other Pacific Islander ,1516,403,1113,164,103,164
2012,Arizona,04,Native Hawaiian and Other Pacific Islander ,2921,1133,1788,332,232,286
2012,Arkansas,05,Native Hawaiian and Other Pacific Islander ,1184,154,1030,208,81,216
2012,California,06,Native Hawaiian and Other Pacific Islander ,37899,17439,20460,1007,714,916
2012,Colorado,08,Native Hawaiian and Other Pacific Islander ,1936,976,960,267,224,205
2012,Connecticut,09,Native Hawaiian and Other Pacific Islander ,593,281,312,174,107,156
2012,Delaware,10,Native Hawaiian and Other Pacific Islander ,139,83,56,99,83,50
2012,District of Columbia,11,Native Hawaiian and Other Pacific Islander ,113,52,61,67,35,76
2012,Florida,12,Native Hawaiian and Other Pacific Islander ,3509,1473,2036,438,277,394
2012,Georgia,13,Native Hawaiian and Other Pacific Islander ,1591,682,909,256,193,217
2012,Hawaii,15,Native Hawaiian and Other Pacific Islander ,33468,15324,18144,1008,665,795
2012,Idaho,16,Native Hawaiian and Other Pacific Islander ,674,401,273,196,194,121
2012,Illinois,17,Native Hawaiian and Other Pacific Islander ,976,541,435,188,162,155
2012,Indiana,18,Native Hawaiian and Other Pacific Islander ,599,341,258,182,141,104
2012,Iowa,19,Native Hawaiian and Other Pacific Islander ,297,153,144,118,69,88
2012,Kansas,20,Native Hawaiian and Other Pacific Islander ,633,276,357,149,107,144
2012,Kentucky,21,Native Hawaiian and Other Pacific Islander ,626,273,353,171,120,162
2012,Louisiana,22,Native Hawaiian and Other Pacific Islander ,676,275,401,223,129,177
2012,Maine,23,Native Hawaiian and Other Pacific Islander ,111,56,55,69,34,59
2012,Maryland,24,Native Hawaiian and Other Pacific Islander ,830,382,448,184,127,145
2012,Massachusetts,25,Native Hawaiian and Other Pacific Islander ,361,122,239,149,76,134
2012,Michigan,26,Native Hawaiian and Other Pacific Islander ,805,371,434,143,113,123
2012,Minnesota,27,Native Hawaiian and Other Pacific Islander ,812,294,518,190,126,162
2012,Mississippi,28,Native Hawaiian and Other Pacific Islander ,78,42,36,49,36,36
2012,Missouri,29,Native Hawaiian and Other Pacific Islander ,1413,388,1025,183,112,188
2012,Montana,30,Native Hawaiian and Other Pacific Islander ,159,83,76,58,39,46
2012,Nebraska,31,Native Hawaiian and Other Pacific Islander ,392,156,236,94,68,81
2012,Nevada,32,Native Hawaiian and Other Pacific Islander ,5165,1975,3190,385,333,361
2012,New Hampshire,33,Native Hawaiian and Other Pacific Islander ,40,40,0,19,19,27
2012,New Jersey,34,Native Hawaiian and Other Pacific Islander ,902,489,413,213,162,174
2012,New Mexico,35,Native Hawaiian and Other Pacific Islander ,432,183,249,104,73,97
2012,New York,36,Native Hawaiian and Other Pacific Islander ,2270,737,1533,359,193,293
2012,North Carolina,37,Native Hawaiian and Other Pacific Islander ,1318,563,755,263,158,206
2012,North Dakota,38,Native Hawaiian and Other Pacific Islander ,107,33,74,74,49,58
2012,Ohio,39,Native Hawaiian and Other Pacific Islander ,813,395,418,238,140,214
2012,Oklahoma,40,Native Hawaiian and Other Pacific Islander ,977,343,634,144,107,130
2012,Oregon,41,Native Hawaiian and Other Pacific Islander ,4007,1069,2938,374,232,374
2012,Pennsylvania,42,Native Hawaiian and Other Pacific Islander ,1067,632,435,278,228,159
2012,Rhode Island,44,Native Hawaiian and Other Pacific Islander ,137,5,132,95,8,95
2012,South Carolina,45,Native Hawaiian and Other Pacific Islander ,485,200,285,148,103,115
2012,South Dakota,46,Native Hawaiian and Other Pacific Islander ,73,2,71,89,4,89
2012,Tennessee,47,Native Hawaiian and Other Pacific Islander ,845,357,488,170,128,141
2012,Texas,48,Native Hawaiian and Other Pacific Islander ,6045,2873,3172,551,368,426
2012,Utah,49,Native Hawaiian and Other Pacific Islander ,5214,2268,2946,338,255,339
2012,Vermont,50,Native Hawaiian and Other Pacific Islander ,7,5,2,7,7,3
2012,Virginia,51,Native Hawaiian and Other Pacific Islander ,1534,1015,519,241,207,167
2012,Washington,53,Native Hawaiian and Other Pacific Islander ,10197,3838,6359,452,339,475
2012,West Virginia,54,Native Hawaiian and Other Pacific Islander ,157,89,68,84,59,64
2012,Wisconsin,55,Native Hawaiian and Other Pacific Islander ,404,198,206,125,85,91
2012,Wyoming,56,Native Hawaiian and Other Pacific Islander ,75,51,24,57,49,27
2012,Puerto Rico,72,Native Hawaiian and Other Pacific Islander ,5,5,0,8,8,30
2013,Alabama,01,Native Hawaiian and Other Pacific Islander ,511,282,229,134,101,105
2013,Alaska,02,Native Hawaiian and Other Pacific Islander ,1696,381,1315,197,121,179
2013,Arizona,04,Native Hawaiian and Other Pacific Islander ,3082,1254,1828,313,227,269
2013,Arkansas,05,Native Hawaiian and Other Pacific Islander ,1165,187,978,205,100,204
2013,California,06,Native Hawaiian and Other Pacific Islander ,38487,16227,22260,1039,824,1029
2013,Colorado,08,Native Hawaiian and Other Pacific Islander ,1898,994,904,265,174,224
2013,Connecticut,09,Native Hawaiian and Other Pacific Islander ,499,217,282,159,98,160
2013,Delaware,10,Native Hawaiian and Other Pacific Islander ,156,103,53,116,99,65
2013,District of Columbia,11,Native Hawaiian and Other Pacific Islander ,86,12,74,85,19,81
2013,Florida,12,Native Hawaiian and Other Pacific Islander ,3353,1396,1957,424,267,369
2013,Georgia,13,Native Hawaiian and Other Pacific Islander ,1556,705,851,237,201,177
2013,Hawaii,15,Native Hawaiian and Other Pacific Islander ,34136,15676,18460,836,607,747
2013,Idaho,16,Native Hawaiian and Other Pacific Islander ,556,304,252,170,146,119
2013,Illinois,17,Native Hawaiian and Other Pacific Islander ,1019,526,493,207,145,151
2013,Indiana,18,Native Hawaiian and Other Pacific Islander ,519,230,289,161,90,148
2013,Iowa,19,Native Hawaiian and Other Pacific Islander ,295,165,130,95,80,73
2013,Kansas,20,Native Hawaiian and Other Pacific Islander ,573,345,228,128,133,93
2013,Kentucky,21,Native Hawaiian and Other Pacific Islander ,455,226,229,131,87,101
2013,Louisiana,22,Native Hawaiian and Other Pacific Islander ,666,263,403,229,129,164
2013,Maine,23,Native Hawaiian and Other Pacific Islander ,90,41,49,65,38,49
2013,Maryland,24,Native Hawaiian and Other Pacific Islander ,824,282,542,211,107,181
2013,Massachusetts,25,Native Hawaiian and Other Pacific Islander ,543,149,394,173,92,166
2013,Michigan,26,Native Hawaiian and Other Pacific Islander ,695,350,345,196,104,154
2013,Minnesota,27,Native Hawaiian and Other Pacific Islander ,848,273,575,159,88,170
2013,Mississippi,28,Native Hawaiian and Other Pacific Islander ,112,59,53,58,39,53
2013,Missouri,29,Native Hawaiian and Other Pacific Islander ,1638,424,1214,218,121,208
2013,Montana,30,Native Hawaiian and Other Pacific Islander ,176,53,123,79,29,74
2013,Nebraska,31,Native Hawaiian and Other Pacific Islander ,494,217,277,127,91,108
2013,Nevada,32,Native Hawaiian and Other Pacific Islander ,4950,1746,3204,397,387,329
2013,New Hampshire,33,Native Hawaiian and Other Pacific Islander ,58,58,0,34,34,27
2013,New Jersey,34,Native Hawaiian and Other Pacific Islander ,888,409,479,271,188,192
2013,New Mexico,35,Native Hawaiian and Other Pacific Islander ,466,204,262,114,73,96
2013,New York,36,Native Hawaiian and Other Pacific Islander ,2224,774,1450,325,171,275
2013,North Carolina,37,Native Hawaiian and Other Pacific Islander ,1617,662,955,267,163,258
2013,North Dakota,38,Native Hawaiian and Other Pacific Islander ,79,26,53,52,37,34
2013,Ohio,39,Native Hawaiian and Other Pacific Islander ,829,389,440,231,121,192
2013,Oklahoma,40,Native Hawaiian and Other Pacific Islander ,1101,317,784,180,106,167
2013,Oregon,41,Native Hawaiian and Other Pacific Islander ,3875,1080,2795,313,234,282
2013,Pennsylvania,42,Native Hawaiian and Other Pacific Islander ,1094,671,423,242,200,163
2013,Rhode Island,44,Native Hawaiian and Other Pacific Islander ,116,37,79,85,38,75
2013,South Carolina,45,Native Hawaiian and Other Pacific Islander ,495,223,272,166,121,119
2013,South Dakota,46,Native Hawaiian and Other Pacific Islander ,127,20,107,89,30,81
2013,Tennessee,47,Native Hawaiian and Other Pacific Islander ,993,392,601,219,127,185
2013,Texas,48,Native Hawaiian and Other Pacific Islander ,5753,2621,3132,499,374,434
2013,Utah,49,Native Hawaiian and Other Pacific Islander ,5202,2017,3185,350,275,356
2013,Vermont,50,Native Hawaiian and Other Pacific Islander ,2,2,0,3,3,22
2013,Virginia,51,Native Hawaiian and Other Pacific Islander ,1556,965,591,206,150,163
2013,Washington,53,Native Hawaiian and Other Pacific Islander ,10541,3848,6693,549,315,527
2013,West Virginia,54,Native Hawaiian and Other Pacific Islander ,124,40,84,84,37,62
2013,Wisconsin,55,Native Hawaiian and Other Pacific Islander ,419,122,297,138,59,120
2013,Wyoming,56,Native Hawaiian and Other Pacific Islander ,58,34,24,47,34,25
2013,Puerto Rico,72,Native Hawaiian and Other Pacific Islander ,5,5,0,8,8,30
2014,Alabama,01,Native Hawaiian and Other Pacific Islander ,469,321,148,134,126,62
2014,Alaska,02,Native Hawaiian and Other Pacific Islander ,1841,444,1397,243,117,234
2014,Arizona,04,Native Hawaiian and Other Pacific Islander ,2836,1047,1789,297,206,255
2014,Arkansas,05,Native Hawaiian and Other Pacific Islander ,1401,188,1213,267,113,271
2014,California,06,Native Hawaiian and Other Pacific Islander ,38894,16027,22867,1137,795,1063
2014,Colorado,08,Native Hawaiian and Other Pacific Islander ,2021,945,1076,276,204,215
2014,Connecticut,09,Native Hawaiian and Other Pacific Islander ,436,197,239,141,110,117
2014,Delaware,10,Native Hawaiian and Other Pacific Islander ,95,46,49,74,41,68
2014,District of Columbia,11,Native Hawaiian and Other Pacific Islander ,56,13,43,50,19,45
2014,Florida,12,Native Hawaiian and Other Pacific Islander ,3714,1507,2207,442,306,368
2014,Georgia,13,Native Hawaiian and Other Pacific Islander ,1307,641,666,205,150,173
2014,Hawaii,15,Native Hawaiian and Other Pacific Islander ,34868,16190,18678,930,684,778
2014,Idaho,16,Native Hawaiian and Other Pacific Islander ,584,302,282,154,126,118
2014,Illinois,17,Native Hawaiian and Other Pacific Islander ,1131,542,589,229,165,163
2014,Indiana,18,Native Hawaiian and Other Pacific Islander ,510,207,303,147,88,118
2014,Iowa,19,Native Hawaiian and Other Pacific Islander ,408,150,258,135,79,121
2014,Kansas,20,Native Hawaiian and Other Pacific Islander ,378,185,193,103,72,70
2014,Kentucky,21,Native Hawaiian and Other Pacific Islander ,540,245,295,138,92,115
2014,Louisiana,22,Native Hawaiian and Other Pacific Islander ,437,185,252,124,73,104
2014,Maine,23,Native Hawaiian and Other Pacific Islander ,75,42,33,50,36,36
2014,Maryland,24,Native Hawaiian and Other Pacific Islander ,895,329,566,178,105,162
2014,Massachusetts,25,Native Hawaiian and Other Pacific Islander ,597,286,311,175,148,146
2014,Michigan,26,Native Hawaiian and Other Pacific Islander ,664,306,358,151,80,118
2014,Minnesota,27,Native Hawaiian and Other Pacific Islander ,856,298,558,172,94,155
2014,Mississippi,28,Native Hawaiian and Other Pacific Islander ,116,63,53,54,41,46
2014,Missouri,29,Native Hawaiian and Other Pacific Islander ,1582,516,1066,243,145,215
2014,Montana,30,Native Hawaiian and Other Pacific Islander ,206,59,147,91,35,97
2014,Nebraska,31,Native Hawaiian and Other Pacific Islander ,503,201,302,133,74,120
2014,Nevada,32,Native Hawaiian and Other Pacific Islander ,4929,1645,3284,364,275,316
2014,New Hampshire,33,Native Hawaiian and Other Pacific Islander ,99,85,14,70,68,15
2014,New Jersey,34,Native Hawaiian and Other Pacific Islander ,738,349,389,191,129,137
2014,New Mexico,35,Native Hawaiian and Other Pacific Islander ,367,207,160,104,68,72
2014,New York,36,Native Hawaiian and Other Pacific Islander ,1993,576,1417,311,138,299
2014,North Carolina,37,Native Hawaiian and Other Pacific Islander ,1778,652,1126,293,161,274
2014,North Dakota,38,Native Hawaiian and Other Pacific Islander ,68,18,50,42,27,34
2014,Ohio,39,Native Hawaiian and Other Pacific Islander ,860,424,436,208,115,175
2014,Oklahoma,40,Native Hawaiian and Other Pacific Islander ,1157,251,906,172,71,149
2014,Oregon,41,Native Hawaiian and Other Pacific Islander ,3929,1016,2913,350,230,315
2014,Pennsylvania,42,Native Hawaiian and Other Pacific Islander ,1132,591,541,235,157,179
2014,Rhode Island,44,Native Hawaiian and Other Pacific Islander ,166,33,133,128,33,115
2014,South Carolina,45,Native Hawaiian and Other Pacific Islander ,434,135,299,148,71,128
2014,South Dakota,46,Native Hawaiian and Other Pacific Islander ,82,17,65,38,25,30
2014,Tennessee,47,Native Hawaiian and Other Pacific Islander ,1074,456,618,218,153,156
2014,Texas,48,Native Hawaiian and Other Pacific Islander ,6300,2642,3658,435,338,367
2014,Utah,49,Native Hawaiian and Other Pacific Islander ,5392,2104,3288,334,234,339
2014,Vermont,50,Native Hawaiian and Other Pacific Islander ,8,6,2,9,8,3
2014,Virginia,51,Native Hawaiian and Other Pacific Islander ,1592,917,675,292,209,172
2014,Washington,53,Native Hawaiian and Other Pacific Islander ,10965,3603,7362,428,333,492
2014,West Virginia,54,Native Hawaiian and Other Pacific Islander ,171,37,134,90,32,85
2014,Wisconsin,55,Native Hawaiian and Other Pacific Islander ,375,121,254,116,64,93
2014,Wyoming,56,Native Hawaiian and Other Pacific Islander ,100,29,71,86,27,83
2014,Puerto Rico,72,Native Hawaiian and Other Pacific Islander ,5,5,0,8,8,30
2015,Alabama,01,Native Hawaiian and Other Pacific Islander ,617,308,309,155,109,103
2015,Alaska,02,Native Hawaiian and Other Pacific Islander ,1936,467,1469,242,123,227
2015,Arizona,04,Native Hawaiian and Other Pacific Islander ,2999,1111,1888,284,216,272
2015,Arkansas,05,Native Hawaiian and Other Pacific Islander ,1384,159,1225,213,96,207
2015,California,06,Native Hawaiian and Other Pacific Islander ,40280,16200,24080,1161,792,999
2015,Colorado,08,Native Hawaiian and Other Pacific Islander ,2268,997,1271,238,199,216
2015,Connecticut,09,Native Hawaiian and Other Pacific Islander ,370,114,256,103,73,91
2015,Delaware,10,Native Hawaiian and Other Pacific Islander ,70,25,45,51,22,47
2015,District of Columbia,11,Native Hawaiian and Other Pacific Islander ,100,9,91,67,15,66
2015,Florida,12,Native Hawaiian and Other Pacific Islander ,3229,1390,1839,356,242,310
2015,Georgia,13,Native Hawaiian and Other Pacific Islander ,1214,512,702,255,177,207
2015,Hawaii,15,Native Hawaiian and Other Pacific Islander ,34720,16252,18468,920,639,794
2015,Idaho,16,Native Hawaiian and Other Pacific Islander ,540,319,221,176,138,100
2015,Illinois,17,Native Hawaiian and Other Pacific Islander ,1124,555,569,196,149,138
2015,Indiana,18,Native Hawaiian and Other Pacific Islander ,520,213,307,146,74,116
2015,Iowa,19,Native Hawaiian and Other Pacific Islander ,453,146,307,119,64,105
2015,Kansas,20,Native Hawaiian and Other Pacific Islander ,384,156,228,117,70,94
2015,Kentucky,21,Native Hawaiian and Other Pacific Islander ,602,201,401,167,76,173
2015,Louisiana,22,Native Hawaiian and Other Pacific Islander ,430,193,237,139,93,105
2015,Maine,23,Native Hawaiian and Other Pacific Islander ,78,43,35,44,37,29
2015,Maryland,24,Native Hawaiian and Other Pacific Islander ,928,455,473,125,102,121
2015,Massachusetts,25,Native Hawaiian and Other Pacific Islander ,596,177,419,288,95,243
2015,Michigan,26,Native Hawaiian and Other Pacific Islander ,746,274,472,186,83,176
2015,Minnesota,27,Native Hawaiian and Other Pacific Islander ,694,213,481,164,84,144
2015,Mississippi,28,Native Hawaiian and Other Pacific Islander ,122,81,41,69,47,40
2015,Missouri,29,Native Hawaiian and Other Pacific Islander ,1813,560,1253,283,187,213
2015,Montana,30,Native Hawaiian and Other Pacific Islander ,238,51,187,113,30,116
2015,Nebraska,31,Native Hawaiian and Other Pacific Islander ,484,249,235,144,91,129
2015,Nevada,32,Native Hawaiian and Other Pacific Islander ,5093,1622,3471,461,315,376
2015,New Hampshire,33,Native Hawaiian and Other Pacific Islander ,76,60,16,59,54,18
2015,New Jersey,34,Native Hawaiian and Other Pacific Islander ,756,315,441,147,108,143
2015,New Mexico,35,Native Hawaiian and Other Pacific Islander ,387,203,184,112,82,86
2015,New York,36,Native Hawaiian and Other Pacific Islander ,1981,579,1402,277,167,267
2015,North Carolina,37,Native Hawaiian and Other Pacific Islander ,1868,673,1195,305,177,243
2015,North Dakota,38,Native Hawaiian and Other Pacific Islander ,51,17,34,46,22,32
2015,Ohio,39,Native Hawaiian and Other Pacific Islander ,1067,425,642,240,148,201
2015,Oklahoma,40,Native Hawaiian and Other Pacific Islander ,1246,295,951,154,82,128
2015,Oregon,41,Native Hawaiian and Other Pacific Islander ,4043,1064,2979,376,204,356
2015,Pennsylvania,42,Native Hawaiian and Other Pacific Islander ,1298,667,631,253,183,150
2015,Rhode Island,44,Native Hawaiian and Other Pacific Islander ,102,39,63,100,41,95
2015,South Carolina,45,Native Hawaiian and Other Pacific Islander ,518,159,359,134,91,122
2015,South Dakota,46,Native Hawaiian and Other Pacific Islander ,123,21,102,61,21,60
2015,Tennessee,47,Native Hawaiian and Other Pacific Islander ,1208,589,619,241,169,155
2015,Texas,48,Native Hawaiian and Other Pacific Islander ,6147,2422,3725,517,427,455
2015,Utah,49,Native Hawaiian and Other Pacific Islander ,5621,2117,3504,356,259,333
2015,Vermont,50,Native Hawaiian and Other Pacific Islander ,34,32,2,23,23,3
2015,Virginia,51,Native Hawaiian and Other Pacific Islander ,1727,1021,706,221,188,164
2015,Washington,53,Native Hawaiian and Other Pacific Islander ,11230,3677,7553,465,325,418
2015,West Virginia,54,Native Hawaiian and Other Pacific Islander ,231,72,159,105,60,85
2015,Wisconsin,55,Native Hawaiian and Other Pacific Islander ,386,138,248,119,59,100
2015,Wyoming,56,Native Hawaiian and Other Pacific Islander ,125,41,84,99,49,89
2015,Puerto Rico,72,Native Hawaiian and Other Pacific Islander ,5,5,0,8,8,31
2016,Alabama,01,Native Hawaiian and Other Pacific Islander ,559,295,264,149,111,94
2016,Alaska,02,Native Hawaiian and Other Pacific Islander ,1954,518,1436,197,148,212
2016,Arizona,04,Native Hawaiian and Other Pacific Islander ,3452,1487,1965,323,250,279
2016,Arkansas,05,Native Hawaiian and Other Pacific Islander ,1328,134,1194,195,94,175
2016,California,06,Native Hawaiian and Other Pacific Islander ,39893,16064,23829,1091,781,994
2016,Colorado,08,Native Hawaiian and Other Pacific Islander ,2304,988,1316,244,202,218
2016,Connecticut,09,Native Hawaiian and Other Pacific Islander ,358,117,241,104,66,97
2016,Delaware,10,Native Hawaiian and Other Pacific Islander ,88,30,58,58,28,57
2016,District of Columbia,11,Native Hawaiian and Other Pacific Islander ,99,9,90,74,14,71
2016,Florida,12,Native Hawaiian and Other Pacific Islander ,3595,1536,2059,402,314,303
2016,Georgia,13,Native Hawaiian and Other Pacific Islander ,1371,627,744,268,164,204
2016,Hawaii,15,Native Hawaiian and Other Pacific Islander ,36236,16188,20048,975,706,814
2016,Idaho,16,Native Hawaiian and Other Pacific Islander ,493,236,257,143,102,125
2016,Illinois,17,Native Hawaiian and Other Pacific Islander ,1294,619,675,187,130,144
2016,Indiana,18,Native Hawaiian and Other Pacific Islander ,606,216,390,157,81,130
2016,Iowa,19,Native Hawaiian and Other Pacific Islander ,635,176,459,136,65,132
2016,Kansas,20,Native Hawaiian and Other Pacific Islander ,420,159,261,88,58,78
2016,Kentucky,21,Native Hawaiian and Other Pacific Islander ,617,233,384,185,99,166
2016,Louisiana,22,Native Hawaiian and Other Pacific Islander ,314,167,147,95,60,70
2016,Maine,23,Native Hawaiian and Other Pacific Islander ,96,45,51,53,29,52
2016,Maryland,24,Native Hawaiian and Other Pacific Islander ,917,451,466,138,120,112
2016,Massachusetts,25,Native Hawaiian and Other Pacific Islander ,722,257,465,170,99,196
2016,Michigan,26,Native Hawaiian and Other Pacific Islander ,858,316,542,248,106,228
2016,Minnesota,27,Native Hawaiian and Other Pacific Islander ,606,198,408,156,80,143
2016,Mississippi,28,Native Hawaiian and Other Pacific Islander ,202,154,48,113,104,44
2016,Missouri,29,Native Hawaiian and Other Pacific Islander ,1867,616,1251,280,186,240
2016,Montana,30,Native Hawaiian and Other Pacific Islander ,189,46,143,104,27,100
2016,Nebraska,31,Native Hawaiian and Other Pacific Islander ,451,215,236,156,106,117
2016,Nevada,32,Native Hawaiian and Other Pacific Islander ,5187,1447,3740,370,236,375
2016,New Hampshire,33,Native Hawaiian and Other Pacific Islander ,80,59,21,58,54,18
2016,New Jersey,34,Native Hawaiian and Other Pacific Islander ,713,360,353,131,94,107
2016,New Mexico,35,Native Hawaiian and Other Pacific Islander ,444,205,239,135,97,122
2016,New York,36,Native Hawaiian and Other Pacific Islander ,2325,612,1713,312,149,300
2016,North Carolina,37,Native Hawaiian and Other Pacific Islander ,2045,712,1333,480,189,485
2016,North Dakota,38,Native Hawaiian and Other Pacific Islander ,52,17,35,49,23,43
2016,Ohio,39,Native Hawaiian and Other Pacific Islander ,1054,375,679,233,108,222
2016,Oklahoma,40,Native Hawaiian and Other Pacific Islander ,1219,302,917,131,84,142
2016,Oregon,41,Native Hawaiian and Other Pacific Islander ,3866,1254,2612,346,212,364
2016,Pennsylvania,42,Native Hawaiian and Other Pacific Islander ,1227,620,607,236,170,160
2016,Rhode Island,44,Native Hawaiian and Other Pacific Islander ,149,65,84,99,55,94
2016,South Carolina,45,Native Hawaiian and Other Pacific Islander ,554,152,402,153,72,136
2016,South Dakota,46,Native Hawaiian and Other Pacific Islander ,116,19,97,53,22,48
2016,Tennessee,47,Native Hawaiian and Other Pacific Islander ,1092,451,641,220,185,147
2016,Texas,48,Native Hawaiian and Other Pacific Islander ,6256,2624,3632,476,353,428
2016,Utah,49,Native Hawaiian and Other Pacific Islander ,5762,2278,3484,359,262,358
2016,Vermont,50,Native Hawaiian and Other Pacific Islander ,38,33,5,28,27,8
2016,Virginia,51,Native Hawaiian and Other Pacific Islander ,1657,758,899,241,163,205
2016,Washington,53,Native Hawaiian and Other Pacific Islander ,11570,3881,7689,518,383,540
2016,West Virginia,54,Native Hawaiian and Other Pacific Islander ,182,33,149,106,37,97
2016,Wisconsin,55,Native Hawaiian and Other Pacific Islander ,399,90,309,110,41,103
2016,Wyoming,56,Native Hawaiian and Other Pacific Islander ,79,30,49,87,42,76
2016,Puerto Rico,72,Native Hawaiian and Other Pacific Islander ,5,5,0,8,8,31
2017,Alabama,01,Native Hawaiian and Other Pacific Islander ,500,287,213,158,146,74
2017,Alaska,02,Native Hawaiian and Other Pacific Islander ,1983,541,1442,239,129,241
2017,Arizona,04,Native Hawaiian and Other Pacific Islander ,3496,1467,2029,363,210,292
2017,Arkansas,05,Native Hawaiian and Other Pacific Islander ,1605,144,1461,232,71,228
2017,California,06,Native Hawaiian and Other Pacific Islander ,40007,16619,23388,1039,810,936
2017,Colorado,08,Native Hawaiian and Other Pacific Islander ,2324,980,1344,257,198,211
2017,Connecticut,09,Native Hawaiian and Other Pacific Islander ,340,88,252,153,53,152
2017,Delaware,10,Native Hawaiian and Other Pacific Islander ,93,33,60,58,24,54
2017,District of Columbia,11,Native Hawaiian and Other Pacific Islander ,117,27,90,72,29,67
2017,Florida,12,Native Hawaiian and Other Pacific Islander ,3350,1464,1886,427,292,329
2017,Georgia,13,Native Hawaiian and Other Pacific Islander ,1444,710,734,260,173,219
2017,Hawaii,15,Native Hawaiian and Other Pacific Islander ,37037,16432,20605,926,722,889
2017,Idaho,16,Native Hawaiian and Other Pacific Islander ,808,329,479,274,150,205
2017,Illinois,17,Native Hawaiian and Other Pacific Islander ,1383,691,692,207,131,150
2017,Indiana,18,Native Hawaiian and Other Pacific Islander ,517,156,361,151,73,133
2017,Iowa,19,Native Hawaiian and Other Pacific Islander ,765,201,564,138,86,129
2017,Kansas,20,Native Hawaiian and Other Pacific Islander ,428,107,321,102,47,90
2017,Kentucky,21,Native Hawaiian and Other Pacific Islander ,616,300,316,129,100,105
2017,Louisiana,22,Native Hawaiian and Other Pacific Islander ,295,122,173,106,50,94
2017,Maine,23,Native Hawaiian and Other Pacific Islander ,107,57,50,54,45,31
2017,Maryland,24,Native Hawaiian and Other Pacific Islander ,937,524,413,140,130,108
2017,Massachusetts,25,Native Hawaiian and Other Pacific Islander ,801,310,491,215,112,206
2017,Michigan,26,Native Hawaiian and Other Pacific Islander ,938,321,617,243,113,203
2017,Minnesota,27,Native Hawaiian and Other Pacific Islander ,676,348,328,188,111,156
2017,Mississippi,28,Native Hawaiian and Other Pacific Islander ,261,189,72,120,101,56
2017,Missouri,29,Native Hawaiian and Other Pacific Islander ,1793,614,1179,304,219,230
2017,Montana,30,Native Hawaiian and Other Pacific Islander ,184,28,156,88,19,81
2017,Nebraska,31,Native Hawaiian and Other Pacific Islander ,550,196,354,184,91,151
2017,Nevada,32,Native Hawaiian and Other Pacific Islander ,5564,1615,3949,390,232,393
2017,New Hampshire,33,Native Hawaiian and Other Pacific Islander ,83,70,13,64,63,15
2017,New Jersey,34,Native Hawaiian and Other Pacific Islander ,712,351,361,136,98,99
2017,New Mexico,35,Native Hawaiian and Other Pacific Islander ,409,219,190,113,92,83
2017,New York,36,Native Hawaiian and Other Pacific Islander ,2406,704,1702,340,198,316
2017,North Carolina,37,Native Hawaiian and Other Pacific Islander ,1923,804,1119,301,239,262
2017,North Dakota,38,Native Hawaiian and Other Pacific Islander ,54,15,39,47,19,45
2017,Ohio,39,Native Hawaiian and Other Pacific Islander ,1084,317,767,213,126,171
2017,Oklahoma,40,Native Hawaiian and Other Pacific Islander ,1265,358,907,149,102,143
2017,Oregon,41,Native Hawaiian and Other Pacific Islander ,4018,1341,2677,388,245,306
2017,Pennsylvania,42,Native Hawaiian and Other Pacific Islander ,1123,573,550,231,159,134
2017,Rhode Island,44,Native Hawaiian and Other Pacific Islander ,235,59,176,128,59,125
2017,South Carolina,45,Native Hawaiian and Other Pacific Islander ,676,214,462,163,103,145
2017,South Dakota,46,Native Hawaiian and Other Pacific Islander ,129,28,101,65,25,57
2017,Tennessee,47,Native Hawaiian and Other Pacific Islander ,1112,407,705,207,132,154
2017,Texas,48,Native Hawaiian and Other Pacific Islander ,6646,2791,3855,565,411,450
2017,Utah,49,Native Hawaiian and Other Pacific Islander ,5916,2420,3496,390,300,431
2017,Vermont,50,Native Hawaiian and Other Pacific Islander ,35,30,5,26,25,7
2017,Virginia,51,Native Hawaiian and Other Pacific Islander ,1647,831,816,230,156,198
2017,Washington,53,Native Hawaiian and Other Pacific Islander ,12303,4157,8146,600,416,584
2017,West Virginia,54,Native Hawaiian and Other Pacific Islander ,155,26,129,98,40,85
2017,Wisconsin,55,Native Hawaiian and Other Pacific Islander ,543,124,419,125,51,119
2017,Wyoming,56,Native Hawaiian and Other Pacific Islander ,100,35,65,85,43,74
2017,Puerto Rico,72,Native Hawaiian and Other Pacific Islander ,0,0,0,32,32,32
2018,Alabama,01,Native Hawaiian and Other Pacific Islander ,511,310,201,136,111,95
2018,Alaska,02,Native Hawaiian and Other Pacific Islander ,2095,562,1533,246,143,252
2018,Arizona,04,Native Hawaiian and Other Pacific Islander ,3505,1411,2094,360,238,290
2018,Arkansas,05,Native Hawaiian and Other Pacific Islander ,1776,124,1652,235,73,231
2018,California,06,Native Hawaiian and Other Pacific Islander ,40450,17765,22685,1081,803,1079
2018,Colorado,08,Native Hawaiian and Other Pacific Islander ,2452,1089,1363,253,218,219
2018,Connecticut,09,Native Hawaiian and Other Pacific Islander ,456,114,342,195,68,187
2018,Delaware,10,Native Hawaiian and Other Pacific Islander ,134,43,91,69,36,64
2018,District of Columbia,11,Native Hawaiian and Other Pacific Islander ,104,43,61,61,39,49
2018,Florida,12,Native Hawaiian and Other Pacific Islander ,3446,1565,1881,381,248,305
2018,Georgia,13,Native Hawaiian and Other Pacific Islander ,1802,763,1039,312,206,282
2018,Hawaii,15,Native Hawaiian and Other Pacific Islander ,37662,16607,21055,1118,774,970
2018,Idaho,16,Native Hawaiian and Other Pacific Islander ,845,358,487,231,162,190
2018,Illinois,17,Native Hawaiian and Other Pacific Islander ,1422,693,729,241,147,193
2018,Indiana,18,Native Hawaiian and Other Pacific Islander ,592,218,374,139,61,131
2018,Iowa,19,Native Hawaiian and Other Pacific Islander ,832,206,626,188,81,181
2018,Kansas,20,Native Hawaiian and Other Pacific Islander ,399,149,250,85,61,59
2018,Kentucky,21,Native Hawaiian and Other Pacific Islander ,758,246,512,178,102,175
2018,Louisiana,22,Native Hawaiian and Other Pacific Islander ,352,177,175,87,65,74
2018,Maine,23,Native Hawaiian and Other Pacific Islander ,102,65,37,57,47,33
2018,Maryland,24,Native Hawaiian and Other Pacific Islander ,938,596,342,190,150,123
2018,Massachusetts,25,Native Hawaiian and Other Pacific Islander ,701,427,274,200,136,134
2018,Michigan,26,Native Hawaiian and Other Pacific Islander ,907,365,542,182,120,152
2018,Minnesota,27,Native Hawaiian and Other Pacific Islander ,695,397,298,197,177,87
2018,Mississippi,28,Native Hawaiian and Other Pacific Islander ,243,212,31,109,108,27
2018,Missouri,29,Native Hawaiian and Other Pacific Islander ,1695,676,1019,297,197,231
2018,Montana,30,Native Hawaiian and Other Pacific Islander ,244,60,184,118,51,114
2018,Nebraska,31,Native Hawaiian and Other Pacific Islander ,410,198,212,130,73,103
2018,Nevada,32,Native Hawaiian and Other Pacific Islander ,5821,1555,4266,429,277,369
2018,New Hampshire,33,Native Hawaiian and Other Pacific Islander ,82,55,27,56,51,25
2018,New Jersey,34,Native Hawaiian and Other Pacific Islander ,773,335,438,162,97,123
2018,New Mexico,35,Native Hawaiian and Other Pacific Islander ,438,207,231,156,105,137
2018,New York,36,Native Hawaiian and Other Pacific Islander ,2445,733,1712,354,175,298
2018,North Carolina,37,Native Hawaiian and Other Pacific Islander ,2111,985,1126,345,248,237
2018,North Dakota,38,Native Hawaiian and Other Pacific Islander ,79,16,63,55,20,53
2018,Ohio,39,Native Hawaiian and Other Pacific Islander ,1171,407,764,227,136,192
2018,Oklahoma,40,Native Hawaiian and Other Pacific Islander ,1138,353,785,157,97,144
2018,Oregon,41,Native Hawaiian and Other Pacific Islander ,4447,1388,3059,422,218,398
2018,Pennsylvania,42,Native Hawaiian and Other Pacific Islander ,1307,528,779,249,166,194
2018,Rhode Island,44,Native Hawaiian and Other Pacific Islander ,283,45,238,137,45,128
2018,South Carolina,45,Native Hawaiian and Other Pacific Islander ,641,216,425,154,90,127
2018,South Dakota,46,Native Hawaiian and Other Pacific Islander ,83,20,63,49,23,42
2018,Tennessee,47,Native Hawaiian and Other Pacific Islander ,1110,346,764,244,113,199
2018,Texas,48,Native Hawaiian and Other Pacific Islander ,6900,2804,4096,505,323,428
2018,Utah,49,Native Hawaiian and Other Pacific Islander ,6203,2613,3590,452,292,422
2018,Vermont,50,Native Hawaiian and Other Pacific Islander ,40,29,11,26,22,14
2018,Virginia,51,Native Hawaiian and Other Pacific Islander ,1636,860,776,199,184,190
2018,Washington,53,Native Hawaiian and Other Pacific Islander ,13183,4289,8894,608,400,580
2018,West Virginia,54,Native Hawaiian and Other Pacific Islander ,160,64,96,82,49,67
2018,Wisconsin,55,Native Hawaiian and Other Pacific Islander ,527,180,347,130,69,122
2018,Wyoming,56,Native Hawaiian and Other Pacific Islander ,127,56,71,79,52,58
2018,Puerto Rico,72,Native Hawaiian and Other Pacific Islander ,21,6,15,31,9,26
2019,Alabama,01,Native Hawaiian and Other Pacific Islander ,568,263,305,164,122,116
2019,Alaska,02,Native Hawaiian and Other Pacific Islander ,2029,545,1484,240,138,254
2019,Arizona,04,Native Hawaiian and Other Pacific Islander ,3705,1437,2268,335,242,300
2019,Arkansas,05,Native Hawaiian and Other Pacific Islander ,1856,123,1733,211,80,198
2019,California,06,Native Hawaiian and Other Pacific Islander ,40613,18082,22531,959,775,907
2019,Colorado,08,Native Hawaiian and Other Pacific Islander ,2663,1225,1438,282,244,242
2019,Connecticut,09,Native Hawaiian and Other Pacific Islander ,274,76,198,142,49,120
2019,Delaware,10,Native Hawaiian and Other Pacific Islander ,177,57,120,68,39,69
2019,District of Columbia,11,Native Hawaiian and Other Pacific Islander ,71,33,38,60,31,44
2019,Florida,12,Native Hawaiian and Other Pacific Islander ,3414,1504,1910,397,202,333
2019,Georgia,13,Native Hawaiian and Other Pacific Islander ,1923,816,1107,357,242,302
2019,Hawaii,15,Native Hawaiian and Other Pacific Islander ,37728,16680,21048,1035,650,991
2019,Idaho,16,Native Hawaiian and Other Pacific Islander ,859,385,474,238,163,204
2019,Illinois,17,Native Hawaiian and Other Pacific Islander ,1352,717,635,228,159,173
2019,Indiana,18,Native Hawaiian and Other Pacific Islander ,516,220,296,127,92,95
2019,Iowa,19,Native Hawaiian and Other Pacific Islander ,950,287,663,194,123,160
2019,Kansas,20,Native Hawaiian and Other Pacific Islander ,542,214,328,126,108,63
2019,Kentucky,21,Native Hawaiian and Other Pacific Islander ,816,280,536,211,105,198
2019,Louisiana,22,Native Hawaiian and Other Pacific Islander ,376,145,231,145,64,127
2019,Maine,23,Native Hawaiian and Other Pacific Islander ,148,84,64,67,52,55
2019,Maryland,24,Native Hawaiian and Other Pacific Islander ,961,561,400,131,102,122
2019,Massachusetts,25,Native Hawaiian and Other Pacific Islander ,922,495,427,252,162,176
2019,Michigan,26,Native Hawaiian and Other Pacific Islander ,937,401,536,178,140,159
2019,Minnesota,27,Native Hawaiian and Other Pacific Islander ,717,385,332,178,149,118
2019,Mississippi,28,Native Hawaiian and Other Pacific Islander ,268,239,29,135,129,37
2019,Missouri,29,Native Hawaiian and Other Pacific Islander ,2049,625,1424,274,194,222
2019,Montana,30,Native Hawaiian and Other Pacific Islander ,256,68,188,123,51,112
2019,Nebraska,31,Native Hawaiian and Other Pacific Islander ,303,177,126,83,63,69
2019,Nevada,32,Native Hawaiian and Other Pacific Islander ,6034,1732,4302,485,278,425
2019,New Hampshire,33,Native Hawaiian and Other Pacific Islander ,107,85,22,71,62,24
2019,New Jersey,34,Native Hawaiian and Other Pacific Islander ,860,408,452,220,154,148
2019,New Mexico,35,Native Hawaiian and Other Pacific Islander ,448,216,232,121,78,121
2019,New York,36,Native Hawaiian and Other Pacific Islander ,2750,822,1928,463,215,365
2019,North Carolina,37,Native Hawaiian and Other Pacific Islander ,2321,1193,1128,394,287,246
2019,North Dakota,38,Native Hawaiian and Other Pacific Islander ,218,18,200,118,21,116
2019,Ohio,39,Native Hawaiian and Other Pacific Islander ,1147,355,792,226,102,207
2019,Oklahoma,40,Native Hawaiian and Other Pacific Islander ,1564,526,1038,239,203,178
2019,Oregon,41,Native Hawaiian and Other Pacific Islander ,4443,1536,2907,380,254,373
2019,Pennsylvania,42,Native Hawaiian and Other Pacific Islander ,1248,522,726,278,148,233
2019,Rhode Island,44,Native Hawaiian and Other Pacific Islander ,282,60,222,117,57,109
2019,South Carolina,45,Native Hawaiian and Other Pacific Islander ,913,233,680,266,83,248
2019,South Dakota,46,Native Hawaiian and Other Pacific Islander ,141,22,119,62,25,56
2019,Tennessee,47,Native Hawaiian and Other Pacific Islander ,1132,300,832,235,106,208
2019,Texas,48,Native Hawaiian and Other Pacific Islander ,7055,3066,3989,544,469,446
2019,Utah,49,Native Hawaiian and Other Pacific Islander ,6412,2733,3679,456,342,410
2019,Vermont,50,Native Hawaiian and Other Pacific Islander ,155,90,65,81,58,62
2019,Virginia,51,Native Hawaiian and Other Pacific Islander ,1841,989,852,292,231,198
2019,Washington,53,Native Hawaiian and Other Pacific Islander ,13655,4456,9199,650,426,694
2019,West Virginia,54,Native Hawaiian and Other Pacific Islander ,127,50,77,85,42,77
2019,Wisconsin,55,Native Hawaiian and Other Pacific Islander ,611,239,372,139,74,127
2019,Wyoming,56,Native Hawaiian and Other Pacific Islander ,113,82,31,67,60,31
2019,Puerto Rico,72,Native Hawaiian and Other Pacific Islander ,22,6,16,27,9,26
2020,Alabama,01,Native Hawaiian and Other Pacific Islander ,390,231,159,125,103,88
2020,Alaska,02,Native Hawaiian and Other Pacific Islander ,2175,528,1647,237,162,270
2020,Arizona,04,Native Hawaiian and Other Pacific Islander ,3861,1468,2393,389,261,350
2020,Arkansas,05,Native Hawaiian and Other Pacific Islander ,2095,116,1979,169,72,165
2020,California,06,Native Hawaiian and Other Pacific Islander ,40036,18182,21854,1275,858,1156
2020,Colorado,08,Native Hawaiian and Other Pacific Islander ,2828,1463,1365,407,272,340
2020,Connecticut,09,Native Hawaiian and Other Pacific Islander ,311,162,149,129,110,78
2020,Delaware,10,Native Hawaiian and Other Pacific Islander ,132,53,79,79,36,72
2020,District of Columbia,11,Native Hawaiian and Other Pacific Islander ,27,25,2,24,24,3
2020,Florida,12,Native Hawaiian and Other Pacific Islander ,3468,1459,2009,425,261,328
2020,Georgia,13,Native Hawaiian and Other Pacific Islander ,2017,835,1182,337,247,244
2020,Hawaii,15,Native Hawaiian and Other Pacific Islander ,39091,17668,21423,1074,799,1096
2020,Idaho,16,Native Hawaiian and Other Pacific Islander ,932,415,517,222,130,208
2020,Illinois,17,Native Hawaiian and Other Pacific Islander ,1848,1003,845,308,217,217
2020,Indiana,18,Native Hawaiian and Other Pacific Islander ,488,175,313,121,87,119
2020,Iowa,19,Native Hawaiian and Other Pacific Islander ,948,307,641,216,132,184
2020,Kansas,20,Native Hawaiian and Other Pacific Islander ,635,255,380,198,118,152
2020,Kentucky,21,Native Hawaiian and Other Pacific Islander ,804,319,485,177,104,167
2020,Louisiana,22,Native Hawaiian and Other Pacific Islander ,492,223,269,196,100,166
2020,Maine,23,Native Hawaiian and Other Pacific Islander ,59,45,14,51,44,17
2020,Maryland,24,Native Hawaiian and Other Pacific Islander ,908,490,418,215,138,168
2020,Massachusetts,25,Native Hawaiian and Other Pacific Islander ,966,559,407,222,167,173
2020,Michigan,26,Native Hawaiian and Other Pacific Islander ,911,454,457,208,174,159
2020,Minnesota,27,Native Hawaiian and Other Pacific Islander ,870,488,382,187,158,119
2020,Mississippi,28,Native Hawaiian and Other Pacific Islander ,463,227,236,252,128,221
2020,Missouri,29,Native Hawaiian and Other Pacific Islander ,2222,619,1603,284,205,238
2020,Montana,30,Native Hawaiian and Other Pacific Islander ,168,46,122,66,41,55
2020,Nebraska,31,Native Hawaiian and Other Pacific Islander ,324,179,145,98,76,81
2020,Nevada,32,Native Hawaiian and Other Pacific Islander ,6544,2171,4373,491,316,400
2020,New Hampshire,33,Native Hawaiian and Other Pacific Islander ,187,120,67,106,88,57
2020,New Jersey,34,Native Hawaiian and Other Pacific Islander ,796,356,440,180,123,153
2020,New Mexico,35,Native Hawaiian and Other Pacific Islander ,512,234,278,173,100,143
2020,New York,36,Native Hawaiian and Other Pacific Islander ,2993,1053,1940,486,283,383
2020,North Carolina,37,Native Hawaiian and Other Pacific Islander ,2352,1232,1120,422,306,256
2020,North Dakota,38,Native Hawaiian and Other Pacific Islander ,333,74,259,198,83,145
2020,Ohio,39,Native Hawaiian and Other Pacific Islander ,936,353,583,166,94,135
2020,Oklahoma,40,Native Hawaiian and Other Pacific Islander ,1853,414,1439,404,194,419
2020,Oregon,41,Native Hawaiian and Other Pacific Islander ,4647,1565,3082,480,322,522
2020,Pennsylvania,42,Native Hawaiian and Other Pacific Islander ,1149,442,707,226,154,174
2020,Rhode Island,44,Native Hawaiian and Other Pacific Islander ,337,71,266,130,59,132
2020,South Carolina,45,Native Hawaiian and Other Pacific Islander ,906,234,672,246,89,231
2020,South Dakota,46,Native Hawaiian and Other Pacific Islander ,175,29,146,89,32,83
2020,Tennessee,47,Native Hawaiian and Other Pacific Islander ,944,199,745,203,90,192
2020,Texas,48,Native Hawaiian and Other Pacific Islander ,7687,3373,4314,675,464,546
2020,Utah,49,Native Hawaiian and Other Pacific Islander ,6655,3030,3625,513,367,467
2020,Vermont,50,Native Hawaiian and Other Pacific Islander ,101,44,57,74,40,65
2020,Virginia,51,Native Hawaiian and Other Pacific Islander ,1694,830,864,324,203,219
2020,Washington,53,Native Hawaiian and Other Pacific Islander ,14519,4782,9737,736,497,703
2020,West Virginia,54,Native Hawaiian and Other Pacific Islander ,96,54,42,60,47,42
2020,Wisconsin,55,Native Hawaiian and Other Pacific Islander ,659,216,443,185,60,174
2020,Wyoming,56,Native Hawaiian and Other Pacific Islander ,163,111,52,89,79,46
2020,Puerto Rico,72,Native Hawaiian and Other Pacific Islander ,23,7,16,27,10,26
2010,Alabama,01,Some Other Race ,11682,4288,7394,811,445,672
2010,Alaska,02,Some Other Race ,2927,1441,1486,346,240,274
2010,Arizona,04,Some Other Race ,138359,81041,57318,2822,2082,1901
2010,Arkansas,05,Some Other Race ,16507,8110,8397,920,655,662
2010,California,06,Some Other Race ,1347371,585854,761517,6841,5512,7317
2010,Colorado,08,Some Other Race ,80622,40592,40030,2013,1521,1463
2010,Connecticut,09,Some Other Race ,57043,15906,41137,1780,982,1477
2010,Delaware,10,Some Other Race ,4910,2410,2500,425,274,355
2010,District of Columbia,11,Some Other Race ,6642,1652,4990,562,236,560
2010,Florida,12,Some Other Race ,172561,87427,85134,3014,2092,2159
2010,Georgia,13,Some Other Race ,84136,31870,52266,1855,1180,1644
2010,Hawaii,15,Some Other Race ,4985,1703,3282,565,307,487
2010,Idaho,16,Some Other Race ,9173,5748,3425,562,426,427
2010,Illinois,17,Some Other Race ,235541,122800,112741,3129,2578,2389
2010,Indiana,18,Some Other Race ,39605,20206,19399,1239,807,998
2010,Iowa,19,Some Other Race ,12775,6581,6194,650,558,555
2010,Kansas,20,Some Other Race ,23447,13083,10364,999,677,761
2010,Kentucky,21,Some Other Race ,9639,2578,7061,689,428,598
2010,Louisiana,22,Some Other Race ,14868,5761,9107,893,641,632
2010,Maine,23,Some Other Race ,1110,418,692,209,128,166
2010,Maryland,24,Some Other Race ,44046,22588,21458,1444,994,1119
2010,Massachusetts,25,Some Other Race ,86109,21061,65048,2011,913,2061
2010,Michigan,26,Some Other Race ,37769,21607,16162,1275,956,753
2010,Minnesota,27,Some Other Race ,19456,9280,10176,790,554,729
2010,Mississippi,28,Some Other Race ,5511,1791,3720,451,291,405
2010,Missouri,29,Some Other Race ,16699,8156,8543,898,553,750
2010,Montana,30,Some Other Race ,2001,802,1199,326,212,298
2010,Nebraska,31,Some Other Race ,12952,6997,5955,653,545,530
2010,Nevada,32,Some Other Race ,44392,22689,21703,1462,1033,1177
2010,New Hampshire,33,Some Other Race ,3007,1007,2000,460,251,411
2010,New Jersey,34,Some Other Race ,162517,53761,108756,2318,1724,2246
2010,New Mexico,35,Some Other Race ,88912,58628,30284,1714,1399,1297
2010,New York,36,Some Other Race ,479290,92694,386596,4307,2089,3690
2010,North Carolina,37,Some Other Race ,90306,32826,57480,2236,1381,1826
2010,North Dakota,38,Some Other Race ,1147,491,656,228,153,199
2010,Ohio,39,Some Other Race ,27428,12362,15066,1049,784,866
2010,Oklahoma,40,Some Other Race ,26830,14068,12762,921,673,917
2010,Oregon,41,Some Other Race ,33710,14292,19418,1292,865,1021
2010,Pennsylvania,42,Some Other Race ,72857,29658,43199,1945,1099,1717
2010,Rhode Island,44,Some Other Race ,20099,5337,14762,781,520,758
2010,South Carolina,45,Some Other Race ,17896,5842,12054,963,573,881
2010,South Dakota,46,Some Other Race ,1986,820,1166,239,167,190
2010,Tennessee,47,Some Other Race ,21974,8038,13936,1153,674,997
2010,Texas,48,Some Other Race ,672178,371857,300321,6694,5139,4377
2010,Utah,49,Some Other Race ,23230,12382,10848,996,731,659
2010,Vermont,50,Some Other Race ,706,305,401,201,97,164
2010,Virginia,51,Some Other Race ,52012,25935,26077,1525,1016,1325
2010,Washington,53,Some Other Race ,71443,29524,41919,1637,1214,1541
2010,West Virginia,54,Some Other Race ,1011,509,502,246,187,143
2010,Wisconsin,55,Some Other Race ,29431,11879,17552,959,672,878
2010,Wyoming,56,Some Other Race ,4027,2323,1704,361,362,283
2010,Puerto Rico,72,Some Other Race ,126880,85126,41754,1992,1731,1119
2011,Alabama,01,Some Other Race ,12507,4465,8042,820,543,686
2011,Alaska,02,Some Other Race ,2890,1416,1474,370,260,254
2011,Arizona,04,Some Other Race ,126452,70813,55639,2581,2055,1740
2011,Arkansas,05,Some Other Race ,16623,8120,8503,909,620,853
2011,California,06,Some Other Race ,1261325,527275,734050,7847,4856,7187
2011,Colorado,08,Some Other Race ,73832,36161,37671,2022,1283,1383
2011,Connecticut,09,Some Other Race ,56877,15349,41528,1538,886,1324
2011,Delaware,10,Some Other Race ,4906,2550,2356,482,334,338
2011,District of Columbia,11,Some Other Race ,6698,1626,5072,699,284,635
2011,Florida,12,Some Other Race ,152980,74884,78096,2606,2030,2105
2011,Georgia,13,Some Other Race ,80773,31083,49690,2290,1265,2134
2011,Hawaii,15,Some Other Race ,4986,1976,3010,475,320,403
2011,Idaho,16,Some Other Race ,8584,5113,3471,681,475,450
2011,Illinois,17,Some Other Race ,218697,112708,105989,2799,1938,2450
2011,Indiana,18,Some Other Race ,39346,19651,19695,1285,992,1051
2011,Iowa,19,Some Other Race ,12551,6061,6490,697,484,523
2011,Kansas,20,Some Other Race ,21602,12178,9424,829,704,631
2011,Kentucky,21,Some Other Race ,10234,2834,7400,600,363,632
2011,Louisiana,22,Some Other Race ,15140,5794,9346,922,507,784
2011,Maine,23,Some Other Race ,916,366,550,189,107,155
2011,Maryland,24,Some Other Race ,44105,21970,22135,1336,952,1067
2011,Massachusetts,25,Some Other Race ,85959,20109,65850,2103,949,1955
2011,Michigan,26,Some Other Race ,33825,19321,14504,1244,770,945
2011,Minnesota,27,Some Other Race ,18647,8350,10297,832,569,816
2011,Mississippi,28,Some Other Race ,5372,1570,3802,621,311,532
2011,Missouri,29,Some Other Race ,16414,7824,8590,702,535,581
2011,Montana,30,Some Other Race ,1564,677,887,304,197,232
2011,Nebraska,31,Some Other Race ,11834,6277,5557,680,466,523
2011,Nevada,32,Some Other Race ,42904,21555,21349,1532,1120,1087
2011,New Hampshire,33,Some Other Race ,2912,1092,1820,397,233,329
2011,New Jersey,34,Some Other Race ,153506,49927,103579,2193,1393,2012
2011,New Mexico,35,Some Other Race ,85395,56020,29375,1811,1477,1173
2011,New York,36,Some Other Race ,469042,88023,381019,4906,2157,4547
2011,North Carolina,37,Some Other Race ,84855,32059,52796,2118,1382,1794
2011,North Dakota,38,Some Other Race ,1148,442,706,222,129,187
2011,Ohio,39,Some Other Race ,27032,11238,15794,1191,658,1028
2011,Oklahoma,40,Some Other Race ,26558,14034,12524,970,704,826
2011,Oregon,41,Some Other Race ,34369,13544,20825,1280,931,1150
2011,Pennsylvania,42,Some Other Race ,70620,28606,42014,1843,1232,1469
2011,Rhode Island,44,Some Other Race ,19152,5256,13896,790,409,710
2011,South Carolina,45,Some Other Race ,18562,6173,12389,903,606,731
2011,South Dakota,46,Some Other Race ,1895,808,1087,293,191,218
2011,Tennessee,47,Some Other Race ,22176,7696,14480,1007,759,882
2011,Texas,48,Some Other Race ,600271,324057,276214,5558,4473,3822
2011,Utah,49,Some Other Race ,22961,11807,11154,751,638,609
2011,Vermont,50,Some Other Race ,539,265,274,141,101,116
2011,Virginia,51,Some Other Race ,48816,23063,25753,1453,1135,1304
2011,Washington,53,Some Other Race ,68841,28661,40180,1890,1295,1687
2011,West Virginia,54,Some Other Race ,1004,438,566,209,121,175
2011,Wisconsin,55,Some Other Race ,25529,10691,14838,983,628,903
2011,Wyoming,56,Some Other Race ,3916,2148,1768,441,325,318
2011,Puerto Rico,72,Some Other Race ,121525,80516,41009,2312,1691,1368
2012,Alabama,01,Some Other Race ,12371,4237,8134,754,458,617
2012,Alaska,02,Some Other Race ,2536,1142,1394,371,247,296
2012,Arizona,04,Some Other Race ,111117,61661,49456,2196,1796,1583
2012,Arkansas,05,Some Other Race ,16054,8120,7934,851,623,693
2012,California,06,Some Other Race ,1195162,472547,722615,7066,4386,7344
2012,Colorado,08,Some Other Race ,68938,31045,37893,1863,1290,1517
2012,Connecticut,09,Some Other Race ,53113,13380,39733,1519,837,1381
2012,Delaware,10,Some Other Race ,5085,2556,2529,525,358,395
2012,District of Columbia,11,Some Other Race ,6360,1474,4886,515,246,479
2012,Florida,12,Some Other Race ,133464,62540,70924,2603,1766,2040
2012,Georgia,13,Some Other Race ,75361,28051,47310,2273,1258,1787
2012,Hawaii,15,Some Other Race ,4648,1612,3036,503,247,497
2012,Idaho,16,Some Other Race ,8888,5105,3783,600,501,453
2012,Illinois,17,Some Other Race ,197017,97993,99024,2947,2055,2398
2012,Indiana,18,Some Other Race ,38704,18675,20029,1321,937,1140
2012,Iowa,19,Some Other Race ,11928,5811,6117,673,488,511
2012,Kansas,20,Some Other Race ,19696,11235,8461,988,684,699
2012,Kentucky,21,Some Other Race ,10168,2880,7288,639,385,641
2012,Louisiana,22,Some Other Race ,14297,5436,8861,1027,571,775
2012,Maine,23,Some Other Race ,771,378,393,183,111,140
2012,Maryland,24,Some Other Race ,42748,19639,23109,1331,953,1097
2012,Massachusetts,25,Some Other Race ,83010,19347,63663,1727,1044,1828
2012,Michigan,26,Some Other Race ,29691,16909,12782,1109,738,887
2012,Minnesota,27,Some Other Race ,18083,7804,10279,923,526,777
2012,Mississippi,28,Some Other Race ,5791,1733,4058,618,342,552
2012,Missouri,29,Some Other Race ,16830,7198,9632,739,577,649
2012,Montana,30,Some Other Race ,1641,681,960,263,193,202
2012,Nebraska,31,Some Other Race ,11596,5924,5672,676,600,556
2012,Nevada,32,Some Other Race ,42774,20654,22120,1294,986,1049
2012,New Hampshire,33,Some Other Race ,2665,875,1790,408,186,387
2012,New Jersey,34,Some Other Race ,144049,45721,98328,2536,1289,2307
2012,New Mexico,35,Some Other Race ,81639,52306,29333,2339,1652,1514
2012,New York,36,Some Other Race ,457138,83845,373293,4816,2009,4331
2012,North Carolina,37,Some Other Race ,76042,29411,46631,2054,1232,1655
2012,North Dakota,38,Some Other Race ,1093,397,696,158,115,160
2012,Ohio,39,Some Other Race ,25388,10309,15079,1076,700,858
2012,Oklahoma,40,Some Other Race ,25154,13191,11963,1018,679,756
2012,Oregon,41,Some Other Race ,34788,12910,21878,1260,629,1096
2012,Pennsylvania,42,Some Other Race ,68967,27356,41611,1753,1173,1530
2012,Rhode Island,44,Some Other Race ,18700,5091,13609,862,534,781
2012,South Carolina,45,Some Other Race ,18187,6132,12055,906,600,757
2012,South Dakota,46,Some Other Race ,2033,879,1154,353,226,261
2012,Tennessee,47,Some Other Race ,22019,7432,14587,1063,645,921
2012,Texas,48,Some Other Race ,523296,274739,248557,5047,4099,3631
2012,Utah,49,Some Other Race ,24207,12302,11905,1018,759,740
2012,Vermont,50,Some Other Race ,524,283,241,139,117,97
2012,Virginia,51,Some Other Race ,46227,20518,25709,1549,1097,1311
2012,Washington,53,Some Other Race ,67972,27498,40474,1776,1106,1409
2012,West Virginia,54,Some Other Race ,891,415,476,207,120,157
2012,Wisconsin,55,Some Other Race ,21947,8733,13214,903,525,733
2012,Wyoming,56,Some Other Race ,4010,2105,1905,447,320,331
2012,Puerto Rico,72,Some Other Race ,113913,75100,38813,1943,1620,1175
2013,Alabama,01,Some Other Race ,13493,5279,8214,740,545,651
2013,Alaska,02,Some Other Race ,2584,1201,1383,345,237,244
2013,Arizona,04,Some Other Race ,108940,56807,52133,2404,1773,1600
2013,Arkansas,05,Some Other Race ,16072,7791,8281,763,684,554
2013,California,06,Some Other Race ,1184197,458845,725352,6832,3897,7063
2013,Colorado,08,Some Other Race ,69502,30381,39121,1626,1189,1549
2013,Connecticut,09,Some Other Race ,54269,13804,40465,1725,866,1484
2013,Delaware,10,Some Other Race ,5732,2571,3161,517,318,434
2013,District of Columbia,11,Some Other Race ,6593,1461,5132,702,297,657
2013,Florida,12,Some Other Race ,130815,58902,71913,2418,1832,1850
2013,Georgia,13,Some Other Race ,70877,25788,45089,2059,1322,1825
2013,Hawaii,15,Some Other Race ,4560,1514,3046,440,244,381
2013,Idaho,16,Some Other Race ,9898,5462,4436,648,490,440
2013,Illinois,17,Some Other Race ,190993,93814,97179,3084,2111,2119
2013,Indiana,18,Some Other Race ,39450,18950,20500,1392,936,1073
2013,Iowa,19,Some Other Race ,11453,5395,6058,708,451,558
2013,Kansas,20,Some Other Race ,18567,10518,8049,816,586,606
2013,Kentucky,21,Some Other Race ,9901,2602,7299,641,385,554
2013,Louisiana,22,Some Other Race ,14393,5028,9365,891,486,770
2013,Maine,23,Some Other Race ,829,355,474,183,134,136
2013,Maryland,24,Some Other Race ,45153,19628,25525,1417,929,1186
2013,Massachusetts,25,Some Other Race ,83603,18520,65083,2216,992,2131
2013,Michigan,26,Some Other Race ,28746,15927,12819,1215,784,831
2013,Minnesota,27,Some Other Race ,18926,7596,11330,912,543,677
2013,Mississippi,28,Some Other Race ,6131,2081,4050,599,374,524
2013,Missouri,29,Some Other Race ,17494,7681,9813,856,560,802
2013,Montana,30,Some Other Race ,1574,706,868,278,201,215
2013,Nebraska,31,Some Other Race ,11161,5821,5340,684,498,501
2013,Nevada,32,Some Other Race ,50582,22983,27599,1460,969,1198
2013,New Hampshire,33,Some Other Race ,2548,894,1654,376,218,312
2013,New Jersey,34,Some Other Race ,146882,45190,101692,2649,1378,2295
2013,New Mexico,35,Some Other Race ,78110,50938,27172,1751,1355,1263
2013,New York,36,Some Other Race ,462545,83953,378592,4922,1871,4501
2013,North Carolina,37,Some Other Race ,72404,28185,44219,1834,1215,1508
2013,North Dakota,38,Some Other Race ,1246,478,768,203,113,187
2013,Ohio,39,Some Other Race ,26480,10156,16324,1125,520,931
2013,Oklahoma,40,Some Other Race ,26002,13694,12308,900,647,808
2013,Oregon,41,Some Other Race ,35648,12410,23238,1395,700,1254
2013,Pennsylvania,42,Some Other Race ,67597,26586,41011,1835,1054,1542
2013,Rhode Island,44,Some Other Race ,18784,5327,13457,915,573,824
2013,South Carolina,45,Some Other Race ,18052,6435,11617,979,569,727
2013,South Dakota,46,Some Other Race ,1977,719,1258,300,177,262
2013,Tennessee,47,Some Other Race ,23584,8047,15537,1163,730,995
2013,Texas,48,Some Other Race ,491343,256243,235100,5005,4107,3423
2013,Utah,49,Some Other Race ,27483,13426,14057,1119,699,849
2013,Vermont,50,Some Other Race ,435,248,187,129,99,88
2013,Virginia,51,Some Other Race ,45291,19122,26169,1476,1011,1126
2013,Washington,53,Some Other Race ,66943,27158,39785,1901,969,1688
2013,West Virginia,54,Some Other Race ,932,399,533,191,128,140
2013,Wisconsin,55,Some Other Race ,22901,8298,14603,1042,610,972
2013,Wyoming,56,Some Other Race ,3846,2163,1683,381,260,333
2013,Puerto Rico,72,Some Other Race ,119784,78531,41253,2148,1919,1489
2014,Alabama,01,Some Other Race ,13851,5624,8227,846,539,695
2014,Alaska,02,Some Other Race ,2406,1039,1367,340,211,257
2014,Arizona,04,Some Other Race ,112483,56971,55512,2238,1936,1756
2014,Arkansas,05,Some Other Race ,15389,7303,8086,851,554,688
2014,California,06,Some Other Race ,1183790,453825,729965,6464,4153,5309
2014,Colorado,08,Some Other Race ,68851,28326,40525,1805,1171,1437
2014,Connecticut,09,Some Other Race ,54119,13803,40316,1514,897,1262
2014,Delaware,10,Some Other Race ,5783,2506,3277,473,321,438
2014,District of Columbia,11,Some Other Race ,6914,1438,5476,586,254,564
2014,Florida,12,Some Other Race ,130440,56382,74058,2700,1958,2013
2014,Georgia,13,Some Other Race ,70038,26939,43099,1790,1385,1641
2014,Hawaii,15,Some Other Race ,4574,1501,3073,445,258,360
2014,Idaho,16,Some Other Race ,9728,5035,4693,726,527,540
2014,Illinois,17,Some Other Race ,186396,90134,96262,2862,1854,2110
2014,Indiana,18,Some Other Race ,40249,18911,21338,1201,792,1119
2014,Iowa,19,Some Other Race ,10678,5037,5641,671,437,522
2014,Kansas,20,Some Other Race ,18621,10806,7815,752,545,655
2014,Kentucky,21,Some Other Race ,9501,2668,6833,708,329,658
2014,Louisiana,22,Some Other Race ,13792,5096,8696,786,524,621
2014,Maine,23,Some Other Race ,790,407,383,196,130,141
2014,Maryland,24,Some Other Race ,45174,18740,26434,1347,1014,1145
2014,Massachusetts,25,Some Other Race ,85269,18296,66973,1807,824,1779
2014,Michigan,26,Some Other Race ,28484,15769,12715,1030,755,790
2014,Minnesota,27,Some Other Race ,19483,7684,11799,805,519,745
2014,Mississippi,28,Some Other Race ,6157,2196,3961,628,403,516
2014,Missouri,29,Some Other Race ,17510,7565,9945,920,645,694
2014,Montana,30,Some Other Race ,1335,561,774,258,158,226
2014,Nebraska,31,Some Other Race ,10177,5428,4749,604,415,453
2014,Nevada,32,Some Other Race ,57914,24388,33526,1610,1098,1297
2014,New Hampshire,33,Some Other Race ,2155,855,1300,304,177,260
2014,New Jersey,34,Some Other Race ,155814,46287,109527,2592,1495,2261
2014,New Mexico,35,Some Other Race ,76107,48503,27604,1814,1378,1301
2014,New York,36,Some Other Race ,479332,84118,395214,5168,2003,4596
2014,North Carolina,37,Some Other Race ,72454,28222,44232,2007,1301,1600
2014,North Dakota,38,Some Other Race ,1409,544,865,234,137,210
2014,Ohio,39,Some Other Race ,27747,10702,17045,989,638,867
2014,Oklahoma,40,Some Other Race ,26452,13727,12725,927,548,801
2014,Oregon,41,Some Other Race ,35222,12781,22441,1481,836,1274
2014,Pennsylvania,42,Some Other Race ,66999,25718,41281,1758,1142,1513
2014,Rhode Island,44,Some Other Race ,18637,5291,13346,812,552,748
2014,South Carolina,45,Some Other Race ,18531,7087,11444,1012,733,781
2014,South Dakota,46,Some Other Race ,2044,780,1264,277,170,215
2014,Tennessee,47,Some Other Race ,24855,7996,16859,1087,662,948
2014,Texas,48,Some Other Race ,460210,237402,222808,5011,4390,3254
2014,Utah,49,Some Other Race ,29637,14483,15154,1048,800,944
2014,Vermont,50,Some Other Race ,381,185,196,96,72,76
2014,Virginia,51,Some Other Race ,44833,18309,26524,1619,995,1348
2014,Washington,53,Some Other Race ,66880,26235,40645,1693,1087,1457
2014,West Virginia,54,Some Other Race ,948,357,591,193,123,163
2014,Wisconsin,55,Some Other Race ,24483,8260,16223,1147,613,1008
2014,Wyoming,56,Some Other Race ,3859,2195,1664,449,328,315
2014,Puerto Rico,72,Some Other Race ,133186,86243,46943,2412,1758,1654
2015,Alabama,01,Some Other Race ,14297,6099,8198,768,582,663
2015,Alaska,02,Some Other Race ,2699,1073,1626,356,211,321
2015,Arizona,04,Some Other Race ,116393,57133,59260,2250,1516,1781
2015,Arkansas,05,Some Other Race ,15959,7538,8421,761,596,608
2015,California,06,Some Other Race ,1208919,461522,747397,7862,3904,7131
2015,Colorado,08,Some Other Race ,65034,26633,38401,1637,1087,1408
2015,Connecticut,09,Some Other Race ,53677,14149,39528,1301,729,1188
2015,Delaware,10,Some Other Race ,5873,2555,3318,549,394,449
2015,District of Columbia,11,Some Other Race ,8337,1650,6687,536,217,564
2015,Florida,12,Some Other Race ,134851,57118,77733,3257,2154,2466
2015,Georgia,13,Some Other Race ,69361,28008,41353,1962,1389,1643
2015,Hawaii,15,Some Other Race ,4380,1428,2952,424,251,367
2015,Idaho,16,Some Other Race ,9874,5154,4720,619,493,502
2015,Illinois,17,Some Other Race ,186587,89706,96881,2531,2018,2184
2015,Indiana,18,Some Other Race ,40853,19403,21450,1338,880,1196
2015,Iowa,19,Some Other Race ,11018,5003,6015,725,459,605
2015,Kansas,20,Some Other Race ,18094,10481,7613,756,585,547
2015,Kentucky,21,Some Other Race ,9387,2649,6738,712,358,604
2015,Louisiana,22,Some Other Race ,13980,5284,8696,795,524,765
2015,Maine,23,Some Other Race ,762,422,340,158,117,101
2015,Maryland,24,Some Other Race ,48601,19370,29231,1287,835,1025
2015,Massachusetts,25,Some Other Race ,87658,18728,68930,1971,1019,1692
2015,Michigan,26,Some Other Race ,29978,16206,13772,1108,881,795
2015,Minnesota,27,Some Other Race ,20562,7779,12783,920,591,935
2015,Mississippi,28,Some Other Race ,6277,2243,4034,640,401,549
2015,Missouri,29,Some Other Race ,18207,8094,10113,938,559,743
2015,Montana,30,Some Other Race ,1417,814,603,254,205,149
2015,Nebraska,31,Some Other Race ,9744,4973,4771,562,444,347
2015,Nevada,32,Some Other Race ,63080,26054,37026,1560,1102,1210
2015,New Hampshire,33,Some Other Race ,1893,757,1136,311,177,261
2015,New Jersey,34,Some Other Race ,161096,46776,114320,2476,1470,2204
2015,New Mexico,35,Some Other Race ,75076,48047,27029,1780,1313,1333
2015,New York,36,Some Other Race ,491977,85509,406468,4374,2093,4283
2015,North Carolina,37,Some Other Race ,72295,27757,44538,1843,1158,1611
2015,North Dakota,38,Some Other Race ,1650,522,1128,270,152,237
2015,Ohio,39,Some Other Race ,29085,11396,17689,1129,720,1007
2015,Oklahoma,40,Some Other Race ,26909,13903,13006,784,552,539
2015,Oregon,41,Some Other Race ,32522,11873,20649,1293,719,1045
2015,Pennsylvania,42,Some Other Race ,69126,26054,43072,1829,1059,1539
2015,Rhode Island,44,Some Other Race ,18833,5408,13425,1022,547,903
2015,South Carolina,45,Some Other Race ,19063,7735,11328,960,658,746
2015,South Dakota,46,Some Other Race ,2250,809,1441,296,183,276
2015,Tennessee,47,Some Other Race ,24954,7832,17122,1007,602,910
2015,Texas,48,Some Other Race ,441941,230344,211597,4834,3951,3296
2015,Utah,49,Some Other Race ,31088,14787,16301,1006,791,830
2015,Vermont,50,Some Other Race ,492,192,300,109,61,98
2015,Virginia,51,Some Other Race ,46425,18621,27804,1545,1044,1250
2015,Washington,53,Some Other Race ,67873,26570,41303,2020,1135,1605
2015,West Virginia,54,Some Other Race ,1060,435,625,215,126,176
2015,Wisconsin,55,Some Other Race ,25895,8746,17149,1005,634,825
2015,Wyoming,56,Some Other Race ,3806,2060,1746,444,341,316
2015,Puerto Rico,72,Some Other Race ,149234,94710,54524,2132,1932,1622
2016,Alabama,01,Some Other Race ,14457,6308,8149,1033,626,781
2016,Alaska,02,Some Other Race ,2562,1014,1548,334,242,259
2016,Arizona,04,Some Other Race ,125578,61928,63650,2549,1880,1634
2016,Arkansas,05,Some Other Race ,16623,8008,8615,864,640,723
2016,California,06,Some Other Race ,1250855,478450,772405,7669,4279,7343
2016,Colorado,08,Some Other Race ,66108,26439,39669,1715,1068,1396
2016,Connecticut,09,Some Other Race ,53397,14637,38760,1387,888,1289
2016,Delaware,10,Some Other Race ,5432,2218,3214,629,362,459
2016,District of Columbia,11,Some Other Race ,9095,1589,7506,571,269,595
2016,Florida,12,Some Other Race ,139729,59173,80556,2958,2191,2535
2016,Georgia,13,Some Other Race ,70099,27407,42692,1911,1318,1768
2016,Hawaii,15,Some Other Race ,3715,965,2750,413,180,403
2016,Idaho,16,Some Other Race ,11112,5836,5276,751,583,483
2016,Illinois,17,Some Other Race ,191355,92045,99310,2339,1927,1930
2016,Indiana,18,Some Other Race ,40922,19838,21084,1267,899,991
2016,Iowa,19,Some Other Race ,10683,5063,5620,687,559,554
2016,Kansas,20,Some Other Race ,17763,10204,7559,903,701,591
2016,Kentucky,21,Some Other Race ,9363,2609,6754,627,357,543
2016,Louisiana,22,Some Other Race ,14958,5597,9361,759,492,735
2016,Maine,23,Some Other Race ,711,346,365,189,120,149
2016,Maryland,24,Some Other Race ,50408,20377,30031,1358,1073,1091
2016,Massachusetts,25,Some Other Race ,87293,19825,67468,2071,955,2009
2016,Michigan,26,Some Other Race ,30857,16501,14356,1166,832,813
2016,Minnesota,27,Some Other Race ,22000,8993,13007,900,539,671
2016,Mississippi,28,Some Other Race ,6701,2466,4235,558,380,472
2016,Missouri,29,Some Other Race ,18448,7875,10573,923,607,824
2016,Montana,30,Some Other Race ,1358,763,595,258,182,153
2016,Nebraska,31,Some Other Race ,9759,4944,4815,636,446,405
2016,Nevada,32,Some Other Race ,68115,26509,41606,1792,1029,1435
2016,New Hampshire,33,Some Other Race ,2057,797,1260,320,149,280
2016,New Jersey,34,Some Other Race ,161752,46092,115660,2706,1430,2503
2016,New Mexico,35,Some Other Race ,72124,46166,25958,1972,1403,1276
2016,New York,36,Some Other Race ,496807,87160,409647,5061,2052,4837
2016,North Carolina,37,Some Other Race ,73861,29036,44825,1896,1339,1668
2016,North Dakota,38,Some Other Race ,1475,580,895,292,186,246
2016,Ohio,39,Some Other Race ,29160,11153,18007,947,636,834
2016,Oklahoma,40,Some Other Race ,27709,14391,13318,909,629,701
2016,Oregon,41,Some Other Race ,31066,11873,19193,1351,797,1201
2016,Pennsylvania,42,Some Other Race ,69834,26302,43532,1568,1216,1428
2016,Rhode Island,44,Some Other Race ,18621,4934,13687,950,535,912
2016,South Carolina,45,Some Other Race ,19517,8041,11476,1085,624,924
2016,South Dakota,46,Some Other Race ,2073,620,1453,307,151,277
2016,Tennessee,47,Some Other Race ,22742,7448,15294,974,570,964
2016,Texas,48,Some Other Race ,437947,229827,208120,4186,3908,3261
2016,Utah,49,Some Other Race ,33429,15888,17541,1093,882,1019
2016,Vermont,50,Some Other Race ,548,225,323,120,79,105
2016,Virginia,51,Some Other Race ,47867,18464,29403,1665,1076,1398
2016,Washington,53,Some Other Race ,71584,28354,43230,1887,1226,1506
2016,West Virginia,54,Some Other Race ,1491,546,945,241,123,211
2016,Wisconsin,55,Some Other Race ,28581,9312,19269,1123,632,975
2016,Wyoming,56,Some Other Race ,3368,1803,1565,431,309,298
2016,Puerto Rico,72,Some Other Race ,165341,102921,62420,2875,2246,1855
2017,Alabama,01,Some Other Race ,15826,6822,9004,910,670,726
2017,Alaska,02,Some Other Race ,2894,1108,1786,361,263,300
2017,Arizona,04,Some Other Race ,127647,63398,64249,2275,1628,1967
2017,Arkansas,05,Some Other Race ,18799,9350,9449,858,572,726
2017,California,06,Some Other Race ,1297440,507346,790094,8285,4629,7362
2017,Colorado,08,Some Other Race ,66060,27914,38146,1534,1214,1250
2017,Connecticut,09,Some Other Race ,55728,15011,40717,1762,1003,1477
2017,Delaware,10,Some Other Race ,4853,2079,2774,458,288,327
2017,District of Columbia,11,Some Other Race ,9218,1816,7402,703,293,654
2017,Florida,12,Some Other Race ,149796,64762,85034,3170,2188,2476
2017,Georgia,13,Some Other Race ,71299,29873,41426,2209,1413,1881
2017,Hawaii,15,Some Other Race ,3884,1031,2853,362,192,361
2017,Idaho,16,Some Other Race ,12456,6805,5651,818,646,544
2017,Illinois,17,Some Other Race ,195257,96143,99114,2838,2182,2240
2017,Indiana,18,Some Other Race ,40056,19472,20584,1374,1067,1127
2017,Iowa,19,Some Other Race ,10863,5170,5693,654,480,501
2017,Kansas,20,Some Other Race ,18371,10419,7952,968,714,633
2017,Kentucky,21,Some Other Race ,9636,2619,7017,634,350,544
2017,Louisiana,22,Some Other Race ,16867,6114,10753,921,528,760
2017,Maine,23,Some Other Race ,713,344,369,179,101,137
2017,Maryland,24,Some Other Race ,54301,22096,32205,1322,983,1172
2017,Massachusetts,25,Some Other Race ,87621,20316,67305,1894,1002,1788
2017,Michigan,26,Some Other Race ,32141,17292,14849,1010,794,767
2017,Minnesota,27,Some Other Race ,23743,9568,14175,960,601,743
2017,Mississippi,28,Some Other Race ,6977,2900,4077,652,435,532
2017,Missouri,29,Some Other Race ,18860,8328,10532,1036,575,923
2017,Montana,30,Some Other Race ,1384,813,571,249,222,154
2017,Nebraska,31,Some Other Race ,9540,4741,4799,753,486,480
2017,Nevada,32,Some Other Race ,74957,29499,45458,1727,1212,1461
2017,New Hampshire,33,Some Other Race ,2005,779,1226,274,167,251
2017,New Jersey,34,Some Other Race ,163228,47583,115645,3149,1824,2344
2017,New Mexico,35,Some Other Race ,66020,42386,23634,1822,1283,1299
2017,New York,36,Some Other Race ,504176,91768,412408,4958,1829,4886
2017,North Carolina,37,Some Other Race ,78775,31573,47202,2064,1329,1753
2017,North Dakota,38,Some Other Race ,1951,589,1362,301,162,294
2017,Ohio,39,Some Other Race ,31071,11964,19107,1087,652,983
2017,Oklahoma,40,Some Other Race ,28527,15029,13498,839,692,630
2017,Oregon,41,Some Other Race ,30577,12422,18155,1202,870,898
2017,Pennsylvania,42,Some Other Race ,70495,26911,43584,1891,1077,1613
2017,Rhode Island,44,Some Other Race ,18700,5114,13586,930,514,794
2017,South Carolina,45,Some Other Race ,19854,8211,11643,1028,615,855
2017,South Dakota,46,Some Other Race ,1906,545,1361,320,135,300
2017,Tennessee,47,Some Other Race ,22283,7610,14673,1117,571,961
2017,Texas,48,Some Other Race ,444352,235282,209070,4994,3764,3776
2017,Utah,49,Some Other Race ,35775,16821,18954,1086,841,1010
2017,Vermont,50,Some Other Race ,498,231,267,117,74,90
2017,Virginia,51,Some Other Race ,49565,20442,29123,1681,1135,1486
2017,Washington,53,Some Other Race ,76547,30805,45742,1974,1128,1755
2017,West Virginia,54,Some Other Race ,1784,587,1197,323,151,291
2017,Wisconsin,55,Some Other Race ,31080,10412,20668,1034,582,850
2017,Wyoming,56,Some Other Race ,3192,1698,1494,424,292,306
2017,Puerto Rico,72,Some Other Race ,179651,110586,69065,2658,2132,1903
2018,Alabama,01,Some Other Race ,16261,7061,9200,994,750,790
2018,Alaska,02,Some Other Race ,3378,1446,1932,422,296,321
2018,Arizona,04,Some Other Race ,127412,64821,62591,1935,1540,1451
2018,Arkansas,05,Some Other Race ,20667,10467,10200,953,730,792
2018,California,06,Some Other Race ,1325598,522417,803181,7266,4755,7086
2018,Colorado,08,Some Other Race ,63654,28007,35647,1690,1086,1226
2018,Connecticut,09,Some Other Race ,57381,15680,41701,1651,966,1441
2018,Delaware,10,Some Other Race ,4666,2290,2376,488,308,414
2018,District of Columbia,11,Some Other Race ,9484,1702,7782,613,273,613
2018,Florida,12,Some Other Race ,162543,70306,92237,3269,2117,2500
2018,Georgia,13,Some Other Race ,71573,30680,40893,1627,1499,1321
2018,Hawaii,15,Some Other Race ,4085,1055,3030,478,196,454
2018,Idaho,16,Some Other Race ,13872,7460,6412,884,694,557
2018,Illinois,17,Some Other Race ,197356,96809,100547,3012,2108,2449
2018,Indiana,18,Some Other Race ,40332,20035,20297,1204,896,1139
2018,Iowa,19,Some Other Race ,11195,5387,5808,617,466,520
2018,Kansas,20,Some Other Race ,18768,10681,8087,1001,660,751
2018,Kentucky,21,Some Other Race ,10296,2857,7439,663,364,601
2018,Louisiana,22,Some Other Race ,18018,6540,11478,878,637,731
2018,Maine,23,Some Other Race ,761,418,343,157,105,126
2018,Maryland,24,Some Other Race ,57320,23844,33476,1462,1051,1058
2018,Massachusetts,25,Some Other Race ,88853,21484,67369,2294,1028,2038
2018,Michigan,26,Some Other Race ,33541,18131,15410,1187,818,1013
2018,Minnesota,27,Some Other Race ,25009,10270,14739,948,650,835
2018,Mississippi,28,Some Other Race ,7153,3045,4108,513,371,505
2018,Missouri,29,Some Other Race ,18718,7810,10908,1121,707,866
2018,Montana,30,Some Other Race ,1598,953,645,294,246,179
2018,Nebraska,31,Some Other Race ,9863,4863,5000,715,477,487
2018,Nevada,32,Some Other Race ,80910,31944,48966,1918,1315,1654
2018,New Hampshire,33,Some Other Race ,1829,655,1174,290,174,251
2018,New Jersey,34,Some Other Race ,165293,47735,117558,2622,1532,2392
2018,New Mexico,35,Some Other Race ,63139,39820,23319,1765,1411,1190
2018,New York,36,Some Other Race ,511909,93010,418899,5364,1900,5083
2018,North Carolina,37,Some Other Race ,79174,32052,47122,2207,1487,1414
2018,North Dakota,38,Some Other Race ,2465,676,1789,350,157,320
2018,Ohio,39,Some Other Race ,32765,12522,20243,1228,806,1017
2018,Oklahoma,40,Some Other Race ,28798,15306,13492,840,601,770
2018,Oregon,41,Some Other Race ,32159,13445,18714,1327,863,1152
2018,Pennsylvania,42,Some Other Race ,74337,28460,45877,1727,1243,1688
2018,Rhode Island,44,Some Other Race ,17992,4778,13214,957,513,936
2018,South Carolina,45,Some Other Race ,20962,9275,11687,1121,796,873
2018,South Dakota,46,Some Other Race ,2157,657,1500,350,173,338
2018,Tennessee,47,Some Other Race ,22530,8203,14327,1025,771,786
2018,Texas,48,Some Other Race ,451293,235490,215803,5232,4441,3591
2018,Utah,49,Some Other Race ,37901,18454,19447,1302,871,1170
2018,Vermont,50,Some Other Race ,555,264,291,110,81,94
2018,Virginia,51,Some Other Race ,51441,22023,29418,1521,1055,1353
2018,Washington,53,Some Other Race ,80898,32183,48715,2158,1324,1809
2018,West Virginia,54,Some Other Race ,1850,772,1078,394,216,268
2018,Wisconsin,55,Some Other Race ,32761,11644,21117,1033,699,787
2018,Wyoming,56,Some Other Race ,2893,1329,1564,449,242,347
2018,Puerto Rico,72,Some Other Race ,194665,118394,76271,2684,1986,1957
2019,Alabama,01,Some Other Race ,17117,7595,9522,773,622,819
2019,Alaska,02,Some Other Race ,3487,1572,1915,489,338,357
2019,Arizona,04,Some Other Race ,124247,65036,59211,2819,1867,1928
2019,Arkansas,05,Some Other Race ,22072,11396,10676,1051,748,858
2019,California,06,Some Other Race ,1347444,532881,814563,8015,4679,7623
2019,Colorado,08,Some Other Race ,63701,29098,34603,1758,1200,1358
2019,Connecticut,09,Some Other Race ,57548,15877,41671,1761,833,1606
2019,Delaware,10,Some Other Race ,4550,2196,2354,446,257,367
2019,District of Columbia,11,Some Other Race ,9551,1854,7697,714,298,703
2019,Florida,12,Some Other Race ,176309,76981,99328,3459,1977,2997
2019,Georgia,13,Some Other Race ,73577,30792,42785,1942,1509,1433
2019,Hawaii,15,Some Other Race ,4619,1213,3406,554,240,461
2019,Idaho,16,Some Other Race ,16043,8870,7173,921,660,787
2019,Illinois,17,Some Other Race ,199860,98478,101382,2752,2150,2519
2019,Indiana,18,Some Other Race ,40750,20106,20644,1346,1006,1063
2019,Iowa,19,Some Other Race ,10926,5079,5847,620,431,521
2019,Kansas,20,Some Other Race ,19859,11149,8710,1027,781,661
2019,Kentucky,21,Some Other Race ,10588,2936,7652,677,385,621
2019,Louisiana,22,Some Other Race ,19249,7108,12141,1098,686,793
2019,Maine,23,Some Other Race ,882,544,338,182,169,128
2019,Maryland,24,Some Other Race ,61746,26072,35674,1563,920,1277
2019,Massachusetts,25,Some Other Race ,90075,23031,67044,1885,1066,1804
2019,Michigan,26,Some Other Race ,34198,18410,15788,1234,920,936
2019,Minnesota,27,Some Other Race ,26775,11117,15658,1083,558,876
2019,Mississippi,28,Some Other Race ,7420,3348,4072,513,369,435
2019,Missouri,29,Some Other Race ,19019,8110,10909,929,577,796
2019,Montana,30,Some Other Race ,1907,1079,828,313,227,214
2019,Nebraska,31,Some Other Race ,11285,5553,5732,780,530,525
2019,Nevada,32,Some Other Race ,83425,33307,50118,1875,1353,1708
2019,New Hampshire,33,Some Other Race ,2046,798,1248,301,213,253
2019,New Jersey,34,Some Other Race ,162723,49201,113522,2939,1689,2508
2019,New Mexico,35,Some Other Race ,61562,39902,21660,1707,1321,1234
2019,New York,36,Some Other Race ,510187,95888,414299,5963,2449,5213
2019,North Carolina,37,Some Other Race ,81114,34409,46705,2154,1462,1651
2019,North Dakota,38,Some Other Race ,2588,603,1985,436,156,414
2019,Ohio,39,Some Other Race ,34216,13061,21155,1407,778,1146
2019,Oklahoma,40,Some Other Race ,29429,15400,14029,907,664,707
2019,Oregon,41,Some Other Race ,32224,14010,18214,1290,876,1008
2019,Pennsylvania,42,Some Other Race ,80776,31804,48972,2183,1225,1790
2019,Rhode Island,44,Some Other Race ,17325,4920,12405,805,492,865
2019,South Carolina,45,Some Other Race ,23011,9816,13195,1230,798,914
2019,South Dakota,46,Some Other Race ,2299,771,1528,354,160,325
2019,Tennessee,47,Some Other Race ,22936,8553,14383,1084,647,921
2019,Texas,48,Some Other Race ,464445,244371,220074,5463,4433,4350
2019,Utah,49,Some Other Race ,37703,18179,19524,1377,967,1105
2019,Vermont,50,Some Other Race ,547,270,277,121,87,106
2019,Virginia,51,Some Other Race ,55426,24239,31187,1756,1172,1429
2019,Washington,53,Some Other Race ,87171,35290,51881,2256,1350,1717
2019,West Virginia,54,Some Other Race ,2133,953,1180,343,219,277
2019,Wisconsin,55,Some Other Race ,34076,12747,21329,1261,727,1003
2019,Wyoming,56,Some Other Race ,2467,1261,1206,395,244,291
2019,Puerto Rico,72,Some Other Race ,198015,119028,78987,2953,2281,2086
2020,Alabama,01,Some Other Race ,18991,9608,9383,924,748,839
2020,Alaska,02,Some Other Race ,3502,2044,1458,463,352,291
2020,Arizona,04,Some Other Race ,131499,70926,60573,4128,2706,3445
2020,Arkansas,05,Some Other Race ,24807,12574,12233,1529,1089,1136
2020,California,06,Some Other Race ,1397210,576852,820358,8309,5103,8014
2020,Colorado,08,Some Other Race ,66326,31832,34494,1869,1326,1451
2020,Connecticut,09,Some Other Race ,60873,17986,42887,2053,1266,1848
2020,Delaware,10,Some Other Race ,6119,3465,2654,969,903,452
2020,District of Columbia,11,Some Other Race ,9032,1745,7287,779,330,723
2020,Florida,12,Some Other Race ,202606,96427,106179,4197,3513,2813
2020,Georgia,13,Some Other Race ,79728,35537,44191,2617,1906,2288
2020,Hawaii,15,Some Other Race ,5306,1552,3754,590,277,521
2020,Idaho,16,Some Other Race ,18239,10146,8093,1131,781,874
2020,Illinois,17,Some Other Race ,205913,107164,98749,3483,2398,2875
2020,Indiana,18,Some Other Race ,46322,23992,22330,2136,1473,1449
2020,Iowa,19,Some Other Race ,10770,5385,5385,725,480,595
2020,Kansas,20,Some Other Race ,22968,12902,10066,1206,1018,835
2020,Kentucky,21,Some Other Race ,11907,4138,7769,876,552,691
2020,Louisiana,22,Some Other Race ,20723,7996,12727,1242,849,884
2020,Maine,23,Some Other Race ,1233,855,378,327,296,140
2020,Maryland,24,Some Other Race ,67414,31617,35797,1838,1374,1218
2020,Massachusetts,25,Some Other Race ,90511,25664,64847,2407,1598,1845
2020,Michigan,26,Some Other Race ,41312,25266,16046,2513,2193,1113
2020,Minnesota,27,Some Other Race ,31056,14959,16097,1674,1016,1069
2020,Mississippi,28,Some Other Race ,8528,4253,4275,768,663,530
2020,Missouri,29,Some Other Race ,20391,9456,10935,1131,811,861
2020,Montana,30,Some Other Race ,2397,1342,1055,358,331,243
2020,Nebraska,31,Some Other Race ,13868,7234,6634,798,620,660
2020,Nevada,32,Some Other Race ,89842,37406,52436,2374,1521,1936
2020,New Hampshire,33,Some Other Race ,2916,1247,1669,465,267,399
2020,New Jersey,34,Some Other Race ,166076,53900,112176,3230,1753,3013
2020,New Mexico,35,Some Other Race ,65381,44005,21376,1946,1732,1337
2020,New York,36,Some Other Race ,510984,103961,407023,5784,3103,5402
2020,North Carolina,37,Some Other Race ,88307,41870,46437,2375,2095,1738
2020,North Dakota,38,Some Other Race ,3155,832,2323,441,208,393
2020,Ohio,39,Some Other Race ,39058,16918,22140,1920,1689,1260
2020,Oklahoma,40,Some Other Race ,30325,16549,13776,1243,826,878
2020,Oregon,41,Some Other Race ,37232,15608,21624,1939,1145,1409
2020,Pennsylvania,42,Some Other Race ,96307,42814,53493,3829,3059,2904
2020,Rhode Island,44,Some Other Race ,18516,6282,12234,1130,645,873
2020,South Carolina,45,Some Other Race ,25798,11794,14004,1367,961,1131
2020,South Dakota,46,Some Other Race ,2350,984,1366,357,180,294
2020,Tennessee,47,Some Other Race ,25675,11017,14658,1509,1227,944
2020,Texas,48,Some Other Race ,511052,275447,235605,5720,5275,3527
2020,Utah,49,Some Other Race ,38349,19766,18583,1436,1111,1129
2020,Vermont,50,Some Other Race ,783,432,351,230,187,133
2020,Virginia,51,Some Other Race ,61351,28355,32996,2138,1511,1768
2020,Washington,53,Some Other Race ,94378,40405,53973,2168,1535,1418
2020,West Virginia,54,Some Other Race ,2578,1132,1446,525,281,427
2020,Wisconsin,55,Some Other Race ,39654,17300,22354,2449,1785,1406
2020,Wyoming,56,Some Other Race ,2957,1552,1405,449,269,391
2020,Puerto Rico,72,Some Other Race ,225376,136250,89126,3058,2512,1918
2010,Alabama,01,Two or More Races ,17541,11279,6262,736,646,505
2010,Alaska,02,Two or More Races ,11787,5924,5863,735,530,589
2010,Arizona,04,Two or More Races ,35946,19396,16550,1283,917,992
2010,Arkansas,05,Two or More Races ,14563,8581,5982,632,498,509
2010,California,06,Two or More Races ,294525,146964,147561,5360,3326,3635
2010,Colorado,08,Two or More Races ,36810,20029,16781,1133,876,759
2010,Connecticut,09,Two or More Races ,16627,8221,8406,906,623,733
2010,Delaware,10,Two or More Races ,3884,2156,1728,376,264,300
2010,District of Columbia,11,Two or More Races ,4201,1816,2385,471,279,355
2010,Florida,12,Two or More Races ,88751,54379,34372,2137,1772,1261
2010,Georgia,13,Two or More Races ,33125,19910,13215,1400,1121,891
2010,Hawaii,15,Two or More Races ,67028,35183,31845,1813,1323,1312
2010,Idaho,16,Two or More Races ,9159,5217,3942,595,450,432
2010,Illinois,17,Two or More Races ,45069,25237,19832,1658,1243,974
2010,Indiana,18,Two or More Races ,25530,14841,10689,1034,850,700
2010,Iowa,19,Two or More Races ,9841,5063,4778,642,427,425
2010,Kansas,20,Two or More Races ,18113,9732,8381,805,579,603
2010,Kentucky,21,Two or More Races ,14670,8106,6564,902,715,595
2010,Louisiana,22,Two or More Races ,14152,8692,5460,781,510,539
2010,Maine,23,Two or More Races ,5367,2576,2791,410,238,344
2010,Maryland,24,Two or More Races ,29841,17552,12289,1224,1031,774
2010,Massachusetts,25,Two or More Races ,35533,13185,22348,1259,804,1033
2010,Michigan,26,Two or More Races ,46270,27079,19191,1555,1057,956
2010,Minnesota,27,Two or More Races ,21085,11596,9489,870,744,597
2010,Mississippi,28,Two or More Races ,6891,4355,2536,569,469,373
2010,Missouri,29,Two or More Races ,31655,17326,14329,1123,811,807
2010,Montana,30,Two or More Races ,5662,2873,2789,499,354,364
2010,Nebraska,31,Two or More Races ,8582,3869,4713,667,377,470
2010,Nevada,32,Two or More Races ,21082,10969,10113,1013,649,720
2010,New Hampshire,33,Two or More Races ,4443,2639,1804,411,284,292
2010,New Jersey,34,Two or More Races ,40119,19991,20128,1590,953,1014
2010,New Mexico,35,Two or More Races ,15670,9584,6086,949,644,633
2010,New York,36,Two or More Races ,102179,37360,64819,2568,1400,1906
2010,North Carolina,37,Two or More Races ,38704,19961,18743,1485,1014,1036
2010,North Dakota,38,Two or More Races ,2210,919,1291,341,181,288
2010,Ohio,39,Two or More Races ,45387,23523,21864,1465,1097,1056
2010,Oklahoma,40,Two or More Races ,74890,44977,29913,1477,1212,1177
2010,Oregon,41,Two or More Races ,32666,15568,17098,1158,806,922
2010,Pennsylvania,42,Two or More Races ,41752,20960,20792,1301,954,921
2010,Rhode Island,44,Two or More Races ,5982,2483,3499,482,334,394
2010,South Carolina,45,Two or More Races ,14586,8180,6406,818,643,564
2010,South Dakota,46,Two or More Races ,3112,1482,1630,435,303,322
2010,Tennessee,47,Two or More Races ,23682,14912,8770,933,808,612
2010,Texas,48,Two or More Races ,119980,70842,49138,2716,1981,1721
2010,Utah,49,Two or More Races ,9059,5385,3674,606,411,493
2010,Vermont,50,Two or More Races ,3049,1483,1566,249,188,217
2010,Virginia,51,Two or More Races ,38935,22026,16909,1486,1037,934
2010,Washington,53,Two or More Races ,64537,32143,32394,1738,1098,1108
2010,West Virginia,54,Two or More Races ,7932,4019,3913,606,416,415
2010,Wisconsin,55,Two or More Races ,19023,9359,9664,920,622,591
2010,Wyoming,56,Two or More Races ,3996,2255,1741,405,298,292
2010,Puerto Rico,72,Two or More Races ,98284,64512,33772,1788,1570,1234
2011,Alabama,01,Two or More Races ,17798,11402,6396,843,608,538
2011,Alaska,02,Two or More Races ,11915,5724,6191,721,456,557
2011,Arizona,04,Two or More Races ,36645,19650,16995,1550,1121,951
2011,Arkansas,05,Two or More Races ,14926,8771,6155,737,508,541
2011,California,06,Two or More Races ,316870,155126,161744,5802,3498,3516
2011,Colorado,08,Two or More Races ,38264,20316,17948,1371,1034,1036
2011,Connecticut,09,Two or More Races ,17815,8751,9064,873,541,655
2011,Delaware,10,Two or More Races ,3986,2372,1614,399,284,262
2011,District of Columbia,11,Two or More Races ,4532,1750,2782,403,270,365
2011,Florida,12,Two or More Races ,90460,55602,34858,2852,2076,1526
2011,Georgia,13,Two or More Races ,35044,20920,14124,1612,1154,836
2011,Hawaii,15,Two or More Races ,69883,36214,33669,1867,1296,1522
2011,Idaho,16,Two or More Races ,8850,4953,3897,600,398,436
2011,Illinois,17,Two or More Races ,48365,25990,22375,1551,1032,1207
2011,Indiana,18,Two or More Races ,27000,15255,11745,1142,687,779
2011,Iowa,19,Two or More Races ,10118,4891,5227,655,450,505
2011,Kansas,20,Two or More Races ,19458,10425,9033,920,658,658
2011,Kentucky,21,Two or More Races ,15521,8282,7239,833,660,541
2011,Louisiana,22,Two or More Races ,16004,9664,6340,956,717,534
2011,Maine,23,Two or More Races ,5759,2744,3015,370,225,338
2011,Maryland,24,Two or More Races ,30632,17795,12837,1292,968,882
2011,Massachusetts,25,Two or More Races ,39123,14449,24674,1371,963,1070
2011,Michigan,26,Two or More Races ,48767,28097,20670,1189,1137,924
2011,Minnesota,27,Two or More Races ,22282,11975,10307,974,651,697
2011,Mississippi,28,Two or More Races ,7485,4902,2583,656,482,394
2011,Missouri,29,Two or More Races ,32483,17488,14995,1162,862,888
2011,Montana,30,Two or More Races ,5993,3179,2814,514,387,409
2011,Nebraska,31,Two or More Races ,8843,4266,4577,624,483,425
2011,Nevada,32,Two or More Races ,21871,11399,10472,1256,872,834
2011,New Hampshire,33,Two or More Races ,5029,3117,1912,437,322,321
2011,New Jersey,34,Two or More Races ,44713,21840,22873,1408,1000,1076
2011,New Mexico,35,Two or More Races ,15530,9282,6248,846,678,629
2011,New York,36,Two or More Races ,111039,40284,70755,2516,1542,1853
2011,North Carolina,37,Two or More Races ,41110,21369,19741,1234,917,974
2011,North Dakota,38,Two or More Races ,2304,1035,1269,273,193,224
2011,Ohio,39,Two or More Races ,48023,24203,23820,1241,840,951
2011,Oklahoma,40,Two or More Races ,77293,47004,30289,1629,1270,1075
2011,Oregon,41,Two or More Races ,34053,15988,18065,1186,815,975
2011,Pennsylvania,42,Two or More Races ,45209,22572,22637,1423,947,1000
2011,Rhode Island,44,Two or More Races ,6186,2749,3437,600,341,424
2011,South Carolina,45,Two or More Races ,14831,8319,6512,810,639,594
2011,South Dakota,46,Two or More Races ,3365,1643,1722,447,226,332
2011,Tennessee,47,Two or More Races ,24663,15448,9215,1042,874,604
2011,Texas,48,Two or More Races ,128696,74747,53949,3212,2134,2009
2011,Utah,49,Two or More Races ,10213,5737,4476,646,500,414
2011,Vermont,50,Two or More Races ,3230,1638,1592,264,192,225
2011,Virginia,51,Two or More Races ,42033,23583,18450,1673,1247,987
2011,Washington,53,Two or More Races ,68261,33547,34714,1980,1285,1377
2011,West Virginia,54,Two or More Races ,8610,4534,4076,569,424,474
2011,Wisconsin,55,Two or More Races ,19884,9412,10472,922,681,741
2011,Wyoming,56,Two or More Races ,3994,2306,1688,486,338,320
2011,Puerto Rico,72,Two or More Races ,119970,76922,43048,2340,1735,1508
2012,Alabama,01,Two or More Races ,17765,11105,6660,699,566,507
2012,Alaska,02,Two or More Races ,12376,6076,6300,717,457,564
2012,Arizona,04,Two or More Races ,38611,20565,18046,1617,1054,1139
2012,Arkansas,05,Two or More Races ,15672,9529,6143,899,641,626
2012,California,06,Two or More Races ,337999,163131,174868,5401,3520,3283
2012,Colorado,08,Two or More Races ,40217,21370,18847,1474,1022,1014
2012,Connecticut,09,Two or More Races ,19381,9433,9948,913,661,700
2012,Delaware,10,Two or More Races ,4221,2505,1716,447,327,319
2012,District of Columbia,11,Two or More Races ,4726,1817,2909,483,312,374
2012,Florida,12,Two or More Races ,96392,57974,38418,2621,1889,1634
2012,Georgia,13,Two or More Races ,38296,21700,16596,1686,1169,1119
2012,Hawaii,15,Two or More Races ,70336,36228,34108,1466,1097,1261
2012,Idaho,16,Two or More Races ,9161,5511,3650,622,513,472
2012,Illinois,17,Two or More Races ,51352,27237,24115,1840,1195,1136
2012,Indiana,18,Two or More Races ,27401,15181,12220,919,829,715
2012,Iowa,19,Two or More Races ,10855,5103,5752,646,501,479
2012,Kansas,20,Two or More Races ,19253,10043,9210,960,572,743
2012,Kentucky,21,Two or More Races ,16187,8356,7831,853,561,646
2012,Louisiana,22,Two or More Races ,17295,10509,6786,856,650,609
2012,Maine,23,Two or More Races ,6136,2947,3189,445,276,362
2012,Maryland,24,Two or More Races ,32635,18710,13925,1315,877,1046
2012,Massachusetts,25,Two or More Races ,41777,14964,26813,1380,893,1045
2012,Michigan,26,Two or More Races ,50443,28369,22074,1319,969,1077
2012,Minnesota,27,Two or More Races ,23383,11976,11407,1009,612,839
2012,Mississippi,28,Two or More Races ,7955,5141,2814,693,549,426
2012,Missouri,29,Two or More Races ,32287,17146,15141,1152,877,807
2012,Montana,30,Two or More Races ,6232,3237,2995,456,325,370
2012,Nebraska,31,Two or More Races ,8867,4199,4668,585,408,497
2012,Nevada,32,Two or More Races ,23404,11530,11874,1241,845,896
2012,New Hampshire,33,Two or More Races ,5555,3295,2260,451,334,336
2012,New Jersey,34,Two or More Races ,48157,22931,25226,1469,1055,1047
2012,New Mexico,35,Two or More Races ,15978,9463,6515,815,617,564
2012,New York,36,Two or More Races ,119993,42839,77154,2743,1395,2089
2012,North Carolina,37,Two or More Races ,43239,22349,20890,1651,1166,1080
2012,North Dakota,38,Two or More Races ,2363,1168,1195,308,201,227
2012,Ohio,39,Two or More Races ,51477,24829,26648,1822,1213,1234
2012,Oklahoma,40,Two or More Races ,78566,47288,31278,1569,1222,982
2012,Oregon,41,Two or More Races ,34979,16614,18365,1413,823,975
2012,Pennsylvania,42,Two or More Races ,48492,23971,24521,1460,1036,1033
2012,Rhode Island,44,Two or More Races ,6290,2593,3697,543,334,411
2012,South Carolina,45,Two or More Races ,16480,9028,7452,822,658,637
2012,South Dakota,46,Two or More Races ,3280,1546,1734,436,280,335
2012,Tennessee,47,Two or More Races ,27046,15715,11331,1019,769,703
2012,Texas,48,Two or More Races ,134879,76392,58487,2947,2188,1653
2012,Utah,49,Two or More Races ,11104,5954,5150,715,510,553
2012,Vermont,50,Two or More Races ,3018,1567,1451,249,201,202
2012,Virginia,51,Two or More Races ,45791,24813,20978,1718,1089,1285
2012,Washington,53,Two or More Races ,73158,35719,37439,1787,1169,1245
2012,West Virginia,54,Two or More Races ,8978,4733,4245,549,400,375
2012,Wisconsin,55,Two or More Races ,21432,9641,11791,960,542,713
2012,Wyoming,56,Two or More Races ,4013,2296,1717,447,344,256
2012,Puerto Rico,72,Two or More Races ,135195,85107,50088,1960,1829,1413
2013,Alabama,01,Two or More Races ,18336,11698,6638,847,625,512
2013,Alaska,02,Two or More Races ,12101,5724,6377,684,509,597
2013,Arizona,04,Two or More Races ,40543,21124,19419,1459,1137,997
2013,Arkansas,05,Two or More Races ,16049,9711,6338,714,650,525
2013,California,06,Two or More Races ,360027,168572,191455,4948,3301,3025
2013,Colorado,08,Two or More Races ,42468,21991,20477,1456,1055,936
2013,Connecticut,09,Two or More Races ,19859,9646,10213,811,541,702
2013,Delaware,10,Two or More Races ,4610,2568,2042,433,342,314
2013,District of Columbia,11,Two or More Races ,5448,1987,3461,442,285,408
2013,Florida,12,Two or More Races ,101804,59435,42369,2756,2021,1783
2013,Georgia,13,Two or More Races ,40772,22813,17959,1737,1268,1153
2013,Hawaii,15,Two or More Races ,71694,37023,34671,1484,1104,1182
2013,Idaho,16,Two or More Races ,9075,5155,3920,577,486,470
2013,Illinois,17,Two or More Races ,55454,28864,26590,1791,1227,1129
2013,Indiana,18,Two or More Races ,27472,15104,12368,1109,752,831
2013,Iowa,19,Two or More Races ,11373,5133,6240,688,431,484
2013,Kansas,20,Two or More Races ,19408,9967,9441,969,633,718
2013,Kentucky,21,Two or More Races ,17228,8849,8379,873,606,681
2013,Louisiana,22,Two or More Races ,18616,10603,8013,877,652,615
2013,Maine,23,Two or More Races ,6152,2958,3194,459,278,364
2013,Maryland,24,Two or More Races ,34608,19555,15053,1482,958,1075
2013,Massachusetts,25,Two or More Races ,44287,15530,28757,1417,786,1189
2013,Michigan,26,Two or More Races ,52939,28849,24090,1459,920,1223
2013,Minnesota,27,Two or More Races ,25150,12276,12874,1011,717,747
2013,Mississippi,28,Two or More Races ,7990,5133,2857,605,444,433
2013,Missouri,29,Two or More Races ,31755,16647,15108,1197,848,900
2013,Montana,30,Two or More Races ,6354,3320,3034,500,344,365
2013,Nebraska,31,Two or More Races ,8820,4166,4654,599,372,462
2013,Nevada,32,Two or More Races ,24910,11925,12985,1009,831,747
2013,New Hampshire,33,Two or More Races ,5535,3079,2456,493,360,397
2013,New Jersey,34,Two or More Races ,49681,23616,26065,1446,1046,1001
2013,New Mexico,35,Two or More Races ,16336,9687,6649,850,637,564
2013,New York,36,Two or More Races ,127529,45243,82286,2433,1427,2194
2013,North Carolina,37,Two or More Races ,46221,23440,22781,1483,1043,1181
2013,North Dakota,38,Two or More Races ,2780,1394,1386,303,230,249
2013,Ohio,39,Two or More Races ,54897,25999,28898,1492,1012,1171
2013,Oklahoma,40,Two or More Races ,79318,47227,32091,1352,1032,982
2013,Oregon,41,Two or More Races ,37174,17583,19591,1324,759,1153
2013,Pennsylvania,42,Two or More Races ,50339,24097,26242,1477,973,996
2013,Rhode Island,44,Two or More Races ,6322,2549,3773,560,329,446
2013,South Carolina,45,Two or More Races ,16811,9081,7730,994,768,655
2013,South Dakota,46,Two or More Races ,3841,1758,2083,434,308,296
2013,Tennessee,47,Two or More Races ,28291,15537,12754,999,695,795
2013,Texas,48,Two or More Races ,144538,78808,65730,3233,2317,1743
2013,Utah,49,Two or More Races ,11448,5943,5505,752,464,548
2013,Vermont,50,Two or More Races ,3166,1729,1437,276,189,216
2013,Virginia,51,Two or More Races ,49715,26778,22937,1622,1183,1133
2013,Washington,53,Two or More Races ,75579,35940,39639,1820,1389,1416
2013,West Virginia,54,Two or More Races ,9101,4763,4338,674,434,448
2013,Wisconsin,55,Two or More Races ,23145,10090,13055,871,624,700
2013,Wyoming,56,Two or More Races ,3892,2208,1684,360,314,276
2013,Puerto Rico,72,Two or More Races ,139294,87634,51660,2191,1823,1356
2014,Alabama,01,Two or More Races ,18403,11590,6813,913,642,604
2014,Alaska,02,Two or More Races ,12114,5508,6606,668,459,479
2014,Arizona,04,Two or More Races ,42835,21935,20900,1774,1278,1101
2014,Arkansas,05,Two or More Races ,16317,9854,6463,856,640,610
2014,California,06,Two or More Races ,378007,173851,204156,5520,3687,3436
2014,Colorado,08,Two or More Races ,44666,22566,22100,1505,962,1071
2014,Connecticut,09,Two or More Races ,21389,9798,11591,1103,700,807
2014,Delaware,10,Two or More Races ,4611,2462,2149,404,301,313
2014,District of Columbia,11,Two or More Races ,5691,1832,3859,544,260,483
2014,Florida,12,Two or More Races ,106482,59852,46630,3173,2186,1880
2014,Georgia,13,Two or More Races ,42534,22906,19628,1711,1275,1146
2014,Hawaii,15,Two or More Races ,70649,36932,33717,1613,1168,1107
2014,Idaho,16,Two or More Races ,9093,5160,3933,649,479,417
2014,Illinois,17,Two or More Races ,59299,30281,29018,1594,1317,1132
2014,Indiana,18,Two or More Races ,28500,15287,13213,1185,781,843
2014,Iowa,19,Two or More Races ,11595,5151,6444,690,430,546
2014,Kansas,20,Two or More Races ,19924,10066,9858,941,574,779
2014,Kentucky,21,Two or More Races ,18395,9261,9134,933,642,689
2014,Louisiana,22,Two or More Races ,19134,10735,8399,888,539,782
2014,Maine,23,Two or More Races ,6431,3138,3293,383,252,359
2014,Maryland,24,Two or More Races ,36788,21335,15453,1193,887,924
2014,Massachusetts,25,Two or More Races ,45945,15717,30228,1460,901,1288
2014,Michigan,26,Two or More Races ,55050,30394,24656,1492,872,972
2014,Minnesota,27,Two or More Races ,26661,12673,13988,1084,645,791
2014,Mississippi,28,Two or More Races ,7475,4555,2920,555,444,360
2014,Missouri,29,Two or More Races ,33088,17396,15692,1040,799,929
2014,Montana,30,Two or More Races ,6459,3474,2985,464,411,331
2014,Nebraska,31,Two or More Races ,8737,3833,4904,587,360,461
2014,Nevada,32,Two or More Races ,25829,11903,13926,1137,747,903
2014,New Hampshire,33,Two or More Races ,6046,3127,2919,535,373,422
2014,New Jersey,34,Two or More Races ,50219,24438,25781,1458,1009,1204
2014,New Mexico,35,Two or More Races ,17023,9930,7093,941,702,615
2014,New York,36,Two or More Races ,134432,47254,87178,2775,1619,2060
2014,North Carolina,37,Two or More Races ,47383,24034,23349,1622,1166,1108
2014,North Dakota,38,Two or More Races ,3257,1558,1699,357,292,269
2014,Ohio,39,Two or More Races ,58447,26963,31484,1664,1141,1164
2014,Oklahoma,40,Two or More Races ,79125,46546,32579,1425,1133,1050
2014,Oregon,41,Two or More Races ,39399,17909,21490,1354,903,1081
2014,Pennsylvania,42,Two or More Races ,54173,25653,28520,1462,984,1059
2014,Rhode Island,44,Two or More Races ,6669,2564,4105,596,327,486
2014,South Carolina,45,Two or More Races ,18282,10201,8081,970,693,729
2014,South Dakota,46,Two or More Races ,4235,1980,2255,424,256,321
2014,Tennessee,47,Two or More Races ,30885,16364,14521,1210,921,786
2014,Texas,48,Two or More Races ,151496,80246,71250,3298,2684,2068
2014,Utah,49,Two or More Races ,11759,5972,5787,684,498,477
2014,Vermont,50,Two or More Races ,3147,1777,1370,266,215,226
2014,Virginia,51,Two or More Races ,53616,28737,24879,1678,1202,1062
2014,Washington,53,Two or More Races ,79187,36794,42393,1786,1063,1543
2014,West Virginia,54,Two or More Races ,9200,4976,4224,581,392,415
2014,Wisconsin,55,Two or More Races ,24165,10468,13697,913,589,649
2014,Wyoming,56,Two or More Races ,3756,1944,1812,390,246,305
2014,Puerto Rico,72,Two or More Races ,130002,81564,48438,2226,1865,1415
2015,Alabama,01,Two or More Races ,20124,12289,7835,802,693,565
2015,Alaska,02,Two or More Races ,12768,6039,6729,782,472,595
2015,Arizona,04,Two or More Races ,45158,22270,22888,1528,954,1232
2015,Arkansas,05,Two or More Races ,16721,10131,6590,805,689,555
2015,California,06,Two or More Races ,386906,174480,212426,4934,3622,3534
2015,Colorado,08,Two or More Races ,44382,22132,22250,1764,1083,1194
2015,Connecticut,09,Two or More Races ,22000,9845,12155,1040,621,871
2015,Delaware,10,Two or More Races ,4789,2505,2284,498,336,345
2015,District of Columbia,11,Two or More Races ,6196,1960,4236,495,275,447
2015,Florida,12,Two or More Races ,110120,61305,48815,2870,2025,1739
2015,Georgia,13,Two or More Races ,46377,24530,21847,1638,1208,1082
2015,Hawaii,15,Two or More Races ,71178,37334,33844,1604,1263,1152
2015,Idaho,16,Two or More Races ,8711,5110,3601,582,554,393
2015,Illinois,17,Two or More Races ,61508,30473,31035,1622,1130,1213
2015,Indiana,18,Two or More Races ,29210,15190,14020,1307,882,945
2015,Iowa,19,Two or More Races ,11534,5359,6175,798,481,582
2015,Kansas,20,Two or More Races ,20082,10228,9854,980,601,758
2015,Kentucky,21,Two or More Races ,19122,9772,9350,949,589,711
2015,Louisiana,22,Two or More Races ,19781,11277,8504,989,799,623
2015,Maine,23,Two or More Races ,6779,3342,3437,407,288,315
2015,Maryland,24,Two or More Races ,37988,21975,16013,1241,866,865
2015,Massachusetts,25,Two or More Races ,46284,16158,30126,1426,953,1214
2015,Michigan,26,Two or More Races ,57013,31103,25910,1361,939,1015
2015,Minnesota,27,Two or More Races ,28664,13426,15238,1061,676,801
2015,Mississippi,28,Two or More Races ,7851,4844,3007,621,471,382
2015,Missouri,29,Two or More Races ,33802,17893,15909,1338,865,866
2015,Montana,30,Two or More Races ,6836,3593,3243,600,398,377
2015,Nebraska,31,Two or More Races ,8483,3846,4637,549,333,445
2015,Nevada,32,Two or More Races ,27356,12161,15195,1196,653,950
2015,New Hampshire,33,Two or More Races ,5867,3001,2866,406,319,323
2015,New Jersey,34,Two or More Races ,50713,24445,26268,1450,1006,896
2015,New Mexico,35,Two or More Races ,17356,9828,7528,886,639,606
2015,New York,36,Two or More Races ,137034,48703,88331,2905,1555,2090
2015,North Carolina,37,Two or More Races ,48416,24781,23635,1734,1135,1226
2015,North Dakota,38,Two or More Races ,3914,1756,2158,444,284,398
2015,Ohio,39,Two or More Races ,62344,27929,34415,1547,1031,1306
2015,Oklahoma,40,Two or More Races ,79768,46262,33506,1336,931,1116
2015,Oregon,41,Two or More Races ,41997,19300,22697,1418,946,1243
2015,Pennsylvania,42,Two or More Races ,56994,26839,30155,1331,1018,1095
2015,Rhode Island,44,Two or More Races ,6771,2621,4150,667,283,555
2015,South Carolina,45,Two or More Races ,18237,9954,8283,926,670,712
2015,South Dakota,46,Two or More Races ,4738,2311,2427,421,285,350
2015,Tennessee,47,Two or More Races ,32172,17003,15169,1284,914,914
2015,Texas,48,Two or More Races ,158777,82555,76222,3402,2248,2313
2015,Utah,49,Two or More Races ,12459,6286,6173,631,463,486
2015,Vermont,50,Two or More Races ,3278,1766,1512,276,215,207
2015,Virginia,51,Two or More Races ,57184,30321,26863,1794,1236,1271
2015,Washington,53,Two or More Races ,83111,38265,44846,1907,1183,1456
2015,West Virginia,54,Two or More Races ,8791,4994,3797,641,466,359
2015,Wisconsin,55,Two or More Races ,24800,10722,14078,978,617,840
2015,Wyoming,56,Two or More Races ,3784,1941,1843,401,283,330
2015,Puerto Rico,72,Two or More Races ,110399,68212,42187,2009,1669,1256
2016,Alabama,01,Two or More Races ,21437,13498,7939,995,690,776
2016,Alaska,02,Two or More Races ,13061,6632,6429,738,524,538
2016,Arizona,04,Two or More Races ,48839,23660,25179,1439,1060,1071
2016,Arkansas,05,Two or More Races ,17791,10411,7380,695,557,546
2016,California,06,Two or More Races ,398780,178359,220421,5237,3507,3423
2016,Colorado,08,Two or More Races ,45176,22733,22443,1353,992,1037
2016,Connecticut,09,Two or More Races ,23071,9927,13144,1022,590,834
2016,Delaware,10,Two or More Races ,5169,2561,2608,467,350,383
2016,District of Columbia,11,Two or More Races ,6392,2091,4301,506,263,408
2016,Florida,12,Two or More Races ,115691,62448,53243,2928,2116,1748
2016,Georgia,13,Two or More Races ,48841,25585,23256,1771,1180,1206
2016,Hawaii,15,Two or More Races ,72451,38258,34193,1562,1218,1242
2016,Idaho,16,Two or More Races ,9535,5446,4089,604,483,430
2016,Illinois,17,Two or More Races ,64622,31839,32783,1718,1217,1332
2016,Indiana,18,Two or More Races ,29449,14918,14531,1301,878,820
2016,Iowa,19,Two or More Races ,12082,5564,6518,661,415,651
2016,Kansas,20,Two or More Races ,20267,10167,10100,865,585,677
2016,Kentucky,21,Two or More Races ,19355,9796,9559,911,590,729
2016,Louisiana,22,Two or More Races ,19332,10999,8333,961,737,589
2016,Maine,23,Two or More Races ,7230,3645,3585,384,301,348
2016,Maryland,24,Two or More Races ,40808,23505,17303,1466,906,1098
2016,Massachusetts,25,Two or More Races ,46930,16463,30467,1414,781,1214
2016,Michigan,26,Two or More Races ,60302,32098,28204,1447,1138,1262
2016,Minnesota,27,Two or More Races ,29903,14144,15759,1113,598,935
2016,Mississippi,28,Two or More Races ,7626,4660,2966,664,557,364
2016,Missouri,29,Two or More Races ,34001,17696,16305,1229,933,750
2016,Montana,30,Two or More Races ,7345,3886,3459,493,351,392
2016,Nebraska,31,Two or More Races ,8938,3989,4949,566,415,466
2016,Nevada,32,Two or More Races ,29227,12634,16593,966,717,738
2016,New Hampshire,33,Two or More Races ,5912,2776,3136,434,339,376
2016,New Jersey,34,Two or More Races ,49940,24610,25330,1412,894,1017
2016,New Mexico,35,Two or More Races ,17322,10019,7303,1070,651,754
2016,New York,36,Two or More Races ,140472,48886,91586,3103,1542,2564
2016,North Carolina,37,Two or More Races ,52095,26211,25884,1774,1263,1181
2016,North Dakota,38,Two or More Races ,4679,1912,2767,452,330,371
2016,Ohio,39,Two or More Races ,65421,28788,36633,1593,1130,1206
2016,Oklahoma,40,Two or More Races ,80231,45656,34575,1143,892,891
2016,Oregon,41,Two or More Races ,45235,21094,24141,1495,976,979
2016,Pennsylvania,42,Two or More Races ,60351,27791,32560,1378,889,1149
2016,Rhode Island,44,Two or More Races ,6798,2404,4394,512,297,450
2016,South Carolina,45,Two or More Races ,19583,10712,8871,938,612,667
2016,South Dakota,46,Two or More Races ,4675,2123,2552,473,319,332
2016,Tennessee,47,Two or More Races ,33081,16428,16653,1074,787,920
2016,Texas,48,Two or More Races ,164987,84753,80234,2989,2090,2254
2016,Utah,49,Two or More Races ,13243,6772,6471,614,455,480
2016,Vermont,50,Two or More Races ,3428,1832,1596,315,212,242
2016,Virginia,51,Two or More Races ,59885,31423,28462,1813,1127,1213
2016,Washington,53,Two or More Races ,88305,39560,48745,1893,1495,1301
2016,West Virginia,54,Two or More Races ,8215,4596,3619,473,369,307
2016,Wisconsin,55,Two or More Races ,25444,10984,14460,1118,628,794
2016,Wyoming,56,Two or More Races ,3877,1953,1924,414,266,303
2016,Puerto Rico,72,Two or More Races ,88019,54622,33397,1902,1393,1235
2017,Alabama,01,Two or More Races ,22813,14204,8609,1054,845,655
2017,Alaska,02,Two or More Races ,13193,6651,6542,791,513,564
2017,Arizona,04,Two or More Races ,52950,25962,26988,1647,1071,1111
2017,Arkansas,05,Two or More Races ,19875,11230,8645,925,636,666
2017,California,06,Two or More Races ,408191,183806,224385,5024,3805,3149
2017,Colorado,08,Two or More Races ,47538,23695,23843,1671,1133,1148
2017,Connecticut,09,Two or More Races ,24180,10307,13873,1026,618,779
2017,Delaware,10,Two or More Races ,5212,2713,2499,538,411,346
2017,District of Columbia,11,Two or More Races ,6809,2331,4478,588,333,460
2017,Florida,12,Two or More Races ,120879,65349,55530,3295,2197,2032
2017,Georgia,13,Two or More Races ,53028,27596,25432,2201,1399,1392
2017,Hawaii,15,Two or More Races ,73153,38927,34226,1478,1374,1254
2017,Idaho,16,Two or More Races ,10609,5405,5204,777,440,566
2017,Illinois,17,Two or More Races ,67613,33664,33949,1651,1295,1127
2017,Indiana,18,Two or More Races ,31924,16589,15335,1280,793,992
2017,Iowa,19,Two or More Races ,12456,5399,7057,673,477,595
2017,Kansas,20,Two or More Races ,21075,10882,10193,940,528,742
2017,Kentucky,21,Two or More Races ,20407,10234,10173,891,713,760
2017,Louisiana,22,Two or More Races ,19720,11198,8522,1015,711,591
2017,Maine,23,Two or More Races ,7713,3992,3721,514,355,418
2017,Maryland,24,Two or More Races ,41697,23855,17842,1476,1093,847
2017,Massachusetts,25,Two or More Races ,48487,18155,30332,1654,930,1305
2017,Michigan,26,Two or More Races ,63109,34013,29096,1502,961,1169
2017,Minnesota,27,Two or More Races ,31621,15421,16200,1276,787,968
2017,Mississippi,28,Two or More Races ,8298,5128,3170,621,533,414
2017,Missouri,29,Two or More Races ,36683,18743,17940,1227,734,943
2017,Montana,30,Two or More Races ,8116,4191,3925,558,394,427
2017,Nebraska,31,Two or More Races ,9514,4287,5227,636,400,431
2017,Nevada,32,Two or More Races ,30993,13894,17099,1198,624,996
2017,New Hampshire,33,Two or More Races ,6297,2998,3299,480,320,387
2017,New Jersey,34,Two or More Races ,51031,25486,25545,1631,1171,1155
2017,New Mexico,35,Two or More Races ,17575,10249,7326,871,660,664
2017,New York,36,Two or More Races ,145016,51055,93961,3055,1453,2429
2017,North Carolina,37,Two or More Races ,54323,27570,26753,1673,1108,1245
2017,North Dakota,38,Two or More Races ,4893,1862,3031,472,304,375
2017,Ohio,39,Two or More Races ,69290,29831,39459,1906,1209,1285
2017,Oklahoma,40,Two or More Races ,81357,46482,34875,1420,992,1157
2017,Oregon,41,Two or More Races ,48445,22495,25950,1309,879,1232
2017,Pennsylvania,42,Two or More Races ,63500,28759,34741,1639,1106,1193
2017,Rhode Island,44,Two or More Races ,6943,2377,4566,612,301,491
2017,South Carolina,45,Two or More Races ,20898,11477,9421,1017,695,768
2017,South Dakota,46,Two or More Races ,5278,2463,2815,507,293,390
2017,Tennessee,47,Two or More Races ,34508,18063,16445,1425,968,991
2017,Texas,48,Two or More Races ,170671,88384,82287,3765,2561,2227
2017,Utah,49,Two or More Races ,14771,7938,6833,690,533,443
2017,Vermont,50,Two or More Races ,3512,2000,1512,234,210,209
2017,Virginia,51,Two or More Races ,63204,33567,29637,1908,1327,1289
2017,Washington,53,Two or More Races ,93520,42201,51319,1853,1431,1576
2017,West Virginia,54,Two or More Races ,7135,4068,3067,562,452,392
2017,Wisconsin,55,Two or More Races ,26666,11652,15014,939,565,711
2017,Wyoming,56,Two or More Races ,4147,2231,1916,481,342,358
2017,Puerto Rico,72,Two or More Races ,70982,44672,26310,1634,1412,1049
2018,Alabama,01,Two or More Races ,23604,14588,9016,1015,793,771
2018,Alaska,02,Two or More Races ,13481,7091,6390,759,549,534
2018,Arizona,04,Two or More Races ,57372,27769,29603,1664,1213,1243
2018,Arkansas,05,Two or More Races ,20917,11468,9449,1143,726,756
2018,California,06,Two or More Races ,423812,193968,229844,5958,3853,3468
2018,Colorado,08,Two or More Races ,48474,25111,23363,1520,1108,1103
2018,Connecticut,09,Two or More Races ,24784,10448,14336,1048,755,850
2018,Delaware,10,Two or More Races ,5128,2841,2287,499,365,339
2018,District of Columbia,11,Two or More Races ,7012,2756,4256,558,354,461
2018,Florida,12,Two or More Races ,126620,68814,57806,3552,2341,2267
2018,Georgia,13,Two or More Races ,57389,29859,27530,1994,1406,1425
2018,Hawaii,15,Two or More Races ,75244,40209,35035,1401,1128,1003
2018,Idaho,16,Two or More Races ,11034,5720,5314,727,483,612
2018,Illinois,17,Two or More Races ,69629,34555,35074,1865,1258,1382
2018,Indiana,18,Two or More Races ,34543,17756,16787,1405,822,1052
2018,Iowa,19,Two or More Races ,12891,5719,7172,822,558,570
2018,Kansas,20,Two or More Races ,22148,11070,11078,1006,703,694
2018,Kentucky,21,Two or More Races ,21264,10261,11003,1050,749,882
2018,Louisiana,22,Two or More Races ,20655,12037,8618,1121,732,714
2018,Maine,23,Two or More Races ,8140,4106,4034,519,340,401
2018,Maryland,24,Two or More Races ,45116,25733,19383,1351,921,945
2018,Massachusetts,25,Two or More Races ,50324,18694,31630,1554,1041,1453
2018,Michigan,26,Two or More Races ,65376,35705,29671,1607,1195,1075
2018,Minnesota,27,Two or More Races ,32668,15853,16815,1415,887,888
2018,Mississippi,28,Two or More Races ,8945,5250,3695,759,556,555
2018,Missouri,29,Two or More Races ,38298,19667,18631,1417,854,1085
2018,Montana,30,Two or More Races ,8422,4414,4008,537,404,413
2018,Nebraska,31,Two or More Races ,10286,4721,5565,638,382,453
2018,Nevada,32,Two or More Races ,33045,14856,18189,1309,793,1025
2018,New Hampshire,33,Two or More Races ,6783,3455,3328,489,374,436
2018,New Jersey,34,Two or More Races ,52515,26494,26021,1571,1168,1194
2018,New Mexico,35,Two or More Races ,17626,10101,7525,899,724,629
2018,New York,36,Two or More Races ,150580,52193,98387,2867,1646,2142
2018,North Carolina,37,Two or More Races ,56386,27961,28425,1870,1366,1301
2018,North Dakota,38,Two or More Races ,5268,2120,3148,563,339,498
2018,Ohio,39,Two or More Races ,72762,30901,41861,1929,1207,1466
2018,Oklahoma,40,Two or More Races ,82118,46621,35497,1315,1044,1008
2018,Oregon,41,Two or More Races ,50730,23777,26953,1602,1237,1224
2018,Pennsylvania,42,Two or More Races ,66210,29753,36457,1680,1150,1429
2018,Rhode Island,44,Two or More Races ,7488,2654,4834,585,321,499
2018,South Carolina,45,Two or More Races ,21553,11998,9555,1094,812,687
2018,South Dakota,46,Two or More Races ,5008,2241,2767,518,270,434
2018,Tennessee,47,Two or More Races ,35006,18440,16566,1477,1058,1062
2018,Texas,48,Two or More Races ,175669,92075,83594,3909,2875,2269
2018,Utah,49,Two or More Races ,16210,8769,7441,854,692,486
2018,Vermont,50,Two or More Races ,3748,2124,1624,297,205,260
2018,Virginia,51,Two or More Races ,67173,35201,31972,1878,1220,1472
2018,Washington,53,Two or More Races ,98390,44698,53692,2127,1332,1839
2018,West Virginia,54,Two or More Races ,7188,4160,3028,558,455,334
2018,Wisconsin,55,Two or More Races ,27359,12346,15013,985,634,841
2018,Wyoming,56,Two or More Races ,4720,2548,2172,572,391,354
2018,Puerto Rico,72,Two or More Races ,60544,37522,23022,1518,1166,935
2019,Alabama,01,Two or More Races ,24269,15198,9071,942,824,671
2019,Alaska,02,Two or More Races ,13841,7475,6366,820,596,574
2019,Arizona,04,Two or More Races ,60915,29898,31017,1723,1121,1402
2019,Arkansas,05,Two or More Races ,21824,11644,10180,981,662,799
2019,California,06,Two or More Races ,437098,201829,235269,6198,3833,3642
2019,Colorado,08,Two or More Races ,51674,26700,24974,1514,1300,1184
2019,Connecticut,09,Two or More Races ,26835,11194,15641,1463,828,1189
2019,Delaware,10,Two or More Races ,5660,3188,2472,529,399,363
2019,District of Columbia,11,Two or More Races ,7702,3179,4523,606,390,483
2019,Florida,12,Two or More Races ,133876,74975,58901,3523,2589,1987
2019,Georgia,13,Two or More Races ,60590,31643,28947,2017,1365,1366
2019,Hawaii,15,Two or More Races ,76517,41704,34813,1517,1166,1043
2019,Idaho,16,Two or More Races ,12089,5946,6143,900,525,696
2019,Illinois,17,Two or More Races ,73372,36654,36718,1912,1076,1566
2019,Indiana,18,Two or More Races ,35481,18263,17218,1445,937,1076
2019,Iowa,19,Two or More Races ,13507,6365,7142,904,537,685
2019,Kansas,20,Two or More Races ,22894,11407,11487,997,660,704
2019,Kentucky,21,Two or More Races ,21205,10256,10949,1071,673,855
2019,Louisiana,22,Two or More Races ,21519,12928,8591,1097,791,636
2019,Maine,23,Two or More Races ,8184,4364,3820,556,431,473
2019,Maryland,24,Two or More Races ,46975,26555,20420,1542,1140,1057
2019,Massachusetts,25,Two or More Races ,52736,20391,32345,1592,910,1371
2019,Michigan,26,Two or More Races ,68060,37047,31013,1711,1333,1212
2019,Minnesota,27,Two or More Races ,34445,16781,17664,1219,870,889
2019,Mississippi,28,Two or More Races ,9040,5276,3764,800,555,574
2019,Missouri,29,Two or More Races ,39370,20085,19285,1526,1080,1053
2019,Montana,30,Two or More Races ,8975,4652,4323,604,433,451
2019,Nebraska,31,Two or More Races ,10839,4959,5880,695,477,469
2019,Nevada,32,Two or More Races ,34475,15694,18781,1416,851,1087
2019,New Hampshire,33,Two or More Races ,6805,3495,3310,499,369,349
2019,New Jersey,34,Two or More Races ,55298,28060,27238,1595,1250,1212
2019,New Mexico,35,Two or More Races ,17541,10130,7411,963,697,658
2019,New York,36,Two or More Races ,158294,54536,103758,3712,1925,2933
2019,North Carolina,37,Two or More Races ,58724,29167,29557,1887,1394,1236
2019,North Dakota,38,Two or More Races ,5451,2203,3248,619,345,475
2019,Ohio,39,Two or More Races ,75948,32161,43787,2069,1213,1856
2019,Oklahoma,40,Two or More Races ,83220,47364,35856,1560,1075,1035
2019,Oregon,41,Two or More Races ,52141,25078,27063,1325,996,1145
2019,Pennsylvania,42,Two or More Races ,69314,31182,38132,2025,1093,1468
2019,Rhode Island,44,Two or More Races ,7984,2789,5195,705,356,597
2019,South Carolina,45,Two or More Races ,22952,12620,10332,1078,758,820
2019,South Dakota,46,Two or More Races ,5016,2278,2738,502,314,405
2019,Tennessee,47,Two or More Races ,35589,18677,16912,1395,1029,996
2019,Texas,48,Two or More Races ,183083,97081,86002,3956,2750,2516
2019,Utah,49,Two or More Races ,17657,9606,8051,998,679,737
2019,Vermont,50,Two or More Races ,3666,2052,1614,299,264,222
2019,Virginia,51,Two or More Races ,70613,36756,33857,1955,1438,1410
2019,Washington,53,Two or More Races ,104964,47978,56986,2310,1593,1801
2019,West Virginia,54,Two or More Races ,6917,3988,2929,474,363,379
2019,Wisconsin,55,Two or More Races ,28044,12650,15394,1047,626,867
2019,Wyoming,56,Two or More Races ,4472,2501,1971,580,425,361
2019,Puerto Rico,72,Two or More Races ,61907,37874,24033,1928,1712,956
2020,Alabama,01,Two or More Races ,32359,20509,11850,1596,1327,866
2020,Alaska,02,Two or More Races ,16252,9314,6938,923,758,581
2020,Arizona,04,Two or More Races ,134977,75360,59617,3804,2500,3046
2020,Arkansas,05,Two or More Races ,33547,18148,15399,1485,1130,1237
2020,California,06,Two or More Races ,760308,369212,391096,8718,6207,6809
2020,Colorado,08,Two or More Races ,90553,49837,40716,2267,1682,1910
2020,Connecticut,09,Two or More Races ,44005,20133,23872,1928,1273,1405
2020,Delaware,10,Two or More Races ,9086,5321,3765,990,777,677
2020,District of Columbia,11,Two or More Races ,10732,4736,5996,1069,738,879
2020,Florida,12,Two or More Races ,369394,206834,162560,5499,4681,4972
2020,Georgia,13,Two or More Races ,96901,54262,42639,3125,2244,2084
2020,Hawaii,15,Two or More Races ,80356,44872,35484,1724,1455,1267
2020,Idaho,16,Two or More Races ,20362,11986,8376,1301,1143,817
2020,Illinois,17,Two or More Races ,136449,71816,64633,3566,2636,2291
2020,Indiana,18,Two or More Races ,52395,28216,24179,2202,1338,1668
2020,Iowa,19,Two or More Races ,20967,10613,10354,1052,775,902
2020,Kansas,20,Two or More Races ,35895,18456,17439,1421,892,1097
2020,Kentucky,21,Two or More Races ,29920,13694,16226,1367,853,1178
2020,Louisiana,22,Two or More Races ,33013,19662,13351,1752,1514,983
2020,Maine,23,Two or More Races ,11142,7106,4036,787,674,461
2020,Maryland,24,Two or More Races ,64866,38317,26549,2220,1874,1376
2020,Massachusetts,25,Two or More Races ,87158,33852,53306,2337,1551,2139
2020,Michigan,26,Two or More Races ,94721,55187,39534,2527,2123,2035
2020,Minnesota,27,Two or More Races ,48510,24770,23740,1731,1107,1162
2020,Mississippi,28,Two or More Races ,12594,8007,4587,997,760,604
2020,Missouri,29,Two or More Races ,57366,31685,25681,2086,1266,1425
2020,Montana,30,Two or More Races ,12055,6526,5529,834,500,651
2020,Nebraska,31,Two or More Races ,18276,8602,9674,855,599,660
2020,Nevada,32,Two or More Races ,60165,28891,31274,2165,1685,1563
2020,New Hampshire,33,Two or More Races ,10404,5103,5301,916,556,701
2020,New Jersey,34,Two or More Races ,115369,56696,58673,2935,2136,2114
2020,New Mexico,35,Two or More Races ,51178,35114,16064,2061,1850,1324
2020,New York,36,Two or More Races ,264354,94511,169843,4875,2689,4422
2020,North Carolina,37,Two or More Races ,88239,45408,42831,2427,2091,1908
2020,North Dakota,38,Two or More Races ,6930,2949,3981,674,433,522
2020,Ohio,39,Two or More Races ,103232,46502,56730,2757,2082,2149
2020,Oklahoma,40,Two or More Races ,95370,55795,39575,1947,1408,1282
2020,Oregon,41,Two or More Races ,72690,35419,37271,2149,1626,1658
2020,Pennsylvania,42,Two or More Races ,105895,52782,53113,3479,2354,2449
2020,Rhode Island,44,Two or More Races ,13387,5578,7809,1164,695,1043
2020,South Carolina,45,Two or More Races ,33654,19224,14430,1361,1270,793
2020,South Dakota,46,Two or More Races ,7231,3692,3539,669,472,531
2020,Tennessee,47,Two or More Races ,53680,28481,25199,1811,1578,1222
2020,Texas,48,Two or More Races ,542992,317870,225122,6742,5574,5637
2020,Utah,49,Two or More Races ,29060,16420,12640,1730,1334,1208
2020,Vermont,50,Two or More Races ,5071,2775,2296,401,335,267
2020,Virginia,51,Two or More Races ,95431,52475,42956,2717,1733,1957
2020,Washington,53,Two or More Races ,137143,65839,71304,2809,2134,2260
2020,West Virginia,54,Two or More Races ,10882,6543,4339,852,610,562
2020,Wisconsin,55,Two or More Races ,44013,22093,21920,1465,1012,1059
2020,Wyoming,56,Two or More Races ,6076,3867,2209,721,579,388
2020,Puerto Rico,72,Two or More Races ,119570,80516,39054,2598,2053,1435
2010,Alabama,01,"White, Not Hispanic or Latino ",1288091,1004516,283575,4090,4286,3543
2010,Alaska,02,"White, Not Hispanic or Latino ",181130,124991,56139,1367,1464,1512
2010,Arizona,04,"White, Not Hispanic or Latino ",1606064,1175592,430472,4847,5967,4306
2010,Arkansas,05,"White, Not Hispanic or Latino ",881252,641729,239523,3030,4338,3021
2010,California,06,"White, Not Hispanic or Latino ",6487457,4256084,2231373,12520,19261,11367
2010,Colorado,08,"White, Not Hispanic or Latino ",1478288,1072784,405504,4324,5674,3723
2010,Connecticut,09,"White, Not Hispanic or Latino ",1049136,812133,237003,2453,3307,2768
2010,Delaware,10,"White, Not Hispanic or Latino ",238522,194064,44458,1375,1588,1419
2010,District of Columbia,11,"White, Not Hispanic or Latino ",97735,51441,46294,937,1030,1079
2010,Florida,12,"White, Not Hispanic or Latino ",4756221,3659316,1096905,15872,18388,8168
2010,Georgia,13,"White, Not Hispanic or Latino ",2124437,1636237,488200,6258,8872,4911
2010,Hawaii,15,"White, Not Hispanic or Latino ",138332,76651,61681,1629,1474,1320
2010,Idaho,16,"White, Not Hispanic or Latino ",507270,370132,137138,2292,2322,2525
2010,Illinois,17,"White, Not Hispanic or Latino ",3386677,2603063,783614,8154,10882,5285
2010,Indiana,18,"White, Not Hispanic or Latino ",2102436,1591977,510459,6472,8357,4213
2010,Iowa,19,"White, Not Hispanic or Latino ",1125120,848061,277059,3262,3932,2681
2010,Kansas,20,"White, Not Hispanic or Latino ",924922,675015,249907,2900,3819,2921
2010,Kentucky,21,"White, Not Hispanic or Latino ",1489760,1090992,398768,4921,5949,4121
2010,Louisiana,22,"White, Not Hispanic or Latino ",1070640,823564,247076,3502,4378,3440
2010,Maine,23,"White, Not Hispanic or Latino ",530846,393952,136894,1905,2539,2231
2010,Maryland,24,"White, Not Hispanic or Latino ",1288218,1001763,286455,3625,4423,3386
2010,Massachusetts,25,"White, Not Hispanic or Latino ",2047226,1440106,607120,4670,6403,4913
2010,Michigan,26,"White, Not Hispanic or Latino ",3086667,2458676,627991,8445,10348,4536
2010,Minnesota,27,"White, Not Hispanic or Latino ",1844442,1443067,401375,4774,5277,2760
2010,Mississippi,28,"White, Not Hispanic or Latino ",677651,534092,143559,2568,3306,2337
2010,Missouri,29,"White, Not Hispanic or Latino ",1970593,1466393,504200,5036,7067,4213
2010,Montana,30,"White, Not Hispanic or Latino ",368095,261261,106834,1670,2055,1867
2010,Nebraska,31,"White, Not Hispanic or Latino ",623287,448319,174968,2283,2574,2283
2010,Nevada,32,"White, Not Hispanic or Latino ",635978,421909,214069,3318,3726,2952
2010,New Hampshire,33,"White, Not Hispanic or Latino ",486047,359181,126866,2064,2446,1957
2010,New Jersey,34,"White, Not Hispanic or Latino ",2101136,1640832,460304,4324,6408,4460
2010,New Mexico,35,"White, Not Hispanic or Latino ",382220,279642,102578,2008,2315,1854
2010,New York,36,"White, Not Hispanic or Latino ",4673820,3155003,1518817,9502,12475,8240
2010,North Carolina,37,"White, Not Hispanic or Latino ",2563787,1938459,625328,5838,8764,5884
2010,North Dakota,38,"White, Not Hispanic or Latino ",255708,175801,79907,1354,1424,1367
2010,Ohio,39,"White, Not Hispanic or Latino ",3806768,2827085,979683,9163,12921,6982
2010,Oklahoma,40,"White, Not Hispanic or Latino ",1071536,781648,289888,3755,4367,3532
2010,Oregon,41,"White, Not Hispanic or Latino ",1279614,853189,426425,3826,5115,3057
2010,Pennsylvania,42,"White, Not Hispanic or Latino ",4136417,3122592,1013825,7989,11746,6597
2010,Rhode Island,44,"White, Not Hispanic or Latino ",338953,231911,107042,1602,1900,1799
2010,South Carolina,45,"White, Not Hispanic or Latino ",1192163,924903,267260,4064,5291,3726
2010,South Dakota,46,"White, Not Hispanic or Latino ",285861,205358,80503,1463,1688,1322
2010,Tennessee,47,"White, Not Hispanic or Latino ",1945223,1455390,489833,5257,7453,5120
2010,Texas,48,"White, Not Hispanic or Latino ",4664852,3390883,1273969,9866,13643,7687
2010,Utah,49,"White, Not Hispanic or Latino ",734771,546778,187993,2358,3362,2510
2010,Vermont,50,"White, Not Hispanic or Latino ",246576,178081,68495,1157,1437,1338
2010,Virginia,51,"White, Not Hispanic or Latino ",2097810,1574918,522892,6598,8279,4686
2010,Washington,53,"White, Not Hispanic or Latino ",2064893,1417946,646947,5029,6688,5230
2010,West Virginia,54,"White, Not Hispanic or Latino ",700569,532365,168204,2472,2865,2605
2010,Wisconsin,55,"White, Not Hispanic or Latino ",2005203,1471457,533746,8952,8710,3419
2010,Wyoming,56,"White, Not Hispanic or Latino ",195169,140300,54869,1233,1428,1479
2010,Puerto Rico,72,"White, Not Hispanic or Latino ",12119,8479,3640,634,534,351
2011,Alabama,01,"White, Not Hispanic or Latino ",1290124,1001626,288498,4015,5597,3902
2011,Alaska,02,"White, Not Hispanic or Latino ",184871,126965,57906,1144,1274,1394
2011,Arizona,04,"White, Not Hispanic or Latino ",1609555,1166420,443135,5113,7087,4992
2011,Arkansas,05,"White, Not Hispanic or Latino ",882573,642028,240545,3182,3687,2754
2011,California,06,"White, Not Hispanic or Latino ",6448915,4201077,2247838,12423,18821,11182
2011,Colorado,08,"White, Not Hispanic or Latino ",1494644,1072885,421759,4201,5758,3576
2011,Connecticut,09,"White, Not Hispanic or Latino ",1044345,808414,235931,2885,3686,2892
2011,Delaware,10,"White, Not Hispanic or Latino ",237932,192138,45794,1411,1549,1343
2011,District of Columbia,11,"White, Not Hispanic or Latino ",101483,51830,49653,1197,907,1221
2011,Florida,12,"White, Not Hispanic or Latino ",4723216,3604657,1118559,15934,18948,7380
2011,Georgia,13,"White, Not Hispanic or Latino ",2128127,1632441,495686,6018,8281,4935
2011,Hawaii,15,"White, Not Hispanic or Latino ",138939,76155,62784,1374,1479,1527
2011,Idaho,16,"White, Not Hispanic or Latino ",511065,370972,140093,2151,2734,1984
2011,Illinois,17,"White, Not Hispanic or Latino ",3376007,2584356,791651,8395,10914,5987
2011,Indiana,18,"White, Not Hispanic or Latino ",2104353,1585844,518509,5917,7774,4413
2011,Iowa,19,"White, Not Hispanic or Latino ",1125188,847634,277554,3372,3761,2525
2011,Kansas,20,"White, Not Hispanic or Latino ",923978,670837,253141,3113,3988,2591
2011,Kentucky,21,"White, Not Hispanic or Latino ",1490883,1087214,403669,5048,6399,4035
2011,Louisiana,22,"White, Not Hispanic or Latino ",1082594,830679,251915,3456,4186,3276
2011,Maine,23,"White, Not Hispanic or Latino ",531296,391848,139448,2047,2201,2272
2011,Maryland,24,"White, Not Hispanic or Latino ",1280249,994634,285615,3573,5193,3381
2011,Massachusetts,25,"White, Not Hispanic or Latino ",2046851,1434583,612268,4456,6213,5411
2011,Michigan,26,"White, Not Hispanic or Latino ",3068607,2427959,640648,8608,10629,4590
2011,Minnesota,27,"White, Not Hispanic or Latino ",1846734,1438152,408582,5182,5734,2978
2011,Mississippi,28,"White, Not Hispanic or Latino ",677449,534042,143407,2533,3336,2441
2011,Missouri,29,"White, Not Hispanic or Latino ",1970589,1459126,511463,5292,6708,4523
2011,Montana,30,"White, Not Hispanic or Latino ",369694,261267,108427,1919,2256,1876
2011,Nebraska,31,"White, Not Hispanic or Latino ",624345,447554,176791,1881,2604,2091
2011,Nevada,32,"White, Not Hispanic or Latino ",634718,415891,218827,3082,3790,3160
2011,New Hampshire,33,"White, Not Hispanic or Latino ",486475,358604,127871,1666,2389,2029
2011,New Jersey,34,"White, Not Hispanic or Latino ",2088639,1626607,462032,4473,6792,5163
2011,New Mexico,35,"White, Not Hispanic or Latino ",382009,278917,103092,1900,2328,2010
2011,New York,36,"White, Not Hispanic or Latino ",4663436,3134382,1529054,8458,12588,8216
2011,North Carolina,37,"White, Not Hispanic or Latino ",2578458,1941729,636729,6669,9626,5846
2011,North Dakota,38,"White, Not Hispanic or Latino ",257258,176833,80425,1376,1587,1381
2011,Ohio,39,"White, Not Hispanic or Latino ",3801744,2807189,994555,9756,13338,6630
2011,Oklahoma,40,"White, Not Hispanic or Latino ",1075779,779266,296513,3877,3985,3449
2011,Oregon,41,"White, Not Hispanic or Latino ",1284794,848670,436124,3468,5135,4094
2011,Pennsylvania,42,"White, Not Hispanic or Latino ",4132574,3110058,1022516,8238,11817,6372
2011,Rhode Island,44,"White, Not Hispanic or Latino ",337943,229694,108249,1776,2260,1905
2011,South Carolina,45,"White, Not Hispanic or Latino ",1201475,929946,271529,4495,5445,3868
2011,South Dakota,46,"White, Not Hispanic or Latino ",287338,206584,80754,1523,1728,1569
2011,Tennessee,47,"White, Not Hispanic or Latino ",1954729,1453020,501709,5685,7854,5098
2011,Texas,48,"White, Not Hispanic or Latino ",4690365,3392745,1297620,9493,14843,8338
2011,Utah,49,"White, Not Hispanic or Latino ",741287,549379,191908,2613,3525,2578
2011,Vermont,50,"White, Not Hispanic or Latino ",246539,178052,68487,1197,1224,1164
2011,Virginia,51,"White, Not Hispanic or Latino ",2101360,1570021,531339,5567,7350,4832
2011,Washington,53,"White, Not Hispanic or Latino ",2074337,1419966,654371,4914,6594,4573
2011,West Virginia,54,"White, Not Hispanic or Latino ",699829,529440,170389,2739,3155,2470
2011,Wisconsin,55,"White, Not Hispanic or Latino ",2005907,1464268,541639,8439,8289,3284
2011,Wyoming,56,"White, Not Hispanic or Latino ",197746,142704,55042,1231,1342,1343
2011,Puerto Rico,72,"White, Not Hispanic or Latino ",10936,7503,3433,656,543,345
2012,Alabama,01,"White, Not Hispanic or Latino ",1290788,996489,294299,4234,4697,3443
2012,Alaska,02,"White, Not Hispanic or Latino ",184210,127032,57178,1208,1318,1353
2012,Arizona,04,"White, Not Hispanic or Latino ",1610002,1151295,458707,5478,6803,4890
2012,Arkansas,05,"White, Not Hispanic or Latino ",882664,640318,242346,2979,3665,2846
2012,California,06,"White, Not Hispanic or Latino ",6405947,4142289,2263658,12134,18289,11490
2012,Colorado,08,"White, Not Hispanic or Latino ",1508111,1069867,438244,4348,5612,4121
2012,Connecticut,09,"White, Not Hispanic or Latino ",1036839,798908,237931,2696,3440,3062
2012,Delaware,10,"White, Not Hispanic or Latino ",237524,191476,46048,1442,1640,1184
2012,District of Columbia,11,"White, Not Hispanic or Latino ",103862,51911,51951,1012,1000,1096
2012,Florida,12,"White, Not Hispanic or Latino ",4699925,3551350,1148575,16000,18800,7060
2012,Georgia,13,"White, Not Hispanic or Latino ",2127825,1616348,511477,5649,8071,4938
2012,Hawaii,15,"White, Not Hispanic or Latino ",140305,75879,64426,1206,1391,1289
2012,Idaho,16,"White, Not Hispanic or Latino ",512229,368691,143538,2054,2495,2200
2012,Illinois,17,"White, Not Hispanic or Latino ",3365956,2561700,804256,8710,11153,5730
2012,Indiana,18,"White, Not Hispanic or Latino ",2105566,1578629,526937,5757,7875,4766
2012,Iowa,19,"White, Not Hispanic or Latino ",1127283,844884,282399,3483,4467,2835
2012,Kansas,20,"White, Not Hispanic or Latino ",925343,665598,259745,2779,3589,2766
2012,Kentucky,21,"White, Not Hispanic or Latino ",1496323,1080418,415905,4746,6529,4045
2012,Louisiana,22,"White, Not Hispanic or Latino ",1089497,831464,258033,3380,4553,3533
2012,Maine,23,"White, Not Hispanic or Latino ",532093,389059,143034,1909,2664,2399
2012,Maryland,24,"White, Not Hispanic or Latino ",1278141,987775,290366,3572,4930,3376
2012,Massachusetts,25,"White, Not Hispanic or Latino ",2039502,1424646,614856,4554,6279,4340
2012,Michigan,26,"White, Not Hispanic or Latino ",3056731,2400826,655905,8029,9637,4422
2012,Minnesota,27,"White, Not Hispanic or Latino ",1849546,1431240,418306,4076,4894,2756
2012,Mississippi,28,"White, Not Hispanic or Latino ",676243,530041,146202,2941,3496,2473
2012,Missouri,29,"White, Not Hispanic or Latino ",1971601,1450698,520903,4954,6554,4578
2012,Montana,30,"White, Not Hispanic or Latino ",370379,260767,109612,1496,1739,1559
2012,Nebraska,31,"White, Not Hispanic or Latino ",627047,446680,180367,2175,2769,2300
2012,Nevada,32,"White, Not Hispanic or Latino ",633932,409469,224463,3087,3980,2645
2012,New Hampshire,33,"White, Not Hispanic or Latino ",487117,357369,129748,1969,2087,1891
2012,New Jersey,34,"White, Not Hispanic or Latino ",2075678,1613104,462574,4001,7069,4786
2012,New Mexico,35,"White, Not Hispanic or Latino ",381284,276266,105018,2418,2527,2090
2012,New York,36,"White, Not Hispanic or Latino ",4649269,3115907,1533362,7667,12186,8373
2012,North Carolina,37,"White, Not Hispanic or Latino ",2588726,1933310,655416,7191,9091,5018
2012,North Dakota,38,"White, Not Hispanic or Latino ",260739,178586,82153,1459,1533,1454
2012,Ohio,39,"White, Not Hispanic or Latino ",3793686,2780415,1013271,10308,14344,7003
2012,Oklahoma,40,"White, Not Hispanic or Latino ",1077311,775923,301388,3005,4037,3257
2012,Oregon,41,"White, Not Hispanic or Latino ",1284384,842370,442014,4165,4816,4081
2012,Pennsylvania,42,"White, Not Hispanic or Latino ",4123951,3087139,1036812,8172,11320,6105
2012,Rhode Island,44,"White, Not Hispanic or Latino ",336397,226179,110218,1797,2128,1886
2012,South Carolina,45,"White, Not Hispanic or Latino ",1207518,930379,277139,4440,5197,3754
2012,South Dakota,46,"White, Not Hispanic or Latino ",288314,207249,81065,1366,1739,1541
2012,Tennessee,47,"White, Not Hispanic or Latino ",1955647,1442736,512911,5591,7639,5063
2012,Texas,48,"White, Not Hispanic or Latino ",4711340,3386287,1325053,8855,13215,8078
2012,Utah,49,"White, Not Hispanic or Latino ",747507,551631,195876,2476,3472,2677
2012,Vermont,50,"White, Not Hispanic or Latino ",246633,177660,68973,1327,1454,1276
2012,Virginia,51,"White, Not Hispanic or Latino ",2104331,1564180,540151,5417,7854,5119
2012,Washington,53,"White, Not Hispanic or Latino ",2075738,1411223,664515,4806,6166,5120
2012,West Virginia,54,"White, Not Hispanic or Latino ",701575,526395,175180,2630,2995,2374
2012,Wisconsin,55,"White, Not Hispanic or Latino ",2007636,1459427,548209,7027,7369,3576
2012,Wyoming,56,"White, Not Hispanic or Latino ",198377,143067,55310,1459,1596,1338
2012,Puerto Rico,72,"White, Not Hispanic or Latino ",9388,6155,3233,577,421,433
2013,Alabama,01,"White, Not Hispanic or Latino ",1285801,986868,298933,3985,5065,3570
2013,Alaska,02,"White, Not Hispanic or Latino ",182163,125383,56780,1162,1391,1237
2013,Arizona,04,"White, Not Hispanic or Latino ",1609271,1137143,472128,5583,6063,5193
2013,Arkansas,05,"White, Not Hispanic or Latino ",881298,636145,245153,3274,3660,2857
2013,California,06,"White, Not Hispanic or Latino ",6382685,4092281,2290404,11427,17727,12262
2013,Colorado,08,"White, Not Hispanic or Latino ",1517355,1067762,449593,4157,5161,4160
2013,Connecticut,09,"White, Not Hispanic or Latino ",1026753,787651,239102,2790,3961,2852
2013,Delaware,10,"White, Not Hispanic or Latino ",237403,190604,46799,1467,1477,1275
2013,District of Columbia,11,"White, Not Hispanic or Latino ",106232,53115,53117,1148,984,1152
2013,Florida,12,"White, Not Hispanic or Latino ",4677485,3498174,1179311,15937,18935,7437
2013,Georgia,13,"White, Not Hispanic or Latino ",2123693,1598241,525452,6455,8682,5035
2013,Hawaii,15,"White, Not Hispanic or Latino ",140694,75246,65448,1377,1282,1331
2013,Idaho,16,"White, Not Hispanic or Latino ",512103,368037,144066,2300,2704,2224
2013,Illinois,17,"White, Not Hispanic or Latino ",3357580,2537589,819991,7811,10233,5592
2013,Indiana,18,"White, Not Hispanic or Latino ",2099691,1565009,534682,5554,7434,4560
2013,Iowa,19,"White, Not Hispanic or Latino ",1126842,841507,285335,3184,3995,2625
2013,Kansas,20,"White, Not Hispanic or Latino ",923774,659524,264250,3025,3079,2769
2013,Kentucky,21,"White, Not Hispanic or Latino ",1497985,1077743,420242,4547,6044,3944
2013,Louisiana,22,"White, Not Hispanic or Latino ",1093153,832306,260847,3491,4833,3608
2013,Maine,23,"White, Not Hispanic or Latino ",532389,387756,144633,2043,2478,2157
2013,Maryland,24,"White, Not Hispanic or Latino ",1271632,979836,291796,3875,4957,3214
2013,Massachusetts,25,"White, Not Hispanic or Latino ",2032923,1412772,620151,4661,6378,5363
2013,Michigan,26,"White, Not Hispanic or Latino ",3053355,2378234,675121,7474,9319,4631
2013,Minnesota,27,"White, Not Hispanic or Latino ",1848802,1424449,424353,4701,5557,3022
2013,Mississippi,28,"White, Not Hispanic or Latino ",673648,525085,148563,2769,3863,2921
2013,Missouri,29,"White, Not Hispanic or Latino ",1970800,1440738,530062,5186,6465,3563
2013,Montana,30,"White, Not Hispanic or Latino ",369853,259464,110389,2007,1907,1487
2013,Nebraska,31,"White, Not Hispanic or Latino ",628979,444241,184738,2365,2990,2257
2013,Nevada,32,"White, Not Hispanic or Latino ",632248,402509,229739,2583,3603,2893
2013,New Hampshire,33,"White, Not Hispanic or Latino ",488012,355492,132520,2155,2370,1937
2013,New Jersey,34,"White, Not Hispanic or Latino ",2055705,1592870,462835,4593,6060,4427
2013,New Mexico,35,"White, Not Hispanic or Latino ",377866,272077,105789,2166,2670,2245
2013,New York,36,"White, Not Hispanic or Latino ",4630759,3091418,1539341,8355,11831,7409
2013,North Carolina,37,"White, Not Hispanic or Latino ",2595403,1922590,672813,6309,8730,5982
2013,North Dakota,38,"White, Not Hispanic or Latino ",263923,180151,83772,1246,1461,1433
2013,Ohio,39,"White, Not Hispanic or Latino ",3786326,2757437,1028889,10108,13743,6255
2013,Oklahoma,40,"White, Not Hispanic or Latino ",1076673,772029,304644,2945,3779,2724
2013,Oregon,41,"White, Not Hispanic or Latino ",1281601,835457,446144,4408,5350,4245
2013,Pennsylvania,42,"White, Not Hispanic or Latino ",4114435,3071425,1043010,7485,10467,6518
2013,Rhode Island,44,"White, Not Hispanic or Latino ",334666,225535,109131,1609,2090,2012
2013,South Carolina,45,"White, Not Hispanic or Latino ",1214410,930326,284084,3632,5079,3682
2013,South Dakota,46,"White, Not Hispanic or Latino ",289745,207359,82386,1454,1669,1264
2013,Tennessee,47,"White, Not Hispanic or Latino ",1952850,1431625,521225,5674,8024,5310
2013,Texas,48,"White, Not Hispanic or Latino ",4728627,3375194,1353433,10457,13766,7502
2013,Utah,49,"White, Not Hispanic or Latino ",751308,552547,198761,2651,3421,2922
2013,Vermont,50,"White, Not Hispanic or Latino ",246578,177369,69209,1205,1336,1125
2013,Virginia,51,"White, Not Hispanic or Latino ",2109001,1559248,549753,5526,7520,5018
2013,Washington,53,"White, Not Hispanic or Latino ",2071724,1399822,671902,4775,6578,4841
2013,West Virginia,54,"White, Not Hispanic or Latino ",699663,523766,175897,2787,3393,2907
2013,Wisconsin,55,"White, Not Hispanic or Latino ",2004163,1450953,553210,5655,6380,3563
2013,Wyoming,56,"White, Not Hispanic or Latino ",199025,143353,55672,1421,1566,1807
2013,Puerto Rico,72,"White, Not Hispanic or Latino ",9184,6057,3127,533,405,371
2014,Alabama,01,"White, Not Hispanic or Latino ",1283807,980650,303157,3593,4245,2848
2014,Alaska,02,"White, Not Hispanic or Latino ",180613,123621,56992,1358,1355,1398
2014,Arizona,04,"White, Not Hispanic or Latino ",1609303,1121479,487824,5405,6513,4801
2014,Arkansas,05,"White, Not Hispanic or Latino ",879490,633989,245501,3232,3800,3057
2014,California,06,"White, Not Hispanic or Latino ",6343422,4034237,2309185,11967,16436,9610
2014,Colorado,08,"White, Not Hispanic or Latino ",1528900,1067501,461399,4082,5228,4030
2014,Connecticut,09,"White, Not Hispanic or Latino ",1020209,779578,240631,2666,3621,2997
2014,Delaware,10,"White, Not Hispanic or Latino ",237736,189194,48542,1316,1608,1368
2014,District of Columbia,11,"White, Not Hispanic or Latino ",108749,53330,55419,1073,924,1063
2014,Florida,12,"White, Not Hispanic or Latino ",4677842,3461227,1216615,15368,18644,7642
2014,Georgia,13,"White, Not Hispanic or Latino ",2124707,1580124,544583,6503,8054,5542
2014,Hawaii,15,"White, Not Hispanic or Latino ",141189,73998,67191,1331,1111,1230
2014,Idaho,16,"White, Not Hispanic or Latino ",515905,368187,147718,2051,2692,2496
2014,Illinois,17,"White, Not Hispanic or Latino ",3342779,2510661,832118,8809,11220,5577
2014,Indiana,18,"White, Not Hispanic or Latino ",2100332,1556438,543894,5870,7805,4876
2014,Iowa,19,"White, Not Hispanic or Latino ",1127913,839169,288744,3368,4172,2822
2014,Kansas,20,"White, Not Hispanic or Latino ",921205,654676,266529,3047,3432,2363
2014,Kentucky,21,"White, Not Hispanic or Latino ",1499557,1069731,429826,4524,6201,4184
2014,Louisiana,22,"White, Not Hispanic or Latino ",1093939,827872,266067,3277,4311,3457
2014,Maine,23,"White, Not Hispanic or Latino ",531154,385147,146007,1916,2640,2234
2014,Maryland,24,"White, Not Hispanic or Latino ",1265487,970870,294617,4043,5415,3511
2014,Massachusetts,25,"White, Not Hispanic or Latino ",2024611,1404158,620453,4161,6138,4973
2014,Michigan,26,"White, Not Hispanic or Latino ",3051808,2363481,688327,8409,9880,4886
2014,Minnesota,27,"White, Not Hispanic or Latino ",1848961,1418672,430289,5013,5384,3006
2014,Mississippi,28,"White, Not Hispanic or Latino ",673781,523005,150776,2595,3182,2697
2014,Missouri,29,"White, Not Hispanic or Latino ",1967395,1431131,536264,5399,6750,4702
2014,Montana,30,"White, Not Hispanic or Latino ",371140,258552,112588,1621,2083,1897
2014,Nebraska,31,"White, Not Hispanic or Latino ",632242,443861,188381,2220,2592,2083
2014,Nevada,32,"White, Not Hispanic or Latino ",629339,395117,234222,2830,3406,2958
2014,New Hampshire,33,"White, Not Hispanic or Latino ",488004,354385,133619,1837,2335,1786
2014,New Jersey,34,"White, Not Hispanic or Latino ",2034356,1569257,465099,4921,6653,4653
2014,New Mexico,35,"White, Not Hispanic or Latino ",376835,270300,106535,2089,2250,2046
2014,New York,36,"White, Not Hispanic or Latino ",4607690,3066607,1541083,7719,10389,7261
2014,North Carolina,37,"White, Not Hispanic or Latino ",2601119,1913870,687249,6593,9023,5518
2014,North Dakota,38,"White, Not Hispanic or Latino ",267128,180642,86486,1498,1533,1459
2014,Ohio,39,"White, Not Hispanic or Latino ",3785069,2737600,1047469,8972,12500,6510
2014,Oklahoma,40,"White, Not Hispanic or Latino ",1074425,766649,307776,3177,3436,2937
2014,Oregon,41,"White, Not Hispanic or Latino ",1281186,829774,451412,3529,4736,4084
2014,Pennsylvania,42,"White, Not Hispanic or Latino ",4098342,3052015,1046327,8240,11777,6959
2014,Rhode Island,44,"White, Not Hispanic or Latino ",331815,221110,110705,1563,1888,1591
2014,South Carolina,45,"White, Not Hispanic or Latino ",1224402,931918,292484,3892,4925,3588
2014,South Dakota,46,"White, Not Hispanic or Latino ",292435,209488,82947,1377,1565,1449
2014,Tennessee,47,"White, Not Hispanic or Latino ",1952949,1422892,530057,5589,7868,4745
2014,Texas,48,"White, Not Hispanic or Latino ",4748115,3363906,1384209,9429,13928,8733
2014,Utah,49,"White, Not Hispanic or Latino ",756121,553358,202763,2401,3291,2287
2014,Vermont,50,"White, Not Hispanic or Latino ",246629,177116,69513,1189,1156,1216
2014,Virginia,51,"White, Not Hispanic or Latino ",2111460,1553334,558126,6422,8080,4468
2014,Washington,53,"White, Not Hispanic or Latino ",2073773,1392401,681372,4694,6393,5003
2014,West Virginia,54,"White, Not Hispanic or Latino ",699842,520705,179137,2673,3354,2771
2014,Wisconsin,55,"White, Not Hispanic or Latino ",2003544,1444131,559413,5080,6061,3917
2014,Wyoming,56,"White, Not Hispanic or Latino ",200644,142943,57701,1258,1400,1501
2014,Puerto Rico,72,"White, Not Hispanic or Latino ",8863,5698,3165,627,488,388
2015,Alabama,01,"White, Not Hispanic or Latino ",1280492,974049,306443,4056,5420,3641
2015,Alaska,02,"White, Not Hispanic or Latino ",179371,122751,56620,1185,1265,1167
2015,Arizona,04,"White, Not Hispanic or Latino ",1614809,1118274,496535,5154,6451,4464
2015,Arkansas,05,"White, Not Hispanic or Latino ",880805,631305,249500,3180,4195,3287
2015,California,06,"White, Not Hispanic or Latino ",6321683,3994307,2327376,11127,16910,9758
2015,Colorado,08,"White, Not Hispanic or Latino ",1543768,1070435,473333,3800,5489,4298
2015,Connecticut,09,"White, Not Hispanic or Latino ",1008698,769256,239442,3186,4290,2938
2015,Delaware,10,"White, Not Hispanic or Latino ",239646,190074,49572,1350,1645,1314
2015,District of Columbia,11,"White, Not Hispanic or Latino ",111434,54298,57136,1283,954,1271
2015,Florida,12,"White, Not Hispanic or Latino ",4696110,3448414,1247696,14519,17960,7575
2015,Georgia,13,"White, Not Hispanic or Latino ",2128149,1564632,563517,6420,8330,6040
2015,Hawaii,15,"White, Not Hispanic or Latino ",140509,73603,66906,1389,1216,1460
2015,Idaho,16,"White, Not Hispanic or Latino ",518951,368269,150682,2130,2820,2494
2015,Illinois,17,"White, Not Hispanic or Latino ",3331817,2490916,840901,8348,10644,5660
2015,Indiana,18,"White, Not Hispanic or Latino ",2101695,1550345,551350,5962,7998,4502
2015,Iowa,19,"White, Not Hispanic or Latino ",1128101,836855,291246,3565,4058,2747
2015,Kansas,20,"White, Not Hispanic or Latino ",918480,650072,268408,2856,3802,2730
2015,Kentucky,21,"White, Not Hispanic or Latino ",1500956,1065137,435819,4428,6329,4121
2015,Louisiana,22,"White, Not Hispanic or Latino ",1095971,825384,270587,3288,4560,3472
2015,Maine,23,"White, Not Hispanic or Latino ",530322,383454,146868,2182,2214,2076
2015,Maryland,24,"White, Not Hispanic or Latino ",1261064,965422,295642,3697,4904,3349
2015,Massachusetts,25,"White, Not Hispanic or Latino ",2019393,1399704,619689,4167,6588,4793
2015,Michigan,26,"White, Not Hispanic or Latino ",3053091,2354486,698605,6782,8844,4312
2015,Minnesota,27,"White, Not Hispanic or Latino ",1849977,1413935,436042,5332,6274,3278
2015,Mississippi,28,"White, Not Hispanic or Latino ",672215,519437,152778,2732,3618,2947
2015,Missouri,29,"White, Not Hispanic or Latino ",1964672,1415763,548909,4702,6267,3911
2015,Montana,30,"White, Not Hispanic or Latino ",372090,257533,114557,1718,2169,1789
2015,Nebraska,31,"White, Not Hispanic or Latino ",633484,444417,189067,2188,2955,2351
2015,Nevada,32,"White, Not Hispanic or Latino ",628602,390479,238123,2850,3350,2734
2015,New Hampshire,33,"White, Not Hispanic or Latino ",487590,354019,133571,1642,2343,1942
2015,New Jersey,34,"White, Not Hispanic or Latino ",2015522,1548308,467214,4495,6424,4334
2015,New Mexico,35,"White, Not Hispanic or Latino ",371276,266366,104910,2153,2316,2134
2015,New York,36,"White, Not Hispanic or Latino ",4579652,3042762,1536890,8460,11695,6975
2015,North Carolina,37,"White, Not Hispanic or Latino ",2613230,1908657,704573,6337,9386,6094
2015,North Dakota,38,"White, Not Hispanic or Latino ",271914,181796,90118,1382,1535,1607
2015,Ohio,39,"White, Not Hispanic or Latino ",3781216,2720398,1060818,8518,12797,7567
2015,Oklahoma,40,"White, Not Hispanic or Latino ",1073826,762557,311269,2538,2719,2499
2015,Oregon,41,"White, Not Hispanic or Latino ",1284964,829825,455139,3841,4771,3465
2015,Pennsylvania,42,"White, Not Hispanic or Latino ",4081209,3034484,1046725,7434,11279,6627
2015,Rhode Island,44,"White, Not Hispanic or Latino ",329883,220062,109821,1480,1857,1791
2015,South Carolina,45,"White, Not Hispanic or Latino ",1235249,939687,295562,4146,5551,4015
2015,South Dakota,46,"White, Not Hispanic or Latino ",294854,211362,83492,1496,1749,1410
2015,Tennessee,47,"White, Not Hispanic or Latino ",1958896,1422539,536357,5294,7857,5072
2015,Texas,48,"White, Not Hispanic or Latino ",4761772,3359206,1402566,8873,13835,8548
2015,Utah,49,"White, Not Hispanic or Latino ",762816,557622,205194,2528,3447,2650
2015,Vermont,50,"White, Not Hispanic or Latino ",245892,177208,68684,1068,1466,1471
2015,Virginia,51,"White, Not Hispanic or Latino ",2114600,1545827,568773,4985,7790,5511
2015,Washington,53,"White, Not Hispanic or Latino ",2078896,1393259,685637,5265,6820,4941
2015,West Virginia,54,"White, Not Hispanic or Latino ",697665,515994,181671,2849,3733,3109
2015,Wisconsin,55,"White, Not Hispanic or Latino ",2003059,1438659,564400,5239,6172,3163
2015,Wyoming,56,"White, Not Hispanic or Latino ",201010,142871,58139,1205,1507,1289
2015,Puerto Rico,72,"White, Not Hispanic or Latino ",8874,5769,3105,563,477,373
2016,Alabama,01,"White, Not Hispanic or Latino ",1277770,970994,306776,4197,4762,3935
2016,Alaska,02,"White, Not Hispanic or Latino ",177865,122418,55447,1305,1103,1141
2016,Arizona,04,"White, Not Hispanic or Latino ",1628948,1126684,502264,5408,6822,4772
2016,Arkansas,05,"White, Not Hispanic or Latino ",879927,628021,251906,3345,3570,3157
2016,California,06,"White, Not Hispanic or Latino ",6313861,3974239,2339622,10364,17412,11873
2016,Colorado,08,"White, Not Hispanic or Latino ",1561761,1085027,476734,3624,4791,3308
2016,Connecticut,09,"White, Not Hispanic or Latino ",1002582,761056,241526,3356,4209,3263
2016,Delaware,10,"White, Not Hispanic or Latino ",241128,191238,49890,1560,1392,1327
2016,District of Columbia,11,"White, Not Hispanic or Latino ",113153,55221,57932,1099,996,1131
2016,Florida,12,"White, Not Hispanic or Latino ",4719421,3452319,1267102,13836,17376,8236
2016,Georgia,13,"White, Not Hispanic or Latino ",2132259,1559370,572889,6211,8949,5593
2016,Hawaii,15,"White, Not Hispanic or Latino ",138604,74839,63765,1437,1336,1284
2016,Idaho,16,"White, Not Hispanic or Latino ",523667,372338,151329,2269,2896,2339
2016,Illinois,17,"White, Not Hispanic or Latino ",3326089,2474198,851891,6907,9884,5612
2016,Indiana,18,"White, Not Hispanic or Latino ",2104747,1548784,555963,5840,7870,4848
2016,Iowa,19,"White, Not Hispanic or Latino ",1129231,834624,294607,3330,4116,3259
2016,Kansas,20,"White, Not Hispanic or Latino ",917627,647209,270418,3491,3935,2254
2016,Kentucky,21,"White, Not Hispanic or Latino ",1506718,1065320,441398,3736,5793,3992
2016,Louisiana,22,"White, Not Hispanic or Latino ",1095012,822503,272509,3458,4430,3239
2016,Maine,23,"White, Not Hispanic or Latino ",526934,382988,143946,2041,2766,2080
2016,Maryland,24,"White, Not Hispanic or Latino ",1256840,960642,296198,3837,4793,3249
2016,Massachusetts,25,"White, Not Hispanic or Latino ",2015066,1396941,618125,4394,6523,4273
2016,Michigan,26,"White, Not Hispanic or Latino ",3059232,2355980,703252,6930,9491,5038
2016,Minnesota,27,"White, Not Hispanic or Latino ",1854088,1412850,441238,4977,6376,3858
2016,Mississippi,28,"White, Not Hispanic or Latino ",669417,514940,154477,2703,3366,2490
2016,Missouri,29,"White, Not Hispanic or Latino ",1966685,1410125,556560,5136,6522,4709
2016,Montana,30,"White, Not Hispanic or Latino ",374732,259364,115368,1718,2168,1843
2016,Nebraska,31,"White, Not Hispanic or Latino ",635377,445737,189640,2023,2381,2100
2016,Nevada,32,"White, Not Hispanic or Latino ",628503,390795,237708,2679,3140,3161
2016,New Hampshire,33,"White, Not Hispanic or Latino ",488191,353977,134214,2187,2701,2207
2016,New Jersey,34,"White, Not Hispanic or Latino ",2004270,1536957,467313,4879,6688,4196
2016,New Mexico,35,"White, Not Hispanic or Latino ",367974,264406,103568,2070,2269,2132
2016,New York,36,"White, Not Hispanic or Latino ",4557632,3029700,1527932,8594,12312,8530
2016,North Carolina,37,"White, Not Hispanic or Latino ",2634926,1916695,718231,6888,9685,6605
2016,North Dakota,38,"White, Not Hispanic or Latino ",274817,183059,91758,1757,1689,1555
2016,Ohio,39,"White, Not Hispanic or Latino ",3782686,2712308,1070378,8843,13975,7628
2016,Oklahoma,40,"White, Not Hispanic or Latino ",1071100,757879,313221,2979,2978,2512
2016,Oregon,41,"White, Not Hispanic or Latino ",1290742,835338,455404,3853,4754,3982
2016,Pennsylvania,42,"White, Not Hispanic or Latino ",4069979,3023552,1046427,9144,12714,5927
2016,Rhode Island,44,"White, Not Hispanic or Latino ",327812,218321,109491,1638,2207,2003
2016,South Carolina,45,"White, Not Hispanic or Latino ",1251228,949475,301753,3450,4717,3589
2016,South Dakota,46,"White, Not Hispanic or Latino ",296546,212530,84016,1475,1935,1673
2016,Tennessee,47,"White, Not Hispanic or Latino ",1965720,1423700,542020,5280,7994,5459
2016,Texas,48,"White, Not Hispanic or Latino ",4787808,3363638,1424170,9432,14544,8436
2016,Utah,49,"White, Not Hispanic or Latino ",771743,564849,206894,2292,3259,2745
2016,Vermont,50,"White, Not Hispanic or Latino ",245478,175915,69563,1005,1245,1159
2016,Virginia,51,"White, Not Hispanic or Latino ",2121318,1544625,576693,5262,7902,4933
2016,Washington,53,"White, Not Hispanic or Latino ",2089644,1399509,690135,5074,7406,4755
2016,West Virginia,54,"White, Not Hispanic or Latino ",695253,514632,180621,2632,3419,2508
2016,Wisconsin,55,"White, Not Hispanic or Latino ",2006861,1438395,568466,4332,5654,3674
2016,Wyoming,56,"White, Not Hispanic or Latino ",200510,141533,58977,1452,1707,1397
2016,Puerto Rico,72,"White, Not Hispanic or Latino ",9471,6196,3275,653,511,414
2017,Alabama,01,"White, Not Hispanic or Latino ",1274858,973277,301581,3810,4693,3486
2017,Alaska,02,"White, Not Hispanic or Latino ",178431,122644,55787,1341,1448,1398
2017,Arizona,04,"White, Not Hispanic or Latino ",1637019,1143354,493665,4944,6509,4015
2017,Arkansas,05,"White, Not Hispanic or Latino ",879735,629422,250313,3594,4273,2738
2017,California,06,"White, Not Hispanic or Latino ",6281342,3973835,2307507,10870,16125,9724
2017,Colorado,08,"White, Not Hispanic or Latino ",1577296,1102961,474335,3988,4971,3686
2017,Connecticut,09,"White, Not Hispanic or Latino ",1000287,762221,238066,3073,4045,2655
2017,Delaware,10,"White, Not Hispanic or Latino ",242401,192809,49592,1515,1769,1255
2017,District of Columbia,11,"White, Not Hispanic or Latino ",115088,58071,57017,1005,1036,1228
2017,Florida,12,"White, Not Hispanic or Latino ",4746644,3486661,1259983,13732,18013,9684
2017,Georgia,13,"White, Not Hispanic or Latino ",2144141,1572845,571296,6086,7921,5404
2017,Hawaii,15,"White, Not Hispanic or Latino ",138625,76338,62287,1330,1219,1151
2017,Idaho,16,"White, Not Hispanic or Latino ",532062,380393,151669,2439,2944,2567
2017,Illinois,17,"White, Not Hispanic or Latino ",3324016,2476989,847027,6915,9539,5797
2017,Indiana,18,"White, Not Hispanic or Latino ",2117079,1561480,555599,5964,8436,4539
2017,Iowa,19,"White, Not Hispanic or Latino ",1131955,838293,293662,3706,4794,2908
2017,Kansas,20,"White, Not Hispanic or Latino ",917348,649433,267915,3477,3669,2719
2017,Kentucky,21,"White, Not Hispanic or Latino ",1508569,1070713,437856,3976,5956,4172
2017,Louisiana,22,"White, Not Hispanic or Latino ",1094029,824925,269104,3822,4737,3593
2017,Maine,23,"White, Not Hispanic or Latino ",529062,387601,141461,2299,2614,1737
2017,Maryland,24,"White, Not Hispanic or Latino ",1249670,960087,289583,3893,4744,3295
2017,Massachusetts,25,"White, Not Hispanic or Latino ",2018362,1407534,610828,4228,6661,5115
2017,Michigan,26,"White, Not Hispanic or Latino ",3073628,2374677,698951,7403,9067,5063
2017,Minnesota,27,"White, Not Hispanic or Latino ",1860876,1422377,438499,4513,5277,3320
2017,Mississippi,28,"White, Not Hispanic or Latino ",666886,515397,151489,2869,3562,2714
2017,Missouri,29,"White, Not Hispanic or Latino ",1972469,1419382,553087,5981,7065,4972
2017,Montana,30,"White, Not Hispanic or Latino ",380754,265201,115553,1986,2048,1693
2017,Nebraska,31,"White, Not Hispanic or Latino ",636838,447719,189119,2289,2829,2256
2017,Nevada,32,"White, Not Hispanic or Latino ",632461,397815,234646,2700,3052,2427
2017,New Hampshire,33,"White, Not Hispanic or Latino ",492126,356868,135258,2405,2412,2300
2017,New Jersey,34,"White, Not Hispanic or Latino ",1987620,1528747,458873,5536,6644,3817
2017,New Mexico,35,"White, Not Hispanic or Latino ",364805,263414,101391,2048,2390,1894
2017,New York,36,"White, Not Hispanic or Latino ",4558002,3047678,1510324,8814,12408,7268
2017,North Carolina,37,"White, Not Hispanic or Latino ",2662358,1943840,718518,6303,9212,6353
2017,North Dakota,38,"White, Not Hispanic or Latino ",277998,185776,92222,1470,1576,1540
2017,Ohio,39,"White, Not Hispanic or Latino ",3794612,2729053,1065559,9079,13312,7558
2017,Oklahoma,40,"White, Not Hispanic or Latino ",1070460,757386,313074,2793,3223,2744
2017,Oregon,41,"White, Not Hispanic or Latino ",1304287,848882,455405,3751,4795,3593
2017,Pennsylvania,42,"White, Not Hispanic or Latino ",4088606,3040312,1048294,9088,12416,6170
2017,Rhode Island,44,"White, Not Hispanic or Latino ",326069,219277,106792,1607,1900,1511
2017,South Carolina,45,"White, Not Hispanic or Latino ",1269326,966885,302441,4214,5527,4201
2017,South Dakota,46,"White, Not Hispanic or Latino ",301163,216366,84797,1453,1513,1383
2017,Tennessee,47,"White, Not Hispanic or Latino ",1980945,1434148,546797,5308,7516,5313
2017,Texas,48,"White, Not Hispanic or Latino ",4800673,3383454,1417219,10233,13717,8837
2017,Utah,49,"White, Not Hispanic or Latino ",784972,575586,209386,2598,3565,2440
2017,Vermont,50,"White, Not Hispanic or Latino ",246164,176153,70011,1154,1418,1311
2017,Virginia,51,"White, Not Hispanic or Latino ",2118812,1550287,568525,5882,8395,5400
2017,Washington,53,"White, Not Hispanic or Latino ",2118172,1424241,693931,5533,7661,5286
2017,West Virginia,54,"White, Not Hispanic or Latino ",692724,515541,177183,2600,3661,2891
2017,Wisconsin,55,"White, Not Hispanic or Latino ",2016256,1446049,570207,5840,7136,3792
2017,Wyoming,56,"White, Not Hispanic or Latino ",203164,144598,58566,1542,1498,1672
2017,Puerto Rico,72,"White, Not Hispanic or Latino ",9415,6116,3299,774,597,481
2018,Alabama,01,"White, Not Hispanic or Latino ",1271510,972403,299107,4686,5534,3644
2018,Alaska,02,"White, Not Hispanic or Latino ",177104,122424,54680,1106,1293,1382
2018,Arizona,04,"White, Not Hispanic or Latino ",1652733,1162463,490270,5506,5991,4403
2018,Arkansas,05,"White, Not Hispanic or Latino ",880143,629980,250163,3127,3935,3121
2018,California,06,"White, Not Hispanic or Latino ",6254582,3959445,2295137,12036,17185,11572
2018,Colorado,08,"White, Not Hispanic or Latino ",1593479,1114685,478794,4076,5389,3590
2018,Connecticut,09,"White, Not Hispanic or Latino ",997457,758880,238577,3320,3896,3266
2018,Delaware,10,"White, Not Hispanic or Latino ",244256,195318,48938,1415,1447,1271
2018,District of Columbia,11,"White, Not Hispanic or Latino ",116801,58597,58204,1161,1066,1257
2018,Florida,12,"White, Not Hispanic or Latino ",4775106,3529495,1245611,14405,17086,7296
2018,Georgia,13,"White, Not Hispanic or Latino ",2153535,1586807,566728,5789,7372,5724
2018,Hawaii,15,"White, Not Hispanic or Latino ",137877,77044,60833,1197,1179,1264
2018,Idaho,16,"White, Not Hispanic or Latino ",539311,386468,152843,2156,2907,2163
2018,Illinois,17,"White, Not Hispanic or Latino ",3310102,2466631,843471,6919,9340,5741
2018,Indiana,18,"White, Not Hispanic or Latino ",2122828,1569605,553223,6068,8284,5155
2018,Iowa,19,"White, Not Hispanic or Latino ",1132945,840469,292476,3766,4744,3137
2018,Kansas,20,"White, Not Hispanic or Latino ",916529,648030,268499,3458,4189,2874
2018,Kentucky,21,"White, Not Hispanic or Latino ",1506496,1071350,435146,4428,6221,4534
2018,Louisiana,22,"White, Not Hispanic or Latino ",1088022,821588,266434,4007,4777,4045
2018,Maine,23,"White, Not Hispanic or Latino ",530829,390088,140741,2218,2392,1773
2018,Maryland,24,"White, Not Hispanic or Latino ",1248268,958903,289365,3719,4607,3130
2018,Massachusetts,25,"White, Not Hispanic or Latino ",2015595,1407008,608587,4147,6179,4696
2018,Michigan,26,"White, Not Hispanic or Latino ",3077347,2383266,694081,7749,10086,4797
2018,Minnesota,27,"White, Not Hispanic or Latino ",1865113,1427298,437815,5199,6200,2920
2018,Mississippi,28,"White, Not Hispanic or Latino ",664189,516559,147630,3210,3583,2880
2018,Missouri,29,"White, Not Hispanic or Latino ",1973057,1420379,552678,5466,6700,4705
2018,Montana,30,"White, Not Hispanic or Latino ",382557,266743,115814,1980,2206,2167
2018,Nebraska,31,"White, Not Hispanic or Latino ",638970,449799,189171,2509,2889,2275
2018,Nevada,32,"White, Not Hispanic or Latino ",638186,404800,233386,2872,3231,3103
2018,New Hampshire,33,"White, Not Hispanic or Latino ",491189,358200,132989,2089,2570,2208
2018,New Jersey,34,"White, Not Hispanic or Latino ",1983038,1522579,460459,4740,6513,3879
2018,New Mexico,35,"White, Not Hispanic or Latino ",362653,262031,100622,2130,2170,2027
2018,New York,36,"White, Not Hispanic or Latino ",4539296,3035142,1504154,8848,12316,6913
2018,North Carolina,37,"White, Not Hispanic or Latino ",2679962,1961119,718843,6514,9329,6626
2018,North Dakota,38,"White, Not Hispanic or Latino ",279053,185674,93379,1880,2000,1567
2018,Ohio,39,"White, Not Hispanic or Latino ",3793827,2733517,1060310,8187,12972,7455
2018,Oklahoma,40,"White, Not Hispanic or Latino ",1067570,755287,312283,2606,2758,2487
2018,Oregon,41,"White, Not Hispanic or Latino ",1314053,859423,454630,3824,5336,4477
2018,Pennsylvania,42,"White, Not Hispanic or Latino ",4083092,3041991,1041101,8320,11071,5396
2018,Rhode Island,44,"White, Not Hispanic or Latino ",323081,218753,104328,1701,2021,1846
2018,South Carolina,45,"White, Not Hispanic or Latino ",1284666,983906,300760,4001,4937,3428
2018,South Dakota,46,"White, Not Hispanic or Latino ",301952,218235,83717,1826,1614,1502
2018,Tennessee,47,"White, Not Hispanic or Latino ",1989406,1443548,545858,5353,7661,5101
2018,Texas,48,"White, Not Hispanic or Latino ",4805139,3384284,1420855,9159,13640,9086
2018,Utah,49,"White, Not Hispanic or Latino ",797735,586824,210911,2656,3288,2534
2018,Vermont,50,"White, Not Hispanic or Latino ",246382,177099,69283,1222,1364,1126
2018,Virginia,51,"White, Not Hispanic or Latino ",2120092,1552524,567568,4982,7052,4473
2018,Washington,53,"White, Not Hispanic or Latino ",2135340,1436878,698462,4746,6514,5365
2018,West Virginia,54,"White, Not Hispanic or Latino ",688222,513421,174801,2681,3292,2500
2018,Wisconsin,55,"White, Not Hispanic or Latino ",2023477,1452098,571379,5708,6926,3876
2018,Wyoming,56,"White, Not Hispanic or Latino ",203025,144788,58237,1315,1366,1366
2018,Puerto Rico,72,"White, Not Hispanic or Latino ",9768,6196,3572,659,541,428
2019,Alabama,01,"White, Not Hispanic or Latino ",1271914,975636,296278,3776,5240,3660
2019,Alaska,02,"White, Not Hispanic or Latino ",175492,121623,53869,1474,1517,1154
2019,Arizona,04,"White, Not Hispanic or Latino ",1672581,1188841,483740,4711,5935,4157
2019,Arkansas,05,"White, Not Hispanic or Latino ",881899,629907,251992,3581,3916,2864
2019,California,06,"White, Not Hispanic or Latino ",6231619,3949696,2281923,10337,16322,10236
2019,Colorado,08,"White, Not Hispanic or Latino ",1614843,1133758,481085,4239,5612,4666
2019,Connecticut,09,"White, Not Hispanic or Latino ",992605,753540,239065,3255,4314,3618
2019,Delaware,10,"White, Not Hispanic or Latino ",246718,198037,48681,1501,1890,1467
2019,District of Columbia,11,"White, Not Hispanic or Latino ",119278,60007,59271,1220,1157,1223
2019,Florida,12,"White, Not Hispanic or Latino ",4800896,3571467,1229429,14276,17783,8123
2019,Georgia,13,"White, Not Hispanic or Latino ",2161570,1599676,561894,6298,8825,5640
2019,Hawaii,15,"White, Not Hispanic or Latino ",136104,77500,58604,1321,1294,1392
2019,Idaho,16,"White, Not Hispanic or Latino ",547253,396113,151140,2476,2652,2396
2019,Illinois,17,"White, Not Hispanic or Latino ",3303726,2463555,840171,7483,10685,6252
2019,Indiana,18,"White, Not Hispanic or Latino ",2129510,1579317,550193,6148,8380,4753
2019,Iowa,19,"White, Not Hispanic or Latino ",1135997,843659,292338,3619,4133,2805
2019,Kansas,20,"White, Not Hispanic or Latino ",917299,648434,268865,3613,4477,2637
2019,Kentucky,21,"White, Not Hispanic or Latino ",1507458,1076612,430846,4275,6438,4371
2019,Louisiana,22,"White, Not Hispanic or Latino ",1088755,826063,262692,4001,4833,3644
2019,Maine,23,"White, Not Hispanic or Latino ",533085,391772,141313,2462,2694,2103
2019,Maryland,24,"White, Not Hispanic or Latino ",1245794,957908,287886,4442,4858,3464
2019,Massachusetts,25,"White, Not Hispanic or Latino ",2013404,1406992,606412,4762,7017,5068
2019,Michigan,26,"White, Not Hispanic or Latino ",3087557,2399059,688498,7330,8624,4212
2019,Minnesota,27,"White, Not Hispanic or Latino ",1873239,1435875,437364,4126,5062,3169
2019,Mississippi,28,"White, Not Hispanic or Latino ",659530,514148,145382,3678,3980,2275
2019,Missouri,29,"White, Not Hispanic or Latino ",1982937,1427648,555289,5018,6439,4181
2019,Montana,30,"White, Not Hispanic or Latino ",386549,271193,115356,1573,2029,2003
2019,Nebraska,31,"White, Not Hispanic or Latino ",641373,451346,190027,1936,2280,1943
2019,Nevada,32,"White, Not Hispanic or Latino ",645317,412858,232459,2552,2777,2896
2019,New Hampshire,33,"White, Not Hispanic or Latino ",494425,360683,133742,2324,2574,2250
2019,New Jersey,34,"White, Not Hispanic or Latino ",1977442,1517427,460015,5516,6819,4734
2019,New Mexico,35,"White, Not Hispanic or Latino ",362325,261706,100619,1975,2277,1794
2019,New York,36,"White, Not Hispanic or Latino ",4534313,3027945,1506368,9575,13102,7700
2019,North Carolina,37,"White, Not Hispanic or Latino ",2702764,1983843,718921,7175,9379,6548
2019,North Dakota,38,"White, Not Hispanic or Latino ",280554,186549,94005,1833,1689,1742
2019,Ohio,39,"White, Not Hispanic or Latino ",3799219,2744380,1054839,8844,13216,6823
2019,Oklahoma,40,"White, Not Hispanic or Latino ",1065656,755045,310611,2945,2762,3278
2019,Oregon,41,"White, Not Hispanic or Latino ",1325531,871303,454228,3301,4779,4015
2019,Pennsylvania,42,"White, Not Hispanic or Latino ",4086664,3043507,1043157,8311,12076,6635
2019,Rhode Island,44,"White, Not Hispanic or Latino ",320939,219233,101706,2061,2054,1950
2019,South Carolina,45,"White, Not Hispanic or Latino ",1300207,1003657,296550,4362,5578,3752
2019,South Dakota,46,"White, Not Hispanic or Latino ",303632,218779,84853,1874,1812,1336
2019,Tennessee,47,"White, Not Hispanic or Latino ",2004934,1459610,545324,5231,7588,4983
2019,Texas,48,"White, Not Hispanic or Latino ",4823649,3399794,1423855,9993,13372,7740
2019,Utah,49,"White, Not Hispanic or Latino ",811581,600100,211481,2450,3598,2570
2019,Vermont,50,"White, Not Hispanic or Latino ",246443,177500,68943,1250,1862,1468
2019,Virginia,51,"White, Not Hispanic or Latino ",2124497,1556644,567853,5077,7249,5042
2019,Washington,53,"White, Not Hispanic or Latino ",2153054,1455965,697089,5216,6648,5345
2019,West Virginia,54,"White, Not Hispanic or Latino ",686346,513586,172760,2416,3440,2934
2019,Wisconsin,55,"White, Not Hispanic or Latino ",2030721,1461751,568970,6533,7237,3581
2019,Wyoming,56,"White, Not Hispanic or Latino ",202923,146380,56543,1522,1539,1630
2019,Puerto Rico,72,"White, Not Hispanic or Latino ",10661,6777,3884,846,640,486
2020,Alabama,01,"White, Not Hispanic or Latino ",1278111,987353,290758,4952,6269,4197
2020,Alaska,02,"White, Not Hispanic or Latino ",174055,121131,52924,1300,1493,1489
2020,Arizona,04,"White, Not Hispanic or Latino ",1702280,1221788,480492,4850,6684,4360
2020,Arkansas,05,"White, Not Hispanic or Latino ",880329,633325,247004,3937,5015,3641
2020,California,06,"White, Not Hispanic or Latino ",6149669,3900067,2249602,11866,17209,11671
2020,Colorado,08,"White, Not Hispanic or Latino ",1599857,1134545,465312,4461,5773,5309
2020,Connecticut,09,"White, Not Hispanic or Latino ",990186,750664,239522,2974,4289,3650
2020,Delaware,10,"White, Not Hispanic or Latino ",247276,199103,48173,1905,2352,1781
2020,District of Columbia,11,"White, Not Hispanic or Latino ",122878,61524,61354,1469,1554,1673
2020,Florida,12,"White, Not Hispanic or Latino ",4853937,3651275,1202662,14149,17201,9681
2020,Georgia,13,"White, Not Hispanic or Latino ",2172359,1623006,549353,6428,9219,6402
2020,Hawaii,15,"White, Not Hispanic or Latino ",135328,78032,57296,1491,1396,1469
2020,Idaho,16,"White, Not Hispanic or Latino ",558069,408259,149810,2459,3478,2739
2020,Illinois,17,"White, Not Hispanic or Latino ",3300250,2460761,839489,7393,10179,6690
2020,Indiana,18,"White, Not Hispanic or Latino ",2139412,1596952,542460,5848,8274,4942
2020,Iowa,19,"White, Not Hispanic or Latino ",1136873,847158,289715,3919,4386,2734
2020,Kansas,20,"White, Not Hispanic or Latino ",919526,649069,270457,3995,4431,2989
2020,Kentucky,21,"White, Not Hispanic or Latino ",1511572,1087004,424568,5106,6913,4232
2020,Louisiana,22,"White, Not Hispanic or Latino ",1092374,839784,252590,4438,5552,4184
2020,Maine,23,"White, Not Hispanic or Latino ",539053,398760,140293,2223,2833,2267
2020,Maryland,24,"White, Not Hispanic or Latino ",1243112,957278,285834,4103,4908,3744
2020,Massachusetts,25,"White, Not Hispanic or Latino ",2013597,1410157,603440,4860,6718,5983
2020,Michigan,26,"White, Not Hispanic or Latino ",3103475,2424249,679226,8100,9193,5008
2020,Minnesota,27,"White, Not Hispanic or Latino ",1876630,1442949,433681,5512,6227,3594
2020,Mississippi,28,"White, Not Hispanic or Latino ",660815,520938,139877,3663,3859,2629
2020,Missouri,29,"White, Not Hispanic or Latino ",1989191,1438793,550398,6245,7884,5340
2020,Montana,30,"White, Not Hispanic or Latino ",391347,276095,115252,1974,2276,2117
2020,Nebraska,31,"White, Not Hispanic or Latino ",643138,452788,190350,2202,2826,2583
2020,Nevada,32,"White, Not Hispanic or Latino ",649919,421400,228519,2551,3632,3016
2020,New Hampshire,33,"White, Not Hispanic or Latino ",497368,364372,132996,2115,2877,2674
2020,New Jersey,34,"White, Not Hispanic or Latino ",1974243,1513944,460299,5534,7386,5273
2020,New Mexico,35,"White, Not Hispanic or Latino ",360863,260041,100822,2303,2654,2388
2020,New York,36,"White, Not Hispanic or Latino ",4539214,3033408,1505806,9461,11972,7925
2020,North Carolina,37,"White, Not Hispanic or Latino ",2726594,2012862,713732,6891,9356,6052
2020,North Dakota,38,"White, Not Hispanic or Latino ",280091,187605,92486,1788,1738,1956
2020,Ohio,39,"White, Not Hispanic or Latino ",3806529,2761494,1045035,8411,11959,6549
2020,Oklahoma,40,"White, Not Hispanic or Latino ",1067053,758064,308989,2784,3599,3053
2020,Oregon,41,"White, Not Hispanic or Latino ",1333061,883595,449466,3645,5586,4767
2020,Pennsylvania,42,"White, Not Hispanic or Latino ",4094847,3052796,1042051,9075,12531,7382
2020,Rhode Island,44,"White, Not Hispanic or Latino ",321239,221178,100061,1876,2175,2343
2020,South Carolina,45,"White, Not Hispanic or Latino ",1321984,1029469,292515,4148,6147,4476
2020,South Dakota,46,"White, Not Hispanic or Latino ",304295,219912,84383,1743,2134,1784
2020,Tennessee,47,"White, Not Hispanic or Latino ",2021481,1479109,542372,6131,8169,5712
2020,Texas,48,"White, Not Hispanic or Latino ",4853846,3426257,1427589,11455,15271,10141
2020,Utah,49,"White, Not Hispanic or Latino ",828325,613988,214337,2758,3509,2871
2020,Vermont,50,"White, Not Hispanic or Latino ",248364,180560,67804,1281,1740,1514
2020,Virginia,51,"White, Not Hispanic or Latino ",2123428,1563539,559889,5952,8931,6296
2020,Washington,53,"White, Not Hispanic or Latino ",2164383,1471675,692708,5167,7221,6107
2020,West Virginia,54,"White, Not Hispanic or Latino ",685042,516091,168951,2806,3355,3135
2020,Wisconsin,55,"White, Not Hispanic or Latino ",2034978,1467026,567952,6129,7189,4190
2020,Wyoming,56,"White, Not Hispanic or Latino ",204436,148464,55972,1507,1759,1666
2020,Puerto Rico,72,"White, Not Hispanic or Latino ",10660,6726,3934,747,616,477
2010,Alabama,01,Hispanic or Latino ,40655,16599,24056,1074,902,977
2010,Alaska,02,Hispanic or Latino ,10042,5009,5033,508,463,429
2010,Arizona,04,Hispanic or Latino ,484404,271009,213395,3370,3470,2551
2010,Arkansas,05,Hispanic or Latino ,42271,20387,21884,825,883,736
2010,California,06,Hispanic or Latino ,3304185,1533771,1770414,9672,13048,8726
2010,Colorado,08,Hispanic or Latino ,284456,143385,141071,2194,2548,2118
2010,Connecticut,09,Hispanic or Latino ,133845,47190,86655,1549,1467,1561
2010,Delaware,10,Hispanic or Latino ,16566,8097,8469,657,471,635
2010,District of Columbia,11,Hispanic or Latino ,18472,5310,13162,642,421,699
2010,Florida,12,Hispanic or Latino ,1244858,709582,535276,7974,8268,5007
2010,Georgia,13,Hispanic or Latino ,197377,87082,110295,2504,2171,2232
2010,Hawaii,15,Hispanic or Latino ,29834,11942,17892,917,594,856
2010,Idaho,16,Hispanic or Latino ,41497,22723,18774,902,724,931
2010,Illinois,17,Hispanic or Latino ,490306,274964,215342,3120,3537,2637
2010,Indiana,18,Hispanic or Latino ,93252,49615,43637,1395,1397,1182
2010,Iowa,19,Hispanic or Latino ,34850,18109,16741,765,818,738
2010,Kansas,20,Hispanic or Latino ,72717,40253,32464,1091,1034,1204
2010,Kentucky,21,Hispanic or Latino ,29255,10900,18355,817,821,730
2010,Louisiana,22,Hispanic or Latino ,51096,24662,26434,1267,1009,1079
2010,Maine,23,Hispanic or Latino ,4426,2040,2386,317,262,298
2010,Maryland,24,Hispanic or Latino ,108479,59544,48935,1585,1166,1280
2010,Massachusetts,25,Hispanic or Latino ,178625,47502,131123,1819,1510,2309
2010,Michigan,26,Hispanic or Latino ,111082,64477,46605,1464,1393,1385
2010,Minnesota,27,Hispanic or Latino ,59184,28145,31039,962,829,964
2010,Mississippi,28,Hispanic or Latino ,16680,6967,9713,691,573,632
2010,Missouri,29,Hispanic or Latino ,53768,26812,26956,956,1003,996
2010,Montana,30,Hispanic or Latino ,7530,3772,3758,446,356,403
2010,Nebraska,31,Hispanic or Latino ,38544,19516,19028,882,758,798
2010,Nevada,32,Hispanic or Latino ,176878,84791,92087,2001,1972,1886
2010,New Hampshire,33,Hispanic or Latino ,9491,4282,5209,392,470,488
2010,New Jersey,34,Hispanic or Latino ,420939,160621,260318,2672,2759,2529
2010,New Mexico,35,Hispanic or Latino ,295755,199972,95783,2354,2185,2239
2010,New York,36,Hispanic or Latino ,992938,244477,748461,3862,3135,3844
2010,North Carolina,37,Hispanic or Latino ,183810,78218,105592,2848,2095,1975
2010,North Dakota,38,Hispanic or Latino ,3573,1606,1967,296,227,280
2010,Ohio,39,Hispanic or Latino ,92029,43164,48865,1362,1207,1198
2010,Oklahoma,40,Hispanic or Latino ,78484,38927,39557,1027,1190,1087
2010,Oregon,41,Hispanic or Latino ,104908,43787,61121,1711,1407,1429
2010,Pennsylvania,42,Hispanic or Latino ,184517,79417,105100,1831,1785,2083
2010,Rhode Island,44,Hispanic or Latino ,35189,10266,24923,734,624,858
2010,South Carolina,45,Hispanic or Latino ,55043,21439,33604,1231,987,1101
2010,South Dakota,46,Hispanic or Latino ,5063,2267,2796,370,340,322
2010,Tennessee,47,Hispanic or Latino ,67849,26176,41673,1375,1029,1204
2010,Texas,48,Hispanic or Latino ,2451269,1429212,1022057,8293,10570,6430
2010,Utah,49,Hispanic or Latino ,81476,41665,39811,1043,1236,1236
2010,Vermont,50,Hispanic or Latino ,2690,1521,1169,260,177,199
2010,Virginia,51,Hispanic or Latino ,150859,77085,73774,2296,2049,1812
2010,Washington,53,Hispanic or Latino ,179851,78006,101845,1891,1736,2185
2010,West Virginia,54,Hispanic or Latino ,6211,3567,2644,400,293,336
2010,Wisconsin,55,Hispanic or Latino ,80949,35853,45096,1132,1289,1202
2010,Wyoming,56,Hispanic or Latino ,13582,7653,5929,528,515,521
2010,Puerto Rico,72,Hispanic or Latino ,1211230,878094,333136,3356,3482,3042
2011,Alabama,01,Hispanic or Latino ,42898,18291,24607,1140,978,948
2011,Alaska,02,Hispanic or Latino ,10499,5244,5255,494,373,446
2011,Arizona,04,Hispanic or Latino ,495129,273546,221583,3941,3557,3136
2011,Arkansas,05,Hispanic or Latino ,44596,21652,22944,966,819,1041
2011,California,06,Hispanic or Latino ,3353764,1527634,1826130,9801,12940,9278
2011,Colorado,08,Hispanic or Latino ,290033,143998,146035,2072,2487,2408
2011,Connecticut,09,Hispanic or Latino ,137855,47985,89870,1490,1183,1517
2011,Delaware,10,Hispanic or Latino ,17369,8864,8505,602,559,502
2011,District of Columbia,11,Hispanic or Latino ,19005,5492,13513,749,407,773
2011,Florida,12,Hispanic or Latino ,1260654,708946,551708,7582,8432,4819
2011,Georgia,13,Hispanic or Latino ,204294,90751,113543,2800,2347,2222
2011,Hawaii,15,Hispanic or Latino ,30661,12105,18556,799,571,808
2011,Idaho,16,Hispanic or Latino ,42829,23451,19378,935,920,976
2011,Illinois,17,Hispanic or Latino ,499989,276194,223795,2935,3469,3214
2011,Indiana,18,Hispanic or Latino ,95589,51300,44289,1471,1407,1191
2011,Iowa,19,Hispanic or Latino ,36527,18928,17599,883,807,728
2011,Kansas,20,Hispanic or Latino ,75010,41054,33956,1166,1241,1216
2011,Kentucky,21,Hispanic or Latino ,30997,11486,19511,921,795,917
2011,Louisiana,22,Hispanic or Latino ,54609,25981,28628,1237,929,1060
2011,Maine,23,Hispanic or Latino ,4457,1979,2478,343,278,304
2011,Maryland,24,Hispanic or Latino ,111654,60524,51130,1592,1299,1346
2011,Massachusetts,25,Hispanic or Latino ,184232,48585,135647,1805,1542,2018
2011,Michigan,26,Hispanic or Latino ,110641,63307,47334,1438,1498,1265
2011,Minnesota,27,Hispanic or Latino ,61240,27569,33671,1087,1002,1111
2011,Mississippi,28,Hispanic or Latino ,17994,7727,10267,846,640,648
2011,Missouri,29,Hispanic or Latino ,55489,27845,27644,1192,953,948
2011,Montana,30,Hispanic or Latino ,7525,3915,3610,479,380,361
2011,Nebraska,31,Hispanic or Latino ,40676,20675,20001,733,808,797
2011,Nevada,32,Hispanic or Latino ,180833,84231,96602,1827,1765,1904
2011,New Hampshire,33,Hispanic or Latino ,9859,4360,5499,455,355,435
2011,New Jersey,34,Hispanic or Latino ,430332,163572,266760,2748,2571,2740
2011,New Mexico,35,Hispanic or Latino ,301640,204093,97547,2066,2468,2096
2011,New York,36,Hispanic or Latino ,1008650,247364,761286,4451,3232,4458
2011,North Carolina,37,Hispanic or Latino ,192232,83884,108348,2324,2080,2104
2011,North Dakota,38,Hispanic or Latino ,3592,1533,2059,256,200,262
2011,Ohio,39,Hispanic or Latino ,95165,43729,51436,1433,1186,1426
2011,Oklahoma,40,Hispanic or Latino ,82016,41266,40750,1246,1101,1167
2011,Oregon,41,Hispanic or Latino ,106932,43758,63174,1668,1360,1676
2011,Pennsylvania,42,Hispanic or Latino ,192245,81851,110394,1872,1742,1983
2011,Rhode Island,44,Hispanic or Latino ,36263,10691,25572,644,581,703
2011,South Carolina,45,Hispanic or Latino ,57363,22708,34655,1368,1074,1265
2011,South Dakota,46,Hispanic or Latino ,5333,2411,2922,384,267,377
2011,Tennessee,47,Hispanic or Latino ,70041,26998,43043,1311,1351,1304
2011,Texas,48,Hispanic or Latino ,2518021,1462560,1055461,9352,11553,7002
2011,Utah,49,Hispanic or Latino ,84861,43407,41454,1144,1220,1064
2011,Vermont,50,Hispanic or Latino ,2663,1523,1140,255,206,207
2011,Virginia,51,Hispanic or Latino ,156336,76650,79686,2321,2247,2119
2011,Washington,53,Hispanic or Latino ,186054,80758,105296,2133,2049,1883
2011,West Virginia,54,Hispanic or Latino ,5924,3181,2743,468,338,362
2011,Wisconsin,55,Hispanic or Latino ,83341,37319,46022,1207,1109,1161
2011,Wyoming,56,Hispanic or Latino ,13242,7500,5742,569,519,458
2011,Puerto Rico,72,Hispanic or Latino ,1215568,869851,345717,3867,3626,3239
2012,Alabama,01,Hispanic or Latino ,44459,18749,25710,1154,930,986
2012,Alaska,02,Hispanic or Latino ,10587,5203,5384,509,397,416
2012,Arizona,04,Hispanic or Latino ,502570,272485,230085,3516,3511,2941
2012,Arkansas,05,Hispanic or Latino ,46806,22773,24033,1081,855,931
2012,California,06,Hispanic or Latino ,3401692,1508126,1893566,9744,13701,10304
2012,Colorado,08,Hispanic or Latino ,296771,144620,152151,2177,2521,2147
2012,Connecticut,09,Hispanic or Latino ,141733,48355,93378,1558,1277,1594
2012,Delaware,10,Hispanic or Latino ,17843,8991,8852,587,571,528
2012,District of Columbia,11,Hispanic or Latino ,19403,5601,13802,646,419,688
2012,Florida,12,Hispanic or Latino ,1280644,707530,573114,7304,7619,4849
2012,Georgia,13,Hispanic or Latino ,208894,92551,116343,2693,2399,2287
2012,Hawaii,15,Hispanic or Latino ,31048,11508,19540,871,607,861
2012,Idaho,16,Hispanic or Latino ,43716,23646,20070,897,884,955
2012,Illinois,17,Hispanic or Latino ,507940,273487,234453,3409,3281,3439
2012,Indiana,18,Hispanic or Latino ,98016,52096,45920,1119,1229,1154
2012,Iowa,19,Hispanic or Latino ,38414,19979,18435,712,713,756
2012,Kansas,20,Hispanic or Latino ,77241,42034,35207,1139,1149,1193
2012,Kentucky,21,Hispanic or Latino ,32885,12314,20571,942,739,909
2012,Louisiana,22,Hispanic or Latino ,56986,26713,30273,1195,1185,1128
2012,Maine,23,Hispanic or Latino ,4483,2170,2313,313,247,254
2012,Maryland,24,Hispanic or Latino ,115240,59666,55574,1689,1518,1376
2012,Massachusetts,25,Hispanic or Latino ,189425,48813,140612,1573,1546,1711
2012,Michigan,26,Hispanic or Latino ,113366,63771,49595,1401,1293,1330
2012,Minnesota,27,Hispanic or Latino ,61846,27353,34493,1032,920,1096
2012,Mississippi,28,Hispanic or Latino ,19396,8479,10917,718,632,716
2012,Missouri,29,Hispanic or Latino ,56566,27608,28958,1136,1041,999
2012,Montana,30,Hispanic or Latino ,8307,4190,4117,450,302,426
2012,Nebraska,31,Hispanic or Latino ,42626,21025,21601,828,950,951
2012,Nevada,32,Hispanic or Latino ,185006,83352,101654,2091,1779,1824
2012,New Hampshire,33,Hispanic or Latino ,10191,4173,6018,400,396,508
2012,New Jersey,34,Hispanic or Latino ,443479,166081,277398,2824,2956,2988
2012,New Mexico,35,Hispanic or Latino ,304909,203549,101360,2078,2326,2013
2012,New York,36,Hispanic or Latino ,1025950,248353,777597,4259,3445,4241
2012,North Carolina,37,Hispanic or Latino ,199730,87264,112466,2655,2200,1960
2012,North Dakota,38,Hispanic or Latino ,3736,1629,2107,253,198,236
2012,Ohio,39,Hispanic or Latino ,97736,44400,53336,1480,1243,1172
2012,Oklahoma,40,Hispanic or Latino ,83947,42066,41881,1098,1144,1150
2012,Oregon,41,Hispanic or Latino ,109510,44160,65350,1409,1292,1463
2012,Pennsylvania,42,Hispanic or Latino ,200601,84804,115797,2122,1977,2326
2012,Rhode Island,44,Hispanic or Latino ,37139,10304,26835,728,714,871
2012,South Carolina,45,Hispanic or Latino ,58555,23807,34748,1299,1014,975
2012,South Dakota,46,Hispanic or Latino ,5456,2441,3015,369,310,308
2012,Tennessee,47,Hispanic or Latino ,73004,28103,44901,1406,1163,1236
2012,Texas,48,Hispanic or Latino ,2583192,1491665,1091527,7825,11067,7737
2012,Utah,49,Hispanic or Latino ,87423,45325,42098,1129,1084,1356
2012,Vermont,50,Hispanic or Latino ,2637,1440,1197,219,178,180
2012,Virginia,51,Hispanic or Latino ,161511,76188,85323,2136,1994,1752
2012,Washington,53,Hispanic or Latino ,192428,82068,110360,1989,1727,1995
2012,West Virginia,54,Hispanic or Latino ,5866,3258,2608,396,351,321
2012,Wisconsin,55,Hispanic or Latino ,85501,36693,48808,1193,1111,1070
2012,Wyoming,56,Hispanic or Latino ,14387,7986,6401,530,475,493
2012,Puerto Rico,72,Hispanic or Latino ,1204553,853476,351077,3228,3127,3064
2013,Alabama,01,Hispanic or Latino ,45891,20406,25485,1125,1056,1008
2013,Alaska,02,Hispanic or Latino ,11251,5566,5685,593,374,547
2013,Arizona,04,Hispanic or Latino ,510041,267875,242166,4087,3884,3171
2013,Arkansas,05,Hispanic or Latino ,48109,23019,25090,1178,1071,897
2013,California,06,Hispanic or Latino ,3459623,1505227,1954396,8939,12640,9664
2013,Colorado,08,Hispanic or Latino ,301051,146122,154929,2184,2330,2602
2013,Connecticut,09,Hispanic or Latino ,145043,49704,95339,1565,1550,1797
2013,Delaware,10,Hispanic or Latino ,18759,9284,9475,571,486,459
2013,District of Columbia,11,Hispanic or Latino ,20198,6154,14044,701,465,687
2013,Florida,12,Hispanic or Latino ,1303424,702653,600771,6841,7339,4891
2013,Georgia,13,Hispanic or Latino ,211986,92469,119517,2547,2254,1888
2013,Hawaii,15,Hispanic or Latino ,31244,11766,19478,913,634,910
2013,Idaho,16,Hispanic or Latino ,45199,24144,21055,793,899,928
2013,Illinois,17,Hispanic or Latino ,514407,272586,241821,3449,3174,2824
2013,Indiana,18,Hispanic or Latino ,101347,53316,48031,1509,1127,1405
2013,Iowa,19,Hispanic or Latino ,39672,20328,19344,887,849,904
2013,Kansas,20,Hispanic or Latino ,79584,41949,37635,1172,1027,1085
2013,Kentucky,21,Hispanic or Latino ,33898,12617,21281,898,694,818
2013,Louisiana,22,Hispanic or Latino ,58198,26408,31790,1176,1180,1035
2013,Maine,23,Hispanic or Latino ,4645,2296,2349,296,266,248
2013,Maryland,24,Hispanic or Latino ,121168,61532,59636,1737,1440,1505
2013,Massachusetts,25,Hispanic or Latino ,195134,48923,146211,2292,1492,2294
2013,Michigan,26,Hispanic or Latino ,116790,65150,51640,1443,1441,1300
2013,Minnesota,27,Hispanic or Latino ,62378,26973,35405,1086,952,989
2013,Mississippi,28,Hispanic or Latino ,20391,9122,11269,872,657,806
2013,Missouri,29,Hispanic or Latino ,58285,28055,30230,1046,1132,980
2013,Montana,30,Hispanic or Latino ,8504,4230,4274,472,372,436
2013,Nebraska,31,Hispanic or Latino ,44074,21967,22107,941,679,860
2013,Nevada,32,Hispanic or Latino ,188970,83219,105751,2004,1849,1883
2013,New Hampshire,33,Hispanic or Latino ,10299,4337,5962,538,343,501
2013,New Jersey,34,Hispanic or Latino ,453915,166494,287421,2567,2620,2652
2013,New Mexico,35,Hispanic or Latino ,304858,203489,101369,2167,2431,2091
2013,New York,36,Hispanic or Latino ,1036418,250320,786098,4456,3830,4338
2013,North Carolina,37,Hispanic or Latino ,204267,89186,115081,2372,2214,2134
2013,North Dakota,38,Hispanic or Latino ,4271,1867,2404,291,242,252
2013,Ohio,39,Hispanic or Latino ,101524,44883,56641,1658,1236,1619
2013,Oklahoma,40,Hispanic or Latino ,86308,43113,43195,1160,1167,1216
2013,Oregon,41,Hispanic or Latino ,113220,44835,68385,1511,1418,1448
2013,Pennsylvania,42,Hispanic or Latino ,205225,86302,118923,1884,1964,1522
2013,Rhode Island,44,Hispanic or Latino ,38228,10607,27621,690,625,838
2013,South Carolina,45,Hispanic or Latino ,60420,25539,34881,1333,1101,1117
2013,South Dakota,46,Hispanic or Latino ,6036,2437,3599,365,261,392
2013,Tennessee,47,Hispanic or Latino ,75134,29573,45561,1362,1234,1371
2013,Texas,48,Hispanic or Latino ,2634418,1511820,1122598,8711,10261,7680
2013,Utah,49,Hispanic or Latino ,88229,45294,42935,1338,1110,1170
2013,Vermont,50,Hispanic or Latino ,2710,1448,1262,231,171,200
2013,Virginia,51,Hispanic or Latino ,167134,77004,90130,2328,2227,1715
2013,Washington,53,Hispanic or Latino ,197919,83062,114857,2275,1769,2109
2013,West Virginia,54,Hispanic or Latino ,6298,3470,2828,385,318,319
2013,Wisconsin,55,Hispanic or Latino ,87857,35895,51962,1125,1161,1083
2013,Wyoming,56,Hispanic or Latino ,14775,8329,6446,606,537,486
2013,Puerto Rico,72,Hispanic or Latino ,1217613,854748,362865,3596,3771,3028
2014,Alabama,01,Hispanic or Latino ,47428,21281,26147,1261,1093,1017
2014,Alaska,02,Hispanic or Latino ,11901,5454,6447,522,429,468
2014,Arizona,04,Hispanic or Latino ,520490,268745,251745,4076,3588,2962
2014,Arkansas,05,Hispanic or Latino ,49693,23802,25891,969,924,942
2014,California,06,Hispanic or Latino ,3526727,1514290,2012437,8751,12560,8797
2014,Colorado,08,Hispanic or Latino ,307401,148487,158914,2357,2162,2230
2014,Connecticut,09,Hispanic or Latino ,149729,50555,99174,1643,1521,1688
2014,Delaware,10,Hispanic or Latino ,19699,9635,10064,570,538,565
2014,District of Columbia,11,Hispanic or Latino ,20932,6362,14570,686,446,661
2014,Florida,12,Hispanic or Latino ,1339209,707028,632181,6329,7191,4703
2014,Georgia,13,Hispanic or Latino ,218360,95404,122956,2487,2577,1950
2014,Hawaii,15,Hispanic or Latino ,31442,12130,19312,909,595,868
2014,Idaho,16,Hispanic or Latino ,46395,24162,22233,831,855,979
2014,Illinois,17,Hispanic or Latino ,525774,275143,250631,2746,3132,2748
2014,Indiana,18,Hispanic or Latino ,105689,55440,50249,1309,1265,1440
2014,Iowa,19,Hispanic or Latino ,41401,21481,19920,700,813,860
2014,Kansas,20,Hispanic or Latino ,82028,43095,38933,994,989,1111
2014,Kentucky,21,Hispanic or Latino ,35371,13037,22334,954,887,960
2014,Louisiana,22,Hispanic or Latino ,60915,27334,33581,1338,1089,1068
2014,Maine,23,Hispanic or Latino ,4953,2428,2525,314,261,302
2014,Maryland,24,Hispanic or Latino ,125610,62744,62866,1531,1616,1508
2014,Massachusetts,25,Hispanic or Latino ,202696,49670,153026,2077,1438,2245
2014,Michigan,26,Hispanic or Latino ,118459,65692,52767,1495,1438,1537
2014,Minnesota,27,Hispanic or Latino ,63916,27542,36374,1002,982,959
2014,Mississippi,28,Hispanic or Latino ,20403,9348,11055,783,566,676
2014,Missouri,29,Hispanic or Latino ,60261,28683,31578,1251,1028,1124
2014,Montana,30,Hispanic or Latino ,8922,4234,4688,473,353,425
2014,Nebraska,31,Hispanic or Latino ,45514,22017,23497,818,808,830
2014,Nevada,32,Hispanic or Latino ,195453,84822,110631,2218,1850,1946
2014,New Hampshire,33,Hispanic or Latino ,11042,4371,6671,474,371,434
2014,New Jersey,34,Hispanic or Latino ,468293,170396,297897,2659,2907,2945
2014,New Mexico,35,Hispanic or Latino ,306952,203142,103810,1971,2067,2121
2014,New York,36,Hispanic or Latino ,1058743,254659,804084,4503,3976,4181
2014,North Carolina,37,Hispanic or Latino ,212018,91515,120503,2280,2152,1815
2014,North Dakota,38,Hispanic or Latino ,4968,2182,2786,346,267,330
2014,Ohio,39,Hispanic or Latino ,104897,46155,58742,1448,1386,1431
2014,Oklahoma,40,Hispanic or Latino ,89866,44697,45169,1047,1016,1004
2014,Oregon,41,Hispanic or Latino ,117230,46717,70513,1470,1245,1630
2014,Pennsylvania,42,Hispanic or Latino ,212572,88171,124401,1999,2119,2421
2014,Rhode Island,44,Hispanic or Latino ,39930,11014,28916,832,775,994
2014,South Carolina,45,Hispanic or Latino ,62353,27218,35135,1404,1166,1183
2014,South Dakota,46,Hispanic or Latino ,6637,2754,3883,365,299,349
2014,Tennessee,47,Hispanic or Latino ,78363,30428,47935,1461,1190,1197
2014,Texas,48,Hispanic or Latino ,2702440,1540561,1161879,7901,11137,8184
2014,Utah,49,Hispanic or Latino ,91526,46614,44912,1315,1344,1293
2014,Vermont,50,Hispanic or Latino ,2697,1327,1370,228,176,198
2014,Virginia,51,Hispanic or Latino ,173980,79127,94853,2225,2213,1852
2014,Washington,53,Hispanic or Latino ,203893,84563,119330,1902,1774,1993
2014,West Virginia,54,Hispanic or Latino ,6610,3781,2829,341,322,320
2014,Wisconsin,55,Hispanic or Latino ,89775,36557,53218,1273,1045,1328
2014,Wyoming,56,Hispanic or Latino ,15471,8796,6675,576,526,518
2014,Puerto Rico,72,Hispanic or Latino ,1228456,854456,374000,2995,3643,3311
2015,Alabama,01,Hispanic or Latino ,48519,22671,25848,1109,986,897
2015,Alaska,02,Hispanic or Latino ,12972,5899,7073,491,455,557
2015,Arizona,04,Hispanic or Latino ,533562,270392,263170,3722,3065,3458
2015,Arkansas,05,Hispanic or Latino ,51309,25107,26202,1166,1150,1142
2015,California,06,Hispanic or Latino ,3596271,1531118,2065153,7778,13045,9768
2015,Colorado,08,Hispanic or Latino ,314648,151630,163018,2487,2406,2604
2015,Connecticut,09,Hispanic or Latino ,153966,51966,102000,1495,1396,1901
2015,Delaware,10,Hispanic or Latino ,20971,9943,11028,541,576,614
2015,District of Columbia,11,Hispanic or Latino ,22547,7083,15464,643,494,651
2015,Florida,12,Hispanic or Latino ,1380024,712853,667171,6858,8261,5186
2015,Georgia,13,Hispanic or Latino ,226114,100121,125993,2907,2680,2300
2015,Hawaii,15,Hispanic or Latino ,31973,11848,20125,932,657,802
2015,Idaho,16,Hispanic or Latino ,47393,24620,22773,992,988,947
2015,Illinois,17,Hispanic or Latino ,535363,277371,257992,3137,3604,2953
2015,Indiana,18,Hispanic or Latino ,109203,56951,52252,1567,1444,1495
2015,Iowa,19,Hispanic or Latino ,42802,21923,20879,768,795,749
2015,Kansas,20,Hispanic or Latino ,84144,43781,40363,1334,1189,1210
2015,Kentucky,21,Hispanic or Latino ,36906,13385,23521,966,680,860
2015,Louisiana,22,Hispanic or Latino ,63627,28913,34714,1367,1101,1063
2015,Maine,23,Hispanic or Latino ,5737,2865,2872,364,325,288
2015,Maryland,24,Hispanic or Latino ,131454,63809,67645,1716,1531,1625
2015,Massachusetts,25,Hispanic or Latino ,209772,51542,158230,1867,1522,1698
2015,Michigan,26,Hispanic or Latino ,122703,67755,54948,1362,1399,1458
2015,Minnesota,27,Hispanic or Latino ,65984,27778,38206,1065,1052,1224
2015,Mississippi,28,Hispanic or Latino ,20987,9402,11585,710,665,649
2015,Missouri,29,Hispanic or Latino ,61654,29777,31877,1312,1087,1151
2015,Montana,30,Hispanic or Latino ,9207,4267,4940,519,398,422
2015,Nebraska,31,Hispanic or Latino ,47700,22794,24906,851,816,820
2015,Nevada,32,Hispanic or Latino ,201340,87340,114000,1918,1637,1955
2015,New Hampshire,33,Hispanic or Latino ,11255,4354,6901,532,385,475
2015,New Jersey,34,Hispanic or Latino ,481255,173025,308230,2969,2891,3123
2015,New Mexico,35,Hispanic or Latino ,310232,205099,105133,2300,2836,1966
2015,New York,36,Hispanic or Latino ,1074796,259536,815260,5179,3739,4611
2015,North Carolina,37,Hispanic or Latino ,218933,92906,126027,2280,1928,2168
2015,North Dakota,38,Hispanic or Latino ,5778,2347,3431,318,305,339
2015,Ohio,39,Hispanic or Latino ,111120,48604,62516,1435,1462,1327
2015,Oklahoma,40,Hispanic or Latino ,92071,46006,46065,1255,1097,1086
2015,Oregon,41,Hispanic or Latino ,120042,48027,72015,1471,1304,1627
2015,Pennsylvania,42,Hispanic or Latino ,222416,90838,131578,2340,2086,2085
2015,Rhode Island,44,Hispanic or Latino ,41783,11497,30286,726,710,921
2015,South Carolina,45,Hispanic or Latino ,65375,29117,36258,1446,1232,1173
2015,South Dakota,46,Hispanic or Latino ,7137,3015,4122,467,327,436
2015,Tennessee,47,Hispanic or Latino ,80246,31398,48848,1437,1236,1388
2015,Texas,48,Hispanic or Latino ,2773762,1573116,1200646,8039,11409,8612
2015,Utah,49,Hispanic or Latino ,93356,46981,46375,1257,1401,1247
2015,Vermont,50,Hispanic or Latino ,3059,1508,1551,224,206,200
2015,Virginia,51,Hispanic or Latino ,181270,82957,98313,2197,2325,2206
2015,Washington,53,Hispanic or Latino ,210484,87777,122707,2387,1918,2185
2015,West Virginia,54,Hispanic or Latino ,6875,3915,2960,375,337,245
2015,Wisconsin,55,Hispanic or Latino ,93897,37783,56114,1298,1243,1285
2015,Wyoming,56,Hispanic or Latino ,16187,9050,7137,454,547,537
2015,Puerto Rico,72,Hispanic or Latino ,1231412,850002,381410,3923,4226,3973
2016,Alabama,01,Hispanic or Latino ,48535,22996,25539,1009,1070,955
2016,Alaska,02,Hispanic or Latino ,12927,5691,7236,652,507,583
2016,Arizona,04,Hispanic or Latino ,546388,276284,270104,3015,3578,3145
2016,Arkansas,05,Hispanic or Latino ,53097,26125,26972,1044,1095,995
2016,California,06,Hispanic or Latino ,3650946,1549138,2101808,8696,13536,10017
2016,Colorado,08,Hispanic or Latino ,321015,154278,166737,2079,2542,2542
2016,Connecticut,09,Hispanic or Latino ,158726,53302,105424,1605,1381,1658
2016,Delaware,10,Hispanic or Latino ,21617,9911,11706,684,607,621
2016,District of Columbia,11,Hispanic or Latino ,23885,7381,16504,743,538,745
2016,Florida,12,Hispanic or Latino ,1424340,725673,698667,7744,8352,5613
2016,Georgia,13,Hispanic or Latino ,230186,102649,127537,2372,2527,2138
2016,Hawaii,15,Hispanic or Latino ,32122,12081,20041,944,532,838
2016,Idaho,16,Hispanic or Latino ,48598,24975,23623,1029,1035,1031
2016,Illinois,17,Hispanic or Latino ,543609,280648,262961,3469,3736,3127
2016,Indiana,18,Hispanic or Latino ,111688,58613,53075,1579,1610,1396
2016,Iowa,19,Hispanic or Latino ,44054,22443,21611,1031,964,1041
2016,Kansas,20,Hispanic or Latino ,85805,44733,41072,1097,1063,1116
2016,Kentucky,21,Hispanic or Latino ,37970,13387,24583,936,733,949
2016,Louisiana,22,Hispanic or Latino ,65019,29537,35482,1220,1099,1039
2016,Maine,23,Hispanic or Latino ,5767,2834,2933,354,258,283
2016,Maryland,24,Hispanic or Latino ,135662,65642,70020,1586,1485,1514
2016,Massachusetts,25,Hispanic or Latino ,217020,53837,163183,1871,1663,2146
2016,Michigan,26,Hispanic or Latino ,125549,69412,56137,1430,1256,1312
2016,Minnesota,27,Hispanic or Latino ,67332,29627,37705,951,1056,963
2016,Mississippi,28,Hispanic or Latino ,21253,9580,11673,734,789,711
2016,Missouri,29,Hispanic or Latino ,63361,30961,32400,1279,1234,1150
2016,Montana,30,Hispanic or Latino ,9494,4517,4977,506,285,452
2016,Nebraska,31,Hispanic or Latino ,49448,23100,26348,797,863,917
2016,Nevada,32,Hispanic or Latino ,208984,90226,118758,1925,1846,1907
2016,New Hampshire,33,Hispanic or Latino ,11626,4336,7290,480,380,543
2016,New Jersey,34,Hispanic or Latino ,493239,175032,318207,2647,2740,2620
2016,New Mexico,35,Hispanic or Latino ,311911,204286,107625,1828,2133,2214
2016,New York,36,Hispanic or Latino ,1086748,262968,823780,4768,4419,3758
2016,North Carolina,37,Hispanic or Latino ,223469,95950,127519,2364,2544,2069
2016,North Dakota,38,Hispanic or Latino ,6536,2660,3876,468,349,473
2016,Ohio,39,Hispanic or Latino ,114260,50077,64183,1435,1351,1409
2016,Oklahoma,40,Hispanic or Latino ,94932,47762,47170,1181,1041,1098
2016,Oregon,41,Hispanic or Latino ,123561,49753,73808,1607,1420,1757
2016,Pennsylvania,42,Hispanic or Latino ,231195,93821,137374,2335,2110,2161
2016,Rhode Island,44,Hispanic or Latino ,43069,11400,31669,988,603,1086
2016,South Carolina,45,Hispanic or Latino ,67116,30697,36419,1250,1152,1173
2016,South Dakota,46,Hispanic or Latino ,7325,2854,4471,447,325,378
2016,Tennessee,47,Hispanic or Latino ,82911,32751,50160,1346,1307,1396
2016,Texas,48,Hispanic or Latino ,2841331,1605391,1235940,8383,11602,8597
2016,Utah,49,Hispanic or Latino ,95765,48481,47284,1264,1294,1247
2016,Vermont,50,Hispanic or Latino ,3083,1414,1669,238,175,194
2016,Virginia,51,Hispanic or Latino ,185931,85147,100784,2641,2314,2042
2016,Washington,53,Hispanic or Latino ,216434,90961,125473,2033,1917,1935
2016,West Virginia,54,Hispanic or Latino ,6800,3747,3053,476,348,346
2016,Wisconsin,55,Hispanic or Latino ,97308,38143,59165,1200,1305,1376
2016,Wyoming,56,Hispanic or Latino ,16824,9429,7395,586,510,478
2016,Puerto Rico,72,Hispanic or Latino ,1223905,840659,383246,3799,3634,3124
2017,Alabama,01,Hispanic or Latino ,49777,23478,26299,1308,1170,1164
2017,Alaska,02,Hispanic or Latino ,13461,5896,7565,606,469,575
2017,Arizona,04,Hispanic or Latino ,563685,289999,273686,3610,3422,3202
2017,Arkansas,05,Hispanic or Latino ,54939,27072,27867,1014,1038,1184
2017,California,06,Hispanic or Latino ,3707409,1596943,2110466,8172,13291,9631
2017,Colorado,08,Hispanic or Latino ,330181,160967,169214,2674,2497,2946
2017,Connecticut,09,Hispanic or Latino ,164460,55650,108810,1815,1293,1973
2017,Delaware,10,Hispanic or Latino ,22436,10622,11814,641,537,635
2017,District of Columbia,11,Hispanic or Latino ,23729,7630,16099,803,639,703
2017,Florida,12,Hispanic or Latino ,1489132,760096,729036,7205,8553,5311
2017,Georgia,13,Hispanic or Latino ,238699,108465,130234,2443,2614,2461
2017,Hawaii,15,Hispanic or Latino ,32913,12663,20250,900,596,840
2017,Idaho,16,Hispanic or Latino ,51003,26660,24343,1014,1013,1048
2017,Illinois,17,Hispanic or Latino ,552916,288543,264373,3010,3763,3139
2017,Indiana,18,Hispanic or Latino ,116177,61374,54803,1644,1713,1618
2017,Iowa,19,Hispanic or Latino ,46623,23668,22955,819,900,920
2017,Kansas,20,Hispanic or Latino ,89960,46330,43630,1314,1281,1277
2017,Kentucky,21,Hispanic or Latino ,38994,13849,25145,956,766,863
2017,Louisiana,22,Hispanic or Latino ,68399,30920,37479,1498,1118,1151
2017,Maine,23,Hispanic or Latino ,5928,2910,3018,405,312,347
2017,Maryland,24,Hispanic or Latino ,140242,68223,72019,1903,1878,1792
2017,Massachusetts,25,Hispanic or Latino ,227245,57705,169540,1865,1555,1856
2017,Michigan,26,Hispanic or Latino ,129773,72845,56928,1414,1475,1344
2017,Minnesota,27,Hispanic or Latino ,69096,30913,38183,1168,1097,1110
2017,Mississippi,28,Hispanic or Latino ,21657,9936,11721,744,753,626
2017,Missouri,29,Hispanic or Latino ,66289,33045,33244,1398,1266,1340
2017,Montana,30,Hispanic or Latino ,9921,4965,4956,485,388,445
2017,Nebraska,31,Hispanic or Latino ,51993,24540,27453,876,782,906
2017,Nevada,32,Hispanic or Latino ,217818,95858,121960,1966,1941,1836
2017,New Hampshire,33,Hispanic or Latino ,12051,4580,7471,504,370,495
2017,New Jersey,34,Hispanic or Latino ,504177,181119,323058,2993,3053,2866
2017,New Mexico,35,Hispanic or Latino ,320392,209868,110524,2338,2640,2362
2017,New York,36,Hispanic or Latino ,1102903,276318,826585,4441,3867,4186
2017,North Carolina,37,Hispanic or Latino ,233479,103446,130033,2465,2159,2222
2017,North Dakota,38,Hispanic or Latino ,7455,2749,4706,433,323,480
2017,Ohio,39,Hispanic or Latino ,119047,52834,66213,1322,1384,1417
2017,Oklahoma,40,Hispanic or Latino ,98201,50357,47844,1285,1254,1302
2017,Oregon,41,Hispanic or Latino ,129029,52675,76354,1562,1520,1590
2017,Pennsylvania,42,Hispanic or Latino ,244245,99192,145053,2151,1991,2091
2017,Rhode Island,44,Hispanic or Latino ,45599,12645,32954,858,692,1043
2017,South Carolina,45,Hispanic or Latino ,70209,32341,37868,1346,1137,1178
2017,South Dakota,46,Hispanic or Latino ,7381,2995,4386,442,326,433
2017,Tennessee,47,Hispanic or Latino ,86360,34265,52095,1374,1326,1275
2017,Texas,48,Hispanic or Latino ,2916268,1658282,1257986,9142,12706,8094
2017,Utah,49,Hispanic or Latino ,99584,50267,49317,1294,1492,1437
2017,Vermont,50,Hispanic or Latino ,3323,1601,1722,240,194,221
2017,Virginia,51,Hispanic or Latino ,191051,90324,100727,2248,2302,2066
2017,Washington,53,Hispanic or Latino ,226587,97176,129411,2421,1912,2432
2017,West Virginia,54,Hispanic or Latino ,7280,3855,3425,405,335,358
2017,Wisconsin,55,Hispanic or Latino ,101584,40325,61259,1262,938,1336
2017,Wyoming,56,Hispanic or Latino ,17088,9677,7411,596,608,583
2017,Puerto Rico,72,Hispanic or Latino ,1209493,829295,380198,3632,3973,3607
2018,Alabama,01,Hispanic or Latino ,51617,24945,26672,1174,1185,1090
2018,Alaska,02,Hispanic or Latino ,14083,6474,7609,643,523,606
2018,Arizona,04,Hispanic or Latino ,578067,303229,274838,2968,3416,3099
2018,Arkansas,05,Hispanic or Latino ,57283,28784,28499,940,957,952
2018,California,06,Hispanic or Latino ,3760415,1632825,2127590,8813,14230,9887
2018,Colorado,08,Hispanic or Latino ,337967,168057,169910,2119,2875,2692
2018,Connecticut,09,Hispanic or Latino ,170572,58174,112398,1778,1494,1803
2018,Delaware,10,Hispanic or Latino ,22848,11064,11784,585,647,673
2018,District of Columbia,11,Hispanic or Latino ,24597,7738,16859,738,608,757
2018,Florida,12,Hispanic or Latino ,1547454,789321,758133,7802,8652,6160
2018,Georgia,13,Hispanic or Latino ,244649,114626,130023,2602,2509,2081
2018,Hawaii,15,Hispanic or Latino ,33931,12787,21144,856,600,862
2018,Idaho,16,Hispanic or Latino ,52615,27071,25544,982,949,932
2018,Illinois,17,Hispanic or Latino ,564745,296853,267892,3466,3953,3207
2018,Indiana,18,Hispanic or Latino ,119091,63990,55101,1526,1647,1425
2018,Iowa,19,Hispanic or Latino ,48532,25335,23197,973,1057,941
2018,Kansas,20,Hispanic or Latino ,91967,47671,44296,1061,1265,1474
2018,Kentucky,21,Hispanic or Latino ,41406,14869,26537,964,842,903
2018,Louisiana,22,Hispanic or Latino ,70698,31838,38860,1313,1159,1090
2018,Maine,23,Hispanic or Latino ,6365,3233,3132,338,291,336
2018,Maryland,24,Hispanic or Latino ,143328,70876,72452,1510,1639,1457
2018,Massachusetts,25,Hispanic or Latino ,236389,61002,175387,2207,1723,2531
2018,Michigan,26,Hispanic or Latino ,135033,76104,58929,1421,1412,1538
2018,Minnesota,27,Hispanic or Latino ,72139,32335,39804,1143,1128,1091
2018,Mississippi,28,Hispanic or Latino ,22326,10456,11870,786,746,744
2018,Missouri,29,Hispanic or Latino ,67889,33998,33891,1261,1188,1103
2018,Montana,30,Hispanic or Latino ,11126,5671,5455,507,400,473
2018,Nebraska,31,Hispanic or Latino ,54451,26272,28179,796,874,957
2018,Nevada,32,Hispanic or Latino ,225893,101899,123994,1975,1850,2295
2018,New Hampshire,33,Hispanic or Latino ,13049,4853,8196,536,438,491
2018,New Jersey,34,Hispanic or Latino ,516791,186181,330610,2568,3123,3443
2018,New Mexico,35,Hispanic or Latino ,326480,212903,113577,2382,2512,2258
2018,New York,36,Hispanic or Latino ,1118956,281831,837125,4388,4593,3927
2018,North Carolina,37,Hispanic or Latino ,241364,108920,132444,2673,2300,2345
2018,North Dakota,38,Hispanic or Latino ,8281,2947,5334,375,336,372
2018,Ohio,39,Hispanic or Latino ,125527,56100,69427,1679,1506,1694
2018,Oklahoma,40,Hispanic or Latino ,102279,52933,49346,1202,1132,1266
2018,Oregon,41,Hispanic or Latino ,133543,55051,78492,1755,1566,1819
2018,Pennsylvania,42,Hispanic or Latino ,254534,104104,150430,2136,2185,2385
2018,Rhode Island,44,Hispanic or Latino ,47207,13304,33903,886,700,1098
2018,South Carolina,45,Hispanic or Latino ,72173,33830,38343,1319,1289,1264
2018,South Dakota,46,Hispanic or Latino ,8591,3304,5287,403,378,419
2018,Tennessee,47,Hispanic or Latino ,90481,36548,53933,1423,1358,1320
2018,Texas,48,Hispanic or Latino ,2986578,1702902,1283676,9572,12068,8381
2018,Utah,49,Hispanic or Latino ,103268,53393,49875,1429,1309,1404
2018,Vermont,50,Hispanic or Latino ,3632,1722,1910,252,166,225
2018,Virginia,51,Hispanic or Latino ,198283,96423,101860,1951,2001,1446
2018,Washington,53,Hispanic or Latino ,234406,102173,132233,1894,1972,2387
2018,West Virginia,54,Hispanic or Latino ,7302,3982,3320,433,400,382
2018,Wisconsin,55,Hispanic or Latino ,103584,42224,61360,1328,1301,1429
2018,Wyoming,56,Hispanic or Latino ,17293,9931,7362,566,590,528
2018,Puerto Rico,72,Hispanic or Latino ,1191907,812140,379767,4323,4416,3178
2019,Alabama,01,Hispanic or Latino ,53081,26390,26691,1249,1241,1094
2019,Alaska,02,Hispanic or Latino ,14574,7088,7486,606,502,642
2019,Arizona,04,Hispanic or Latino ,596116,321232,274884,3182,3794,3242
2019,Arkansas,05,Hispanic or Latino ,58587,30601,27986,1086,1038,1014
2019,California,06,Hispanic or Latino ,3811789,1670449,2141340,9674,14822,9807
2019,Colorado,08,Hispanic or Latino ,344882,173842,171040,2427,2995,3040
2019,Connecticut,09,Hispanic or Latino ,174546,59815,114731,1938,1600,1763
2019,Delaware,10,Hispanic or Latino ,23705,11579,12126,689,671,664
2019,District of Columbia,11,Hispanic or Latino ,24718,8098,16620,689,473,825
2019,Florida,12,Hispanic or Latino ,1610100,827202,782898,7681,9733,6169
2019,Georgia,13,Hispanic or Latino ,252299,121299,131000,2474,2709,2420
2019,Hawaii,15,Hispanic or Latino ,35858,13357,22501,909,712,880
2019,Idaho,16,Hispanic or Latino ,55211,29508,25703,1095,942,1183
2019,Illinois,17,Hispanic or Latino ,576009,306528,269481,3091,4097,3955
2019,Indiana,18,Hispanic or Latino ,122060,65469,56591,1683,1545,1542
2019,Iowa,19,Hispanic or Latino ,50400,26119,24281,869,877,934
2019,Kansas,20,Hispanic or Latino ,93730,49069,44661,1262,1173,1370
2019,Kentucky,21,Hispanic or Latino ,43049,16212,26837,973,976,917
2019,Louisiana,22,Hispanic or Latino ,71503,32308,39195,1239,1118,1163
2019,Maine,23,Hispanic or Latino ,6504,3477,3027,397,344,307
2019,Maryland,24,Hispanic or Latino ,146907,73451,73456,1693,1655,1456
2019,Massachusetts,25,Hispanic or Latino ,244310,66191,178119,2215,1672,2335
2019,Michigan,26,Hispanic or Latino ,140493,79332,61161,1731,1588,1651
2019,Minnesota,27,Hispanic or Latino ,75706,34674,41032,1104,1062,1069
2019,Mississippi,28,Hispanic or Latino ,22979,11168,11811,802,685,784
2019,Missouri,29,Hispanic or Latino ,70263,35395,34868,1352,1157,1126
2019,Montana,30,Hispanic or Latino ,11281,5581,5700,585,410,526
2019,Nebraska,31,Hispanic or Latino ,55799,27486,28313,942,953,983
2019,Nevada,32,Hispanic or Latino ,232855,106939,125916,1847,2035,1894
2019,New Hampshire,33,Hispanic or Latino ,13145,5247,7898,579,484,535
2019,New Jersey,34,Hispanic or Latino ,529248,192973,336275,2449,3297,3489
2019,New Mexico,35,Hispanic or Latino ,330703,216718,113985,2387,2510,2316
2019,New York,36,Hispanic or Latino ,1134496,291250,843246,4851,5031,4398
2019,North Carolina,37,Hispanic or Latino ,248304,114117,134187,2282,2379,2453
2019,North Dakota,38,Hispanic or Latino ,8712,2705,6007,454,339,462
2019,Ohio,39,Hispanic or Latino ,131083,58421,72662,1727,1705,1798
2019,Oklahoma,40,Hispanic or Latino ,105166,54212,50954,1358,1141,1218
2019,Oregon,41,Hispanic or Latino ,138221,59229,78992,1731,1505,1786
2019,Pennsylvania,42,Hispanic or Latino ,265875,109562,156313,2285,2255,2732
2019,Rhode Island,44,Hispanic or Latino ,48034,14294,33740,863,637,1060
2019,South Carolina,45,Hispanic or Latino ,74587,35867,38720,1469,1495,1301
2019,South Dakota,46,Hispanic or Latino ,9219,3564,5655,525,353,481
2019,Tennessee,47,Hispanic or Latino ,93264,38418,54846,1356,1363,1209
2019,Texas,48,Hispanic or Latino ,3054709,1749876,1304833,8426,12100,8881
2019,Utah,49,Hispanic or Latino ,106021,55468,50553,1405,1389,1419
2019,Vermont,50,Hispanic or Latino ,3598,1608,1990,246,211,248
2019,Virginia,51,Hispanic or Latino ,204880,100879,104001,2175,2245,1911
2019,Washington,53,Hispanic or Latino ,242557,107475,135082,2261,2290,2216
2019,West Virginia,54,Hispanic or Latino ,7631,4393,3238,475,466,378
2019,Wisconsin,55,Hispanic or Latino ,106297,43498,62799,1452,1231,1256
2019,Wyoming,56,Hispanic or Latino ,17049,10206,6843,669,609,577
2019,Puerto Rico,72,Hispanic or Latino ,1178577,803782,374795,3457,3965,4006
2020,Alabama,01,Hispanic or Latino ,56564,29062,27502,1284,1281,1241
2020,Alaska,02,Hispanic or Latino ,15039,7858,7181,656,615,638
2020,Arizona,04,Hispanic or Latino ,616001,343160,272841,4086,3774,3887
2020,Arkansas,05,Hispanic or Latino ,61345,31299,30046,1220,1340,1354
2020,California,06,Hispanic or Latino ,3874344,1741159,2133185,9793,14257,11922
2020,Colorado,08,Hispanic or Latino ,344416,180871,163545,2807,2818,2712
2020,Connecticut,09,Hispanic or Latino ,183378,65412,117966,1974,1948,2142
2020,Delaware,10,Hispanic or Latino ,23637,11979,11658,773,822,907
2020,District of Columbia,11,Hispanic or Latino ,24940,8252,16688,1015,720,936
2020,Florida,12,Hispanic or Latino ,1696751,894940,801811,8264,10239,7650
2020,Georgia,13,Hispanic or Latino ,263530,131749,131781,3009,3461,2422
2020,Hawaii,15,Hispanic or Latino ,36428,15136,21292,906,843,954
2020,Idaho,16,Hispanic or Latino ,58693,32858,25835,1239,1220,1163
2020,Illinois,17,Hispanic or Latino ,591380,323659,267721,3546,3935,4154
2020,Indiana,18,Hispanic or Latino ,127899,70786,57113,1679,1898,1942
2020,Iowa,19,Hispanic or Latino ,51854,27185,24669,1241,1072,1081
2020,Kansas,20,Hispanic or Latino ,96547,51477,45070,1396,1163,1277
2020,Kentucky,21,Hispanic or Latino ,45279,17680,27599,1115,1017,1128
2020,Louisiana,22,Hispanic or Latino ,73204,34065,39139,1472,1316,1236
2020,Maine,23,Hispanic or Latino ,6630,3691,2939,477,356,374
2020,Maryland,24,Hispanic or Latino ,153300,81528,71772,1997,1900,1712
2020,Massachusetts,25,Hispanic or Latino ,256277,72967,183310,2390,2074,2592
2020,Michigan,26,Hispanic or Latino ,145980,84982,60998,1640,1726,1860
2020,Minnesota,27,Hispanic or Latino ,79572,40007,39565,1235,1181,1145
2020,Mississippi,28,Hispanic or Latino ,25514,12844,12670,928,818,869
2020,Missouri,29,Hispanic or Latino ,73573,37836,35737,1553,1283,1355
2020,Montana,30,Hispanic or Latino ,12196,5758,6438,453,492,520
2020,Nebraska,31,Hispanic or Latino ,58222,29796,28426,899,1079,1080
2020,Nevada,32,Hispanic or Latino ,243909,113794,130115,2378,2042,2473
2020,New Hampshire,33,Hispanic or Latino ,14208,5795,8413,666,523,633
2020,New Jersey,34,Hispanic or Latino ,548532,208640,339892,3548,3432,4072
2020,New Mexico,35,Hispanic or Latino ,340008,227134,112874,2560,2863,2551
2020,New York,36,Hispanic or Latino ,1161394,309455,851939,5524,4926,5926
2020,North Carolina,37,Hispanic or Latino ,256235,123818,132417,2796,2529,2682
2020,North Dakota,38,Hispanic or Latino ,9278,2888,6390,443,363,461
2020,Ohio,39,Hispanic or Latino ,136729,62822,73907,1839,1717,1673
2020,Oklahoma,40,Hispanic or Latino ,109076,57756,51320,1407,1334,1246
2020,Oregon,41,Hispanic or Latino ,145004,62934,82070,2051,1934,2159
2020,Pennsylvania,42,Hispanic or Latino ,279957,118928,161029,2992,2746,3015
2020,Rhode Island,44,Hispanic or Latino ,50692,17210,33482,1083,1003,1189
2020,South Carolina,45,Hispanic or Latino ,77697,39423,38274,1516,1447,1248
2020,South Dakota,46,Hispanic or Latino ,9764,3899,5865,433,380,434
2020,Tennessee,47,Hispanic or Latino ,97174,42123,55051,1471,1747,1559
2020,Texas,48,Hispanic or Latino ,3158494,1835339,1323155,9047,12834,9100
2020,Utah,49,Hispanic or Latino ,111546,60549,50997,1613,1486,1818
2020,Vermont,50,Hispanic or Latino ,3884,1655,2229,276,230,261
2020,Virginia,51,Hispanic or Latino ,215598,109576,106022,2591,2601,2217
2020,Washington,53,Hispanic or Latino ,255918,114475,141443,2482,2393,2281
2020,West Virginia,54,Hispanic or Latino ,8250,4869,3381,568,523,459
2020,Wisconsin,55,Hispanic or Latino ,109399,47129,62270,1317,1307,1445
2020,Wyoming,56,Hispanic or Latino ,17758,10898,6860,708,733,578
2020,Puerto Rico,72,Hispanic or Latino ,1191466,808467,382999,3661,4050,3900
